"","Year","Age","Female","Male","Total"
"1",1850,"0",39671,40920,80591
"2",1850,"1",33995,34490,68485
"3",1850,"2",31863,31926,63789
"4",1850,"3",31733,32211,63944
"5",1850,"4",34595,34874,69469
"6",1850,"5",35175,36191,71366
"7",1850,"6",34121,34737,68858
"8",1850,"7",34071,34407,68478
"9",1850,"8",33572,34626,68198
"10",1850,"9",34217,34662,68879
"11",1850,"10",34102,34636,68738
"12",1850,"11",33273,33463,66736
"13",1850,"12",32497,32930,65427
"14",1850,"13",31557,32596,64153
"15",1850,"14",31710,31989,63699
"16",1850,"15",29671,29830,59501
"17",1850,"16",29772,30162,59934
"18",1850,"17",27055,26695,53750
"19",1850,"18",26403,26766,53169
"20",1850,"19",28869,28214,57083
"21",1850,"20",29382,28396,57778
"22",1850,"21",26648,26392,53040
"23",1850,"22",26613,25472,52085
"24",1850,"23",28418,27081,55499
"25",1850,"24",28675,27102,55777
"26",1850,"25",28649,28203,56852
"27",1850,"26",27548,26437,53985
"28",1850,"27",26021,25646,51667
"29",1850,"28",25001,24140,49141
"30",1850,"29",23450,22484,45934
"31",1850,"30",25064,23911,48975
"32",1850,"31",21002,20516,41518
"33",1850,"32",21278,20642,41920
"34",1850,"33",22722,21678,44400
"35",1850,"34",21147,20617,41764
"36",1850,"35",20512,19656,40168
"37",1850,"36",20389,19474,39863
"38",1850,"37",18722,18110,36832
"39",1850,"38",19931,18968,38899
"40",1850,"39",19098,17878,36976
"41",1850,"40",18426,17251,35677
"42",1850,"41",15606,15223,30829
"43",1850,"42",17152,16059,33211
"44",1850,"43",16695,15892,32587
"45",1850,"44",16733,15885,32618
"46",1850,"45",16309,15501,31810
"47",1850,"46",16258,15524,31782
"48",1850,"47",16255,15490,31745
"49",1850,"48",16268,14998,31266
"50",1850,"49",17314,15713,33027
"51",1850,"50",16900,15804,32704
"52",1850,"51",14121,13639,27760
"53",1850,"52",14531,13660,28191
"54",1850,"53",13440,12297,25737
"55",1850,"54",13384,11344,24728
"56",1850,"55",12519,10961,23480
"57",1850,"56",12330,10579,22909
"58",1850,"57",11989,10253,22242
"59",1850,"58",11359,9628,20987
"60",1850,"59",11442,8871,20313
"61",1850,"60",11190,8414,19604
"62",1850,"61",9932,8120,18052
"63",1850,"62",10546,8911,19457
"64",1850,"63",9301,7600,16901
"65",1850,"64",8928,7163,16091
"66",1850,"65",8168,6572,14740
"67",1850,"66",7327,5910,13237
"68",1850,"67",6315,5101,11416
"69",1850,"68",5696,4516,10212
"70",1850,"69",6354,5077,11431
"71",1850,"70",5891,4504,10395
"72",1850,"71",4435,3545,7980
"73",1850,"72",4826,3998,8824
"74",1850,"73",4110,3220,7330
"75",1850,"74",3953,3095,7048
"76",1850,"75",3702,2891,6593
"77",1850,"76",3143,2565,5708
"78",1850,"77",2916,2299,5215
"79",1850,"78",2388,1724,4112
"80",1850,"79",2459,1812,4271
"81",1850,"80",1825,1347,3172
"82",1850,"81",1530,1169,2699
"83",1850,"82",1274,1001,2275
"84",1850,"83",1047,809,1856
"85",1850,"84",808,602,1410
"86",1850,"85",664,497,1161
"87",1850,"86",539,409,948
"88",1850,"87",404,298,702
"89",1850,"88",280,221,501
"90",1850,"89",236,185,421
"91",1850,"90",180,115,295
"92",1850,"91",98,76,174
"93",1850,"92",81.47,58,139.47
"94",1850,"93",57.53,47.17,104.7
"95",1850,"94",53,22.83,75.83
"96",1850,"95",32.55,24,56.55
"97",1850,"96",24.42,11,35.42
"98",1850,"97",14.03,9,23.03
"99",1850,"98",5.23,3,8.23
"100",1850,"99",4.77,3,7.77
"101",1850,"100",1.65,0,1.65
"102",1850,"101",1.01,0,1.01
"103",1850,"102",0.34,0,0.34
"104",1850,"103",0,0,0
"105",1850,"104",0,0,0
"106",1850,"105",0,0,0
"107",1850,"106",0,0,0
"108",1850,"107",0,0,0
"109",1850,"108",0,0,0
"110",1850,"109",0,0,0
"111",1850,"110+",0,0,0
"112",1851,"0",45744,47331,93075
"113",1851,"1",35782,36455,72237
"114",1851,"2",32587,32983,65570
"115",1851,"3",31050,31048,62098
"116",1851,"4",31207,31644,62851
"117",1851,"5",34166,34402,68568
"118",1851,"6",34776,35774,70550
"119",1851,"7",33830,34434,68264
"120",1851,"8",33821,34142,67963
"121",1851,"9",33347,34402,67749
"122",1851,"10",34005,34469,68474
"123",1851,"11",33916,34457,68373
"124",1851,"12",33110,33321,66431
"125",1851,"13",32355,32800,65155
"126",1851,"14",31399,32461,63860
"127",1851,"15",31529,31864,63393
"128",1851,"16",29508,29709,59217
"129",1851,"17",29609,30031,59640
"130",1851,"18",26884,26519,53403
"131",1851,"19",26228,26567,52795
"132",1851,"20",28671,27989,56660
"133",1851,"21",29188,28154,57342
"134",1851,"22",26440,26148,52588
"135",1851,"23",26402,25223,51625
"136",1851,"24",28205,26854,55059
"137",1851,"25",28457,26873,55330
"138",1851,"26",28389,27951,56340
"139",1851,"27",27294,26191,53485
"140",1851,"28",25746,25421,51167
"141",1851,"29",24726,23920,48646
"142",1851,"30",23194,22266,45460
"143",1851,"31",24820,23722,48542
"144",1851,"32",20743,20326,41069
"145",1851,"33",21006,20429,41435
"146",1851,"34",22439,21467,43906
"147",1851,"35",20893,20416,41309
"148",1851,"36",20272,19457,39729
"149",1851,"37",20142,19281,39423
"150",1851,"38",18458,17903,36361
"151",1851,"39",19662,18750,38412
"152",1851,"40",18833,17661,36494
"153",1851,"41",18176,17047,35223
"154",1851,"42",15374,15001,30375
"155",1851,"43",16921,15845,32766
"156",1851,"44",16482,15664,32146
"157",1851,"45",16518,15658,32176
"158",1851,"46",16092,15261,31353
"159",1851,"47",16038,15292,31330
"160",1851,"48",16032,15242,31274
"161",1851,"49",16037,14747,30784
"162",1851,"50",17076,15445,32521
"163",1851,"51",16675,15526,32201
"164",1851,"52",13867,13331,27198
"165",1851,"53",14287,13381,27668
"166",1851,"54",13208,12024,25232
"167",1851,"55",13147,11075,24222
"168",1851,"56",12270,10701,22971
"169",1851,"57",12065,10318,22383
"170",1851,"58",11732,9982,21714
"171",1851,"59",11092,9348,20440
"172",1851,"60",11157,8585,19742
"173",1851,"61",10907,8132,19039
"174",1851,"62",9632,7826,17458
"175",1851,"63",10220,8611,18831
"176",1851,"64",8948,7292,16240
"177",1851,"65",8581,6848,15429
"178",1851,"66",7823,6239,14062
"179",1851,"67",7011,5629,12640
"180",1851,"68",5995,4835,10830
"181",1851,"69",5364,4246,9610
"182",1851,"70",6002,4792,10794
"183",1851,"71",5544,4234,9778
"184",1851,"72",4076,3272,7348
"185",1851,"73",4468,3710,8178
"186",1851,"74",3766,2922,6688
"187",1851,"75",3593,2805,6398
"188",1851,"76",3356,2604,5960
"189",1851,"77",2819,2284,5103
"190",1851,"78",2593,2052,4645
"191",1851,"79",2088,1490,3578
"192",1851,"80",1882,1416,3298
"193",1851,"81",1595,1150,2745
"194",1851,"82",1320,988,2308
"195",1851,"83",1059,840,1899
"196",1851,"84",853,659,1512
"197",1851,"85",654,486,1140
"198",1851,"86",522,394,916
"199",1851,"87",421,321,742
"200",1851,"88",311,224,535
"201",1851,"89",218,176,394
"202",1851,"90",189,137,326
"203",1851,"91",129,86,215
"204",1851,"92",67,61,128
"205",1851,"93",53.47,35,88.47
"206",1851,"94",46.53,28.17,74.7
"207",1851,"95",27,15.83,42.83
"208",1851,"96",21.55,15,36.55
"209",1851,"97",18.42,7,25.42
"210",1851,"98",9.03,5,14.03
"211",1851,"99",3.23,1,4.23
"212",1851,"100",1.77,1,2.77
"213",1851,"101",0,0,0
"214",1851,"102",0,0,0
"215",1851,"103",0,0,0
"216",1851,"104",0,0,0
"217",1851,"105",0,0,0
"218",1851,"106",0,0,0
"219",1851,"107",0,0,0
"220",1851,"108",0,0,0
"221",1851,"109",0,0,0
"222",1851,"110+",0,0,0
"223",1852,"0",46455,47655,94110
"224",1852,"1",41367,42392,83759
"225",1852,"2",33997,34623,68620
"226",1852,"3",31528,31964,63492
"227",1852,"4",30514,30459,60973
"228",1852,"5",30800,31242,62042
"229",1852,"6",33756,33996,67752
"230",1852,"7",34461,35453,69914
"231",1852,"8",33571,34173,67744
"232",1852,"9",33597,33938,67535
"233",1852,"10",33137,34219,67356
"234",1852,"11",33822,34292,68114
"235",1852,"12",33755,34324,68079
"236",1852,"13",32972,33207,66179
"237",1852,"14",32206,32687,64893
"238",1852,"15",31233,32362,63595
"239",1852,"16",31369,31759,63128
"240",1852,"17",29338,29586,58924
"241",1852,"18",29431,29867,59298
"242",1852,"19",26701,26334,53035
"243",1852,"20",26010,26353,52363
"244",1852,"21",28471,27754,56225
"245",1852,"22",28993,27917,56910
"246",1852,"23",26239,25905,52144
"247",1852,"24",26198,25000,51198
"248",1852,"25",27997,26631,54628
"249",1852,"26",28212,26633,54845
"250",1852,"27",28150,27717,55867
"251",1852,"28",27038,25978,53016
"252",1852,"29",25491,25214,50705
"253",1852,"30",24487,23709,48196
"254",1852,"31",22965,22078,45043
"255",1852,"32",24575,23533,48108
"256",1852,"33",20487,20114,40601
"257",1852,"34",20741,20218,40959
"258",1852,"35",22198,21271,43469
"259",1852,"36",20663,20229,40892
"260",1852,"37",20035,19275,39310
"261",1852,"38",19889,19087,38976
"262",1852,"39",18198,17698,35896
"263",1852,"40",19412,18551,37963
"264",1852,"41",18603,17475,36078
"265",1852,"42",17964,16846,34810
"266",1852,"43",15162,14808,29970
"267",1852,"44",16724,15641,32365
"268",1852,"45",16286,15456,31742
"269",1852,"46",16321,15435,31756
"270",1852,"47",15894,15045,30939
"271",1852,"48",15837,15061,30898
"272",1852,"49",15826,15007,30833
"273",1852,"50",15809,14501,30310
"274",1852,"51",16849,15193,32042
"275",1852,"52",16418,15247,31665
"276",1852,"53",13629,13060,26689
"277",1852,"54",14069,13100,27169
"278",1852,"55",12986,11746,24732
"279",1852,"56",12909,10818,23727
"280",1852,"57",12011,10452,22463
"281",1852,"58",11812,10060,21872
"282",1852,"59",11468,9712,21180
"283",1852,"60",10809,9072,19881
"284",1852,"61",10876,8311,19187
"285",1852,"62",10615,7842,18457
"286",1852,"63",9320,7527,16847
"287",1852,"64",9884,8304,18188
"288",1852,"65",8612,6977,15589
"289",1852,"66",8242,6514,14756
"290",1852,"67",7518,5949,13467
"291",1852,"68",6710,5347,12057
"292",1852,"69",5694,4573,10267
"293",1852,"70",5053,3987,9040
"294",1852,"71",5692,4533,10225
"295",1852,"72",5220,3960,9180
"296",1852,"73",3729,2992,6721
"297",1852,"74",4113,3427,7540
"298",1852,"75",3410,2654,6064
"299",1852,"76",3262,2547,5809
"300",1852,"77",3051,2333,5384
"301",1852,"78",2517,2029,4546
"302",1852,"79",2309,1823,4132
"303",1852,"80",1884,1438,3322
"304",1852,"81",1649,1229,2878
"305",1852,"82",1370,972,2342
"306",1852,"83",1107,829,1936
"307",1852,"84",879,693,1572
"308",1852,"85",712,543,1255
"309",1852,"86",526,381,907
"310",1852,"87",414,307,721
"311",1852,"88",336,250,586
"312",1852,"89",256,181,437
"313",1852,"90",163,137,300
"314",1852,"91",147,97,244
"315",1852,"92",87,60,147
"316",1852,"93",56,40,96
"317",1852,"94",40.47,24,64.47
"318",1852,"95",31.53,20.17,51.7
"319",1852,"96",18,11.83,29.83
"320",1852,"97",14.55,8,22.55
"321",1852,"98",11.42,5,16.42
"322",1852,"99",3.03,3,6.03
"323",1852,"100",1.23,0,1.23
"324",1852,"101",0.77,0,0.77
"325",1852,"102",0,0,0
"326",1852,"103",0,0,0
"327",1852,"104",0,0,0
"328",1852,"105",0,0,0
"329",1852,"106",0,0,0
"330",1852,"107",0,0,0
"331",1852,"108",0,0,0
"332",1852,"109",0,0,0
"333",1852,"110+",0,0,0
"334",1853,"0",46633,47889,94522
"335",1853,"1",41676,42478,84154
"336",1853,"2",39494,40491,79985
"337",1853,"3",33012,33617,66629
"338",1853,"4",30982,31390,62372
"339",1853,"5",30177,30111,60288
"340",1853,"6",30424,30900,61324
"341",1853,"7",33463,33731,67194
"342",1853,"8",34214,35211,69425
"343",1853,"9",33352,33960,67312
"344",1853,"10",33389,33763,67152
"345",1853,"11",32955,34063,67018
"346",1853,"12",33655,34147,67802
"347",1853,"13",33606,34170,67776
"348",1853,"14",32809,33054,65863
"349",1853,"15",32023,32551,64574
"350",1853,"16",31064,32228,63292
"351",1853,"17",31198,31612,62810
"352",1853,"18",29157,29388,58545
"353",1853,"19",29242,29643,58885
"354",1853,"20",26469,26090,52559
"355",1853,"21",25796,26097,51893
"356",1853,"22",28262,27493,55755
"357",1853,"23",28775,27642,56417
"358",1853,"24",26013,25648,51661
"359",1853,"25",25975,24748,50723
"360",1853,"26",27742,26364,54106
"361",1853,"27",27960,26371,54331
"362",1853,"28",27878,27476,55354
"363",1853,"29",26763,25739,52502
"364",1853,"30",25239,24980,50219
"365",1853,"31",24252,23509,47761
"366",1853,"32",22713,21878,44591
"367",1853,"33",24309,23307,47616
"368",1853,"34",20211,19889,40100
"369",1853,"35",20482,20007,40489
"370",1853,"36",21944,21066,43010
"371",1853,"37",20402,20029,40431
"372",1853,"38",19756,19061,38817
"373",1853,"39",19603,18860,38463
"374",1853,"40",17926,17479,35405
"375",1853,"41",19164,18348,37512
"376",1853,"42",18373,17255,35628
"377",1853,"43",17734,16634,34368
"378",1853,"44",14947,14583,29530
"379",1853,"45",16513,15421,31934
"380",1853,"46",16078,15228,31306
"381",1853,"47",16111,15214,31325
"382",1853,"48",15680,14809,30489
"383",1853,"49",15617,14821,30438
"384",1853,"50",15590,14739,30329
"385",1853,"51",15579,14214,29793
"386",1853,"52",16589,14875,31464
"387",1853,"53",16164,14942,31106
"388",1853,"54",13384,12747,26131
"389",1853,"55",13820,12791,26611
"390",1853,"56",12725,11459,24184
"391",1853,"57",12629,10539,23168
"392",1853,"58",11739,10164,21903
"393",1853,"59",11527,9766,21293
"394",1853,"60",11161,9419,20580
"395",1853,"61",10504,8781,19285
"396",1853,"62",10562,8023,18585
"397",1853,"63",10282,7562,17844
"398",1853,"64",8961,7240,16201
"399",1853,"65",9509,8002,17511
"400",1853,"66",8222,6651,14873
"401",1853,"67",7882,6188,14070
"402",1853,"68",7150,5593,12743
"403",1853,"69",6348,5038,11386
"404",1853,"70",5325,4286,9611
"405",1853,"71",4700,3699,8399
"406",1853,"72",5335,4227,9562
"407",1853,"73",4851,3658,8509
"408",1853,"74",3362,2694,6056
"409",1853,"75",3750,3145,6895
"410",1853,"76",3076,2381,5457
"411",1853,"77",2936,2275,5211
"412",1853,"78",2711,2088,4799
"413",1853,"79",2205,1804,4009
"414",1853,"80",1940,1484,3424
"415",1853,"81",1628,1248,2876
"416",1853,"82",1397,1049,2446
"417",1853,"83",1142,804,1946
"418",1853,"84",922,667,1589
"419",1853,"85",729,567,1296
"420",1853,"86",572,433,1005
"421",1853,"87",417,288,705
"422",1853,"88",333,232,565
"423",1853,"89",269,202,471
"424",1853,"90",192,127,319
"425",1853,"91",122,103,225
"426",1853,"92",109,71,180
"427",1853,"93",58,41,99
"428",1853,"94",39,27,66
"429",1853,"95",28.47,12,40.47
"430",1853,"96",21.53,12.17,33.7
"431",1853,"97",10,8.83,18.83
"432",1853,"98",7.55,5,12.55
"433",1853,"99",8.42,1,9.42
"434",1853,"100",2.03,1,3.03
"435",1853,"101",0,0,0
"436",1853,"102",0,0,0
"437",1853,"103",0,0,0
"438",1853,"104",0,0,0
"439",1853,"105",0,0,0
"440",1853,"106",0,0,0
"441",1853,"107",0,0,0
"442",1853,"108",0,0,0
"443",1853,"109",0,0,0
"444",1853,"110+",0,0,0
"445",1854,"0",44895,46272,91167
"446",1854,"1",42245,43095,85340
"447",1854,"2",40009,40683,80692
"448",1854,"3",38433,39384,77817
"449",1854,"4",32391,32971,65362
"450",1854,"5",30606,30967,61573
"451",1854,"6",29890,29809,59699
"452",1854,"7",30177,30664,60841
"453",1854,"8",33242,33501,66743
"454",1854,"9",34006,34996,69002
"455",1854,"10",33148,33784,66932
"456",1854,"11",33205,33606,66811
"457",1854,"12",32764,33914,66678
"458",1854,"13",33469,33986,67455
"459",1854,"14",33420,34018,67438
"460",1854,"15",32614,32923,65537
"461",1854,"16",31843,32414,64257
"462",1854,"17",30881,32069,62950
"463",1854,"18",31006,31399,62405
"464",1854,"19",28960,29149,58109
"465",1854,"20",28999,29383,58382
"466",1854,"21",26237,25819,52056
"467",1854,"22",25570,25824,51394
"468",1854,"23",28031,27212,55243
"469",1854,"24",28540,27384,55924
"470",1854,"25",25783,25396,51179
"471",1854,"26",25709,24477,50186
"472",1854,"27",27483,26094,53577
"473",1854,"28",27682,26120,53802
"474",1854,"29",27601,27226,54827
"475",1854,"30",26486,25486,51972
"476",1854,"31",24955,24758,49713
"477",1854,"32",23950,23285,47235
"478",1854,"33",22395,21624,44019
"479",1854,"34",23980,23053,47033
"480",1854,"35",19922,19635,39557
"481",1854,"36",20215,19745,39960
"482",1854,"37",21668,20812,42480
"483",1854,"38",20106,19757,39863
"484",1854,"39",19454,18774,38228
"485",1854,"40",19299,18585,37884
"486",1854,"41",17634,17226,34860
"487",1854,"42",18892,18074,36966
"488",1854,"43",18101,16991,35092
"489",1854,"44",17481,16354,33835
"490",1854,"45",14708,14311,29019
"491",1854,"46",16284,15140,31424
"492",1854,"47",15846,14955,30801
"493",1854,"48",15876,14923,30799
"494",1854,"49",15438,14514,29952
"495",1854,"50",15355,14515,29870
"496",1854,"51",15334,14428,29762
"497",1854,"52",15290,13870,29160
"498",1854,"53",16284,14522,30806
"499",1854,"54",15852,14560,30412
"500",1854,"55",13067,12370,25437
"501",1854,"56",13504,12439,25943
"502",1854,"57",12401,11118,23519
"503",1854,"58",12314,10186,22500
"504",1854,"59",11411,9804,21215
"505",1854,"60",11177,9408,20585
"506",1854,"61",10812,9064,19876
"507",1854,"62",10139,8430,18569
"508",1854,"63",10170,7681,17851
"509",1854,"64",9859,7211,17070
"510",1854,"65",8525,6854,15379
"511",1854,"66",9059,7571,16630
"512",1854,"67",7790,6250,14040
"513",1854,"68",7425,5773,13198
"514",1854,"69",6722,5214,11936
"515",1854,"70",5935,4669,10604
"516",1854,"71",4930,3940,8870
"517",1854,"72",4301,3353,7654
"518",1854,"73",4905,3860,8765
"519",1854,"74",4408,3277,7685
"520",1854,"75",2932,2342,5274
"521",1854,"76",3361,2810,6171
"522",1854,"77",2713,2047,4760
"523",1854,"78",2571,1974,4545
"524",1854,"79",2346,1803,4149
"525",1854,"80",1895,1476,3371
"526",1854,"81",1651,1243,2894
"527",1854,"82",1371,1024,2395
"528",1854,"83",1137,852,1989
"529",1854,"84",909,625,1534
"530",1854,"85",735,514,1249
"531",1854,"86",556,420,976
"532",1854,"87",429,325,754
"533",1854,"88",304,215,519
"534",1854,"89",256,181,437
"535",1854,"90",204,134,338
"536",1854,"91",132,88,220
"537",1854,"92",95,80,175
"538",1854,"93",71,43,114
"539",1854,"94",42,29,71
"540",1854,"95",21,19,40
"541",1854,"96",19.47,7,26.47
"542",1854,"97",9.53,10.17,19.7
"543",1854,"98",5,4.83,9.83
"544",1854,"99",4.55,3,7.55
"545",1854,"100",1.42,0,1.42
"546",1854,"101",1.03,0,1.03
"547",1854,"102",0,0,0
"548",1854,"103",0,0,0
"549",1854,"104",0,0,0
"550",1854,"105",0,0,0
"551",1854,"106",0,0,0
"552",1854,"107",0,0,0
"553",1854,"108",0,0,0
"554",1854,"109",0,0,0
"555",1854,"110+",0,0,0
"556",1855,"0",44844,46099,90943
"557",1855,"1",40651,41663,82314
"558",1855,"2",40405,41097,81502
"559",1855,"3",38932,39561,78493
"560",1855,"4",37767,38704,76471
"561",1855,"5",31880,32514,64394
"562",1855,"6",30247,30648,60895
"563",1855,"7",29594,29567,59161
"564",1855,"8",29932,30430,60362
"565",1855,"9",33029,33286,66315
"566",1855,"10",33801,34813,68614
"567",1855,"11",32964,33614,66578
"568",1855,"12",33030,33457,66487
"569",1855,"13",32603,33765,66368
"570",1855,"14",33297,33835,67132
"571",1855,"15",33229,33881,67110
"572",1855,"16",32438,32784,65222
"573",1855,"17",31663,32255,63918
"574",1855,"18",30692,31856,62548
"575",1855,"19",30813,31160,61973
"576",1855,"20",28721,28888,57609
"577",1855,"21",28770,29110,57880
"578",1855,"22",26013,25543,51556
"579",1855,"23",25340,25539,50879
"580",1855,"24",27796,26948,54744
"581",1855,"25",28315,27138,55453
"582",1855,"26",25529,25141,50670
"583",1855,"27",25460,24225,49685
"584",1855,"28",27214,25860,53074
"585",1855,"29",27413,25888,53301
"586",1855,"30",27328,26977,54305
"587",1855,"31",26206,25256,51462
"588",1855,"32",24657,24527,49184
"589",1855,"33",23636,23026,46662
"590",1855,"34",22070,21365,43435
"591",1855,"35",23691,22812,46503
"592",1855,"36",19653,19402,39055
"593",1855,"37",19938,19517,39455
"594",1855,"38",21372,20566,41938
"595",1855,"39",19803,19496,39299
"596",1855,"40",19152,18521,37673
"597",1855,"41",19012,18349,37361
"598",1855,"42",17367,16971,34338
"599",1855,"43",18627,17828,36455
"600",1855,"44",17855,16730,34585
"601",1855,"45",17245,16090,33335
"602",1855,"46",14478,14029,28507
"603",1855,"47",16053,14869,30922
"604",1855,"48",15612,14668,30280
"605",1855,"49",15634,14632,30266
"606",1855,"50",15183,14214,29397
"607",1855,"51",15109,14211,29320
"608",1855,"52",15055,14092,29147
"609",1855,"53",14995,13542,28537
"610",1855,"54",15983,14181,30164
"611",1855,"55",15545,14223,29768
"612",1855,"56",12764,12027,24791
"613",1855,"57",13198,12081,25279
"614",1855,"58",12101,10747,22848
"615",1855,"59",11997,9829,21826
"616",1855,"60",11070,9466,20536
"617",1855,"61",10837,9073,19910
"618",1855,"62",10460,8722,19182
"619",1855,"63",9762,8088,17850
"620",1855,"64",9762,7331,17093
"621",1855,"65",9447,6851,16298
"622",1855,"66",8106,6471,14577
"623",1855,"67",8643,7198,15841
"624",1855,"68",7338,5851,13189
"625",1855,"69",6989,5403,12392
"626",1855,"70",6288,4847,11135
"627",1855,"71",5550,4321,9871
"628",1855,"72",4569,3590,8159
"629",1855,"73",3912,3002,6914
"630",1855,"74",4505,3510,8015
"631",1855,"75",4002,2952,6954
"632",1855,"76",2550,2031,4581
"633",1855,"77",3009,2504,5513
"634",1855,"78",2364,1774,4138
"635",1855,"79",2228,1714,3942
"636",1855,"80",1952,1460,3412
"637",1855,"81",1620,1266,2886
"638",1855,"82",1397,1057,2454
"639",1855,"83",1129,847,1976
"640",1855,"84",932,678,1610
"641",1855,"85",743,494,1237
"642",1855,"86",579,402,981
"643",1855,"87",423,318,741
"644",1855,"88",323,236,559
"645",1855,"89",222,164,386
"646",1855,"90",196,132,328
"647",1855,"91",156,94,250
"648",1855,"92",97,55,152
"649",1855,"93",74,54,128
"650",1855,"94",52,31,83
"651",1855,"95",31,19,50
"652",1855,"96",13,11,24
"653",1855,"97",13.47,4,17.47
"654",1855,"98",5.53,5.17,10.7
"655",1855,"99",3,3.83,6.83
"656",1855,"100",2.55,1,3.55
"657",1855,"101",1.42,0,1.42
"658",1855,"102",1.03,0,1.03
"659",1855,"103",0,0,0
"660",1855,"104",0,0,0
"661",1855,"105",0,0,0
"662",1855,"106",0,0,0
"663",1855,"107",0,0,0
"664",1855,"108",0,0,0
"665",1855,"109",0,0,0
"666",1855,"110+",0,0,0
"667",1856,"0",43640,45247,88887
"668",1856,"1",39780,40442,80222
"669",1856,"2",38195,39128,77323
"670",1856,"3",38894,39508,78402
"671",1856,"4",37934,38587,76521
"672",1856,"5",37134,38028,75162
"673",1856,"6",31389,32060,63449
"674",1856,"7",29869,30268,60137
"675",1856,"8",29300,29261,58561
"676",1856,"9",29692,30193,59885
"677",1856,"10",32791,33066,65857
"678",1856,"11",33581,34593,68174
"679",1856,"12",32759,33448,66207
"680",1856,"13",32844,33315,66159
"681",1856,"14",32413,33613,66026
"682",1856,"15",33093,33692,66785
"683",1856,"16",33040,33738,66778
"684",1856,"17",32243,32623,64866
"685",1856,"18",31460,32041,63501
"686",1856,"19",30487,31615,62102
"687",1856,"20",30548,30891,61439
"688",1856,"21",28458,28602,57060
"689",1856,"22",28512,28822,57334
"690",1856,"23",25752,25247,50999
"691",1856,"24",25077,25268,50345
"692",1856,"25",27544,26684,54228
"693",1856,"26",28029,26854,54883
"694",1856,"27",25247,24863,50110
"695",1856,"28",25155,23968,49123
"696",1856,"29",26908,25605,52513
"697",1856,"30",27108,25621,52729
"698",1856,"31",27019,26734,53753
"699",1856,"32",25877,25012,50889
"700",1856,"33",24313,24251,48564
"701",1856,"34",23280,22750,46030
"702",1856,"35",21746,21099,42845
"703",1856,"36",23384,22545,45929
"704",1856,"37",19336,19142,38478
"705",1856,"38",19601,19238,38839
"706",1856,"39",21028,20271,41299
"707",1856,"40",19465,19196,38661
"708",1856,"41",18835,18229,37064
"709",1856,"42",18717,18031,36748
"710",1856,"43",17072,16664,33736
"711",1856,"44",18353,17502,35855
"712",1856,"45",17589,16418,34007
"713",1856,"46",16985,15771,32756
"714",1856,"47",14217,13721,27938
"715",1856,"48",15789,14539,30328
"716",1856,"49",15341,14334,29675
"717",1856,"50",15345,14285,29630
"718",1856,"51",14900,13860,28760
"719",1856,"52",14790,13820,28610
"720",1856,"53",14713,13701,28414
"721",1856,"54",14642,13123,27765
"722",1856,"55",15623,13766,29389
"723",1856,"56",15171,13820,28991
"724",1856,"57",12366,11619,23985
"725",1856,"58",12810,11659,24469
"726",1856,"59",11713,10334,22047
"727",1856,"60",11598,9432,21030
"728",1856,"61",10672,9073,19745
"729",1856,"62",10419,8655,19074
"730",1856,"63",10007,8289,18296
"731",1856,"64",9274,7644,16918
"732",1856,"65",9268,6885,16153
"733",1856,"66",8943,6386,15329
"734",1856,"67",7590,6017,13607
"735",1856,"68",8067,6713,14780
"736",1856,"69",6777,5391,12168
"737",1856,"70",6424,4941,11365
"738",1856,"71",5777,4424,10201
"739",1856,"72",5061,3907,8968
"740",1856,"73",4087,3200,7287
"741",1856,"74",3454,2631,6085
"742",1856,"75",4022,3143,7165
"743",1856,"76",3533,2582,6115
"744",1856,"77",2095,1639,3734
"745",1856,"78",2538,2135,4673
"746",1856,"79",1933,1450,3383
"747",1856,"80",1807,1351,3158
"748",1856,"81",1617,1183,2800
"749",1856,"82",1306,992,2298
"750",1856,"83",1081,823,1904
"751",1856,"84",848,638,1486
"752",1856,"85",709,521,1230
"753",1856,"86",538,361,899
"754",1856,"87",411,283,694
"755",1856,"88",292,215,507
"756",1856,"89",244,186,430
"757",1856,"90",152,109,261
"758",1856,"91",129,81,210
"759",1856,"92",97,63,160
"760",1856,"93",56,29,85
"761",1856,"94",37,37,74
"762",1856,"95",27,18,45
"763",1856,"96",18,13,31
"764",1856,"97",6,5,11
"765",1856,"98",8.47,1,9.47
"766",1856,"99",3.53,2.17,5.7
"767",1856,"100",1,0.83,1.83
"768",1856,"101",0,0,0
"769",1856,"102",0,0,0
"770",1856,"103",0,0,0
"771",1856,"104",0,0,0
"772",1856,"105",0,0,0
"773",1856,"106",0,0,0
"774",1856,"107",0,0,0
"775",1856,"108",0,0,0
"776",1856,"109",0,0,0
"777",1856,"110+",0,0,0
"778",1857,"0",45686,47169,92855
"779",1857,"1",39341,40433,79774
"780",1857,"2",37884,38515,76399
"781",1857,"3",36993,37879,74872
"782",1857,"4",38093,38674,76767
"783",1857,"5",37357,37983,75340
"784",1857,"6",36633,37520,74153
"785",1857,"7",31034,31686,62720
"786",1857,"8",29604,29985,59589
"787",1857,"9",29095,29057,58152
"788",1857,"10",29489,30012,59501
"789",1857,"11",32604,32893,65497
"790",1857,"12",33407,34449,67856
"791",1857,"13",32601,33310,65911
"792",1857,"14",32678,33169,65847
"793",1857,"15",32231,33478,65709
"794",1857,"16",32910,33555,66465
"795",1857,"17",32838,33581,66419
"796",1857,"18",32033,32414,64447
"797",1857,"19",31245,31804,63049
"798",1857,"20",30236,31358,61594
"799",1857,"21",30318,30623,60941
"800",1857,"22",28233,28332,56565
"801",1857,"23",28285,28546,56831
"802",1857,"24",25523,24996,50519
"803",1857,"25",24860,25038,49898
"804",1857,"26",27300,26451,53751
"805",1857,"27",27789,26627,54416
"806",1857,"28",24989,24655,49644
"807",1857,"29",24898,23764,48662
"808",1857,"30",26649,25376,52025
"809",1857,"31",26843,25400,52243
"810",1857,"32",26736,26512,53248
"811",1857,"33",25581,24762,50343
"812",1857,"34",24006,24001,48007
"813",1857,"35",23005,22514,45519
"814",1857,"36",21490,20869,42359
"815",1857,"37",23119,22322,45441
"816",1857,"38",19054,18902,37956
"817",1857,"39",19312,18984,38296
"818",1857,"40",20738,20025,40763
"819",1857,"41",19188,18968,38156
"820",1857,"42",18578,17981,36559
"821",1857,"43",18460,17793,36253
"822",1857,"44",16834,16410,33244
"823",1857,"45",18126,17247,35373
"824",1857,"46",17370,16148,33518
"825",1857,"47",16763,15510,32273
"826",1857,"48",13992,13442,27434
"827",1857,"49",15557,14256,29813
"828",1857,"50",15092,14053,29145
"829",1857,"51",15101,14011,29112
"830",1857,"52",14625,13557,28182
"831",1857,"53",14517,13509,28026
"832",1857,"54",14447,13362,27809
"833",1857,"55",14371,12790,27161
"834",1857,"56",15339,13440,28779
"835",1857,"57",14865,13489,28354
"836",1857,"58",12069,11278,23347
"837",1857,"59",12507,11321,23828
"838",1857,"60",11395,10006,21401
"839",1857,"61",11280,9107,20387
"840",1857,"62",10342,8734,19076
"841",1857,"63",10064,8308,18372
"842",1857,"64",9625,7933,17558
"843",1857,"65",8871,7287,16158
"844",1857,"66",8845,6514,15359
"845",1857,"67",8544,6046,14590
"846",1857,"68",7176,5670,12846
"847",1857,"69",7640,6352,13992
"848",1857,"70",6325,5002,11327
"849",1857,"71",5993,4583,10576
"850",1857,"72",5344,4073,9417
"851",1857,"73",4653,3586,8239
"852",1857,"74",3715,2902,6617
"853",1857,"75",3052,2340,5392
"854",1857,"76",3627,2853,6480
"855",1857,"77",3177,2297,5474
"856",1857,"78",1751,1386,3137
"857",1857,"79",2238,1894,4132
"858",1857,"80",1789,1394,3183
"859",1857,"81",1561,1151,2712
"860",1857,"82",1366,999,2365
"861",1857,"83",1062,817,1879
"862",1857,"84",871,650,1521
"863",1857,"85",687,513,1200
"864",1857,"86",566,418,984
"865",1857,"87",427,278,705
"866",1857,"88",328,220,548
"867",1857,"89",218,176,394
"868",1857,"90",188,126,314
"869",1857,"91",113,74,187
"870",1857,"92",89,63,152
"871",1857,"93",74,51,125
"872",1857,"94",38,23,61
"873",1857,"95",22,21,43
"874",1857,"96",18,7,25
"875",1857,"97",11,7,18
"876",1857,"98",4,2,6
"877",1857,"99",5.47,1,6.47
"878",1857,"100",0.53,2.17,2.7
"879",1857,"101",0,0.83,0.83
"880",1857,"102",0,0,0
"881",1857,"103",0,0,0
"882",1857,"104",0,0,0
"883",1857,"105",0,0,0
"884",1857,"106",0,0,0
"885",1857,"107",0,0,0
"886",1857,"108",0,0,0
"887",1857,"109",0,0,0
"888",1857,"110+",0,0,0
"889",1858,"0",47778,48501,96279
"890",1858,"1",40662,41529,82191
"891",1858,"2",37337,38386,75723
"892",1858,"3",36746,37299,74045
"893",1858,"4",36234,37112,73346
"894",1858,"5",37534,38095,75629
"895",1858,"6",36885,37512,74397
"896",1858,"7",36255,37153,73408
"897",1858,"8",30743,31385,62128
"898",1858,"9",29370,29747,59117
"899",1858,"10",28880,28858,57738
"900",1858,"11",29305,29832,59137
"901",1858,"12",32418,32741,65159
"902",1858,"13",33228,34300,67528
"903",1858,"14",32414,33157,65571
"904",1858,"15",32476,33030,65506
"905",1858,"16",32030,33327,65357
"906",1858,"17",32691,33373,66064
"907",1858,"18",32609,33339,65948
"908",1858,"19",31797,32140,63937
"909",1858,"20",30969,31509,62478
"910",1858,"21",29983,31050,61033
"911",1858,"22",30070,30313,60383
"912",1858,"23",27981,28015,55996
"913",1858,"24",28031,28257,56288
"914",1858,"25",25282,24731,50013
"915",1858,"26",24589,24772,49361
"916",1858,"27",27036,26192,53228
"917",1858,"28",27505,26392,53897
"918",1858,"29",24705,24426,49131
"919",1858,"30",24609,23515,48124
"920",1858,"31",26351,25141,51492
"921",1858,"32",26525,25162,51687
"922",1858,"33",26404,26244,52648
"923",1858,"34",25237,24493,49730
"924",1858,"35",23690,23741,47431
"925",1858,"36",22702,22254,44956
"926",1858,"37",21178,20616,41794
"927",1858,"38",22786,22050,44836
"928",1858,"39",18714,18615,37329
"929",1858,"40",18978,18706,37684
"930",1858,"41",20424,19767,40191
"931",1858,"42",18898,18689,37587
"932",1858,"43",18288,17713,36001
"933",1858,"44",18192,17507,35699
"934",1858,"45",16582,16132,32714
"935",1858,"46",17885,16959,34844
"936",1858,"47",17127,15870,32997
"937",1858,"48",16517,15214,31731
"938",1858,"49",13738,13143,26881
"939",1858,"50",15282,13956,29238
"940",1858,"51",14821,13757,28578
"941",1858,"52",14796,13683,28479
"942",1858,"53",14333,13226,27559
"943",1858,"54",14239,13155,27394
"944",1858,"55",14164,13013,27177
"945",1858,"56",14042,12431,26473
"946",1858,"57",14960,13064,28024
"947",1858,"58",14495,13101,27596
"948",1858,"59",11709,10880,22589
"949",1858,"60",12145,10922,23067
"950",1858,"61",11034,9611,20645
"951",1858,"62",10892,8707,19599
"952",1858,"63",9913,8338,18251
"953",1858,"64",9600,7903,17503
"954",1858,"65",9140,7526,16666
"955",1858,"66",8365,6862,15227
"956",1858,"67",8371,6134,14505
"957",1858,"68",8056,5667,13723
"958",1858,"69",6671,5283,11954
"959",1858,"70",7106,5938,13044
"960",1858,"71",5828,4602,10430
"961",1858,"72",5504,4172,9676
"962",1858,"73",4846,3683,8529
"963",1858,"74",4165,3212,7377
"964",1858,"75",3259,2563,5822
"965",1858,"76",2658,2023,4681
"966",1858,"77",3254,2520,5774
"967",1858,"78",2799,1985,4784
"968",1858,"79",1391,1095,2486
"969",1858,"80",1763,1347,3110
"970",1858,"81",1497,1140,2637
"971",1858,"82",1286,944,2230
"972",1858,"83",1097,793,1890
"973",1858,"84",829,643,1472
"974",1858,"85",686,490,1176
"975",1858,"86",515,371,886
"976",1858,"87",414,297,711
"977",1858,"88",301,197,498
"978",1858,"89",237,159,396
"979",1858,"90",151,127,278
"980",1858,"91",133,78,211
"981",1858,"92",76,51,127
"982",1858,"93",53,40,93
"983",1858,"94",48,35,83
"984",1858,"95",26,15,41
"985",1858,"96",16,12,28
"986",1858,"97",12,7,19
"987",1858,"98",7,6,13
"988",1858,"99",2,1,3
"989",1858,"100",1.47,0,1.47
"990",1858,"101",0.53,0,0.53
"991",1858,"102",0,0,0
"992",1858,"103",0,0,0
"993",1858,"104",0,0,0
"994",1858,"105",0,0,0
"995",1858,"106",0,0,0
"996",1858,"107",0,0,0
"997",1858,"108",0,0,0
"998",1858,"109",0,0,0
"999",1858,"110+",0,0,0
"1000",1859,"0",45198,46245,91443
"1001",1859,"1",42614,42681,85295
"1002",1859,"2",38864,39564,78428
"1003",1859,"3",36111,37111,73222
"1004",1859,"4",35965,36480,72445
"1005",1859,"5",35616,36448,72064
"1006",1859,"6",36981,37506,74487
"1007",1859,"7",36483,37064,73547
"1008",1859,"8",35918,36781,72699
"1009",1859,"9",30446,31086,61532
"1010",1859,"10",29119,29521,58640
"1011",1859,"11",28684,28676,57360
"1012",1859,"12",29105,29670,58775
"1013",1859,"13",32223,32576,64799
"1014",1859,"14",33027,34118,67145
"1015",1859,"15",32197,32982,65179
"1016",1859,"16",32260,32851,65111
"1017",1859,"17",31794,33122,64916
"1018",1859,"18",32445,33099,65544
"1019",1859,"19",32359,33030,65389
"1020",1859,"20",31502,31805,63307
"1021",1859,"21",30693,31158,61851
"1022",1859,"22",29713,30697,60410
"1023",1859,"23",29796,29952,59748
"1024",1859,"24",27705,27685,55390
"1025",1859,"25",27764,27953,55717
"1026",1859,"26",24976,24423,49399
"1027",1859,"27",24290,24469,48759
"1028",1859,"28",26714,25915,52629
"1029",1859,"29",27184,26120,53304
"1030",1859,"30",24379,24132,48511
"1031",1859,"31",24273,23240,47513
"1032",1859,"32",25992,24864,50856
"1033",1859,"33",26148,24851,50999
"1034",1859,"34",26014,25934,51948
"1035",1859,"35",24870,24193,49063
"1036",1859,"36",23330,23440,46770
"1037",1859,"37",22332,21961,44293
"1038",1859,"38",20783,20300,41083
"1039",1859,"39",22383,21717,44100
"1040",1859,"40",18325,18286,36611
"1041",1859,"41",18621,18396,37017
"1042",1859,"42",20093,19432,39525
"1043",1859,"43",18567,18365,36932
"1044",1859,"44",17981,17368,35349
"1045",1859,"45",17906,17179,35085
"1046",1859,"46",16311,15798,32109
"1047",1859,"47",17611,16635,34246
"1048",1859,"48",16849,15522,32371
"1049",1859,"49",16229,14861,31090
"1050",1859,"50",13441,12790,26231
"1051",1859,"51",14999,13607,28606
"1052",1859,"52",14501,13370,27871
"1053",1859,"53",14457,13294,27751
"1054",1859,"54",13985,12812,26797
"1055",1859,"55",13884,12746,26630
"1056",1859,"56",13787,12598,26385
"1057",1859,"57",13635,11999,25634
"1058",1859,"58",14563,12618,27181
"1059",1859,"59",14099,12638,26737
"1060",1859,"60",11302,10410,21712
"1061",1859,"61",11739,10457,22196
"1062",1859,"62",10616,9164,19780
"1063",1859,"63",10445,8282,18727
"1064",1859,"64",9431,7901,17332
"1065",1859,"65",9098,7448,16546
"1066",1859,"66",8616,7037,15653
"1067",1859,"67",7834,6408,14242
"1068",1859,"68",7783,5668,13451
"1069",1859,"69",7478,5236,12714
"1070",1859,"70",6086,4856,10942
"1071",1859,"71",6543,5511,12054
"1072",1859,"72",5257,4149,9406
"1073",1859,"73",4944,3749,8693
"1074",1859,"74",4313,3283,7596
"1075",1859,"75",3654,2858,6512
"1076",1859,"76",2806,2239,5045
"1077",1859,"77",2233,1685,3918
"1078",1859,"78",2826,2205,5031
"1079",1859,"79",2406,1697,4103
"1080",1859,"80",1673,1272,2945
"1081",1859,"81",1454,1108,2562
"1082",1859,"82",1205,915,2120
"1083",1859,"83",1006,741,1747
"1084",1859,"84",859,602,1461
"1085",1859,"85",642,498,1140
"1086",1859,"86",517,366,883
"1087",1859,"87",371,257,628
"1088",1859,"88",297,197,494
"1089",1859,"89",227,141,368
"1090",1859,"90",165,108,273
"1091",1859,"91",106,83,189
"1092",1859,"92",80,52,132
"1093",1859,"93",44,27,71
"1094",1859,"94",31,23,54
"1095",1859,"95",33,25,58
"1096",1859,"96",17,9,26
"1097",1859,"97",7,8,15
"1098",1859,"98",4,5,9
"1099",1859,"99",3,3,6
"1100",1859,"100",1,0,1
"1101",1859,"101",0,0,0
"1102",1859,"102",0,0,0
"1103",1859,"103",0,0,0
"1104",1859,"104",0,0,0
"1105",1859,"105",0,0,0
"1106",1859,"106",0,0,0
"1107",1859,"107",0,0,0
"1108",1859,"108",0,0,0
"1109",1859,"109",0,0,0
"1110",1859,"110+",0,0,0
"1111",1860,"0",48235,49051,97286
"1112",1860,"1",39115,39541,78656
"1113",1860,"2",39753,39944,79697
"1114",1860,"3",37379,37689,75068
"1115",1860,"4",35039,35786,70825
"1116",1860,"5",35347,35944,71291
"1117",1860,"6",35196,35704,70900
"1118",1860,"7",36253,36809,73062
"1119",1860,"8",35493,36082,71575
"1120",1860,"9",35205,36156,71361
"1121",1860,"10",35607,36123,71730
"1122",1860,"11",30539,31541,62080
"1123",1860,"12",28471,28742,57213
"1124",1860,"13",29098,29772,58870
"1125",1860,"14",32113,32795,64908
"1126",1860,"15",32256,33214,65470
"1127",1860,"16",31671,32062,63733
"1128",1860,"17",31702,31477,63179
"1129",1860,"18",31039,32691,63730
"1130",1860,"19",32572,32106,64678
"1131",1860,"20",32385,32050,64435
"1132",1860,"21",31537,30636,62173
"1133",1860,"22",30009,29473,59482
"1134",1860,"23",30441,29332,59773
"1135",1860,"24",28401,27389,55790
"1136",1860,"25",27977,26637,54614
"1137",1860,"26",26992,26079,53071
"1138",1860,"27",24942,23826,48768
"1139",1860,"28",23904,23256,47160
"1140",1860,"29",26753,25385,52138
"1141",1860,"30",26354,25256,51610
"1142",1860,"31",23453,22991,46444
"1143",1860,"32",22940,22384,45324
"1144",1860,"33",24425,23203,47628
"1145",1860,"34",24660,23481,48141
"1146",1860,"35",24772,24228,49000
"1147",1860,"36",24208,23590,47798
"1148",1860,"37",23077,22872,45949
"1149",1860,"38",21779,21572,43351
"1150",1860,"39",21662,20534,42196
"1151",1860,"40",21165,20971,42136
"1152",1860,"41",19057,18678,37735
"1153",1860,"42",18516,18312,36828
"1154",1860,"43",20096,19273,39369
"1155",1860,"44",18739,18135,36874
"1156",1860,"45",17802,17032,34834
"1157",1860,"46",17403,16461,33864
"1158",1860,"47",16349,15715,32064
"1159",1860,"48",17280,16190,33470
"1160",1860,"49",17013,15670,32683
"1161",1860,"50",15070,14022,29092
"1162",1860,"51",13640,13075,26715
"1163",1860,"52",14439,13379,27818
"1164",1860,"53",14244,13191,27435
"1165",1860,"54",13845,12732,26577
"1166",1860,"55",13665,12448,26113
"1167",1860,"56",13369,12324,25693
"1168",1860,"57",13246,12263,25509
"1169",1860,"58",13013,11455,24468
"1170",1860,"59",13769,12048,25817
"1171",1860,"60",12589,11381,23970
"1172",1860,"61",10859,10053,20912
"1173",1860,"62",11217,9770,20987
"1174",1860,"63",10156,8734,18890
"1175",1860,"64",9730,7862,17592
"1176",1860,"65",8998,7512,16510
"1177",1860,"66",8545,7008,15553
"1178",1860,"67",8406,6609,15015
"1179",1860,"68",7580,6117,13697
"1180",1860,"69",7949,5620,13569
"1181",1860,"70",6074,4441,10515
"1182",1860,"71",5738,4519,10257
"1183",1860,"72",5796,4544,10340
"1184",1860,"73",4938,3732,8670
"1185",1860,"74",4479,3433,7912
"1186",1860,"75",3747,2818,6565
"1187",1860,"76",2999,2888,5887
"1188",1860,"77",2599,2049,4648
"1189",1860,"78",2247,1688,3935
"1190",1860,"79",2413,1787,4200
"1191",1860,"80",1726,1250,2976
"1192",1860,"81",1370,1037,2407
"1193",1860,"82",1173,901,2074
"1194",1860,"83",937,729,1666
"1195",1860,"84",777,568,1345
"1196",1860,"85",677,467,1144
"1197",1860,"86",473,379,852
"1198",1860,"87",382,267,649
"1199",1860,"88",269,179,448
"1200",1860,"89",217,144,361
"1201",1860,"90",153,90,243
"1202",1860,"91",117,74,191
"1203",1860,"92",80,59,139
"1204",1860,"93",53,34,87
"1205",1860,"94",25,17,42
"1206",1860,"95",22,13,35
"1207",1860,"96",22,13,35
"1208",1860,"97",11,7,18
"1209",1860,"98",3,4,7
"1210",1860,"99",1,3,4
"1211",1860,"100",1,0,1
"1212",1860,"101",0,0,0
"1213",1860,"102",0,0,0
"1214",1860,"103",0,0,0
"1215",1860,"104",0,0,0
"1216",1860,"105",0,0,0
"1217",1860,"106",0,0,0
"1218",1860,"107",0,0,0
"1219",1860,"108",0,0,0
"1220",1860,"109",0,0,0
"1221",1860,"110+",0,0,0
"1222",1861,"0",45473,47142,92615
"1223",1861,"1",43250,43491,86741
"1224",1861,"2",37154,37609,74763
"1225",1861,"3",38418,38524,76942
"1226",1861,"4",36482,36780,73262
"1227",1861,"5",34372,35147,69519
"1228",1861,"6",34709,35318,70027
"1229",1861,"7",34740,35195,69935
"1230",1861,"8",35892,36316,72208
"1231",1861,"9",35118,35669,70787
"1232",1861,"10",34939,35776,70715
"1233",1861,"11",35312,35695,71007
"1234",1861,"12",30252,31124,61376
"1235",1861,"13",28304,28448,56752
"1236",1861,"14",28945,29448,58393
"1237",1861,"15",31910,32465,64375
"1238",1861,"16",32033,32827,64860
"1239",1861,"17",31330,31630,62960
"1240",1861,"18",31442,31083,62525
"1241",1861,"19",30762,32145,62907
"1242",1861,"20",32246,31603,63849
"1243",1861,"21",32052,31474,63526
"1244",1861,"22",31105,30086,61191
"1245",1861,"23",29623,28952,58575
"1246",1861,"24",30029,28897,58926
"1247",1861,"25",28070,26997,55067
"1248",1861,"26",27598,26281,53879
"1249",1861,"27",26738,25795,52533
"1250",1861,"28",24612,23529,48141
"1251",1861,"29",23665,23034,46699
"1252",1861,"30",26463,25091,51554
"1253",1861,"31",26004,24944,50948
"1254",1861,"32",23156,22674,45830
"1255",1861,"33",22692,22114,44806
"1256",1861,"34",24089,22934,47023
"1257",1861,"35",24342,23221,47563
"1258",1861,"36",24405,23901,48306
"1259",1861,"37",23841,23275,47116
"1260",1861,"38",22704,22577,45281
"1261",1861,"39",21455,21311,42766
"1262",1861,"40",21300,20242,41542
"1263",1861,"41",20841,20692,41533
"1264",1861,"42",18747,18398,37145
"1265",1861,"43",18272,18053,36325
"1266",1861,"44",19792,18954,38746
"1267",1861,"45",18421,17819,36240
"1268",1861,"46",17539,16747,34286
"1269",1861,"47",17153,16181,33334
"1270",1861,"48",16065,15391,31456
"1271",1861,"49",16977,15826,32803
"1272",1861,"50",16679,15299,31978
"1273",1861,"51",14794,13696,28490
"1274",1861,"52",13372,12755,26127
"1275",1861,"53",14135,13079,27214
"1276",1861,"54",13933,12846,26779
"1277",1861,"55",13539,12383,25922
"1278",1861,"56",13366,12103,25469
"1279",1861,"57",13099,11969,25068
"1280",1861,"58",12907,11890,24797
"1281",1861,"59",12676,11062,23738
"1282",1861,"60",13371,11612,24983
"1283",1861,"61",12205,10958,23163
"1284",1861,"62",10517,9676,20193
"1285",1861,"63",10819,9347,20166
"1286",1861,"64",9773,8326,18099
"1287",1861,"65",9316,7474,16790
"1288",1861,"66",8595,7106,15701
"1289",1861,"67",8141,6633,14774
"1290",1861,"68",7963,6206,14169
"1291",1861,"69",7171,5721,12892
"1292",1861,"70",7441,5215,12656
"1293",1861,"71",5691,4115,9806
"1294",1861,"72",5326,4150,9476
"1295",1861,"73",5310,4156,9466
"1296",1861,"74",4495,3401,7896
"1297",1861,"75",4055,3103,7158
"1298",1861,"76",3361,2504,5865
"1299",1861,"77",2667,2535,5202
"1300",1861,"78",2284,1801,4085
"1301",1861,"79",1964,1457,3421
"1302",1861,"80",1818,1341,3159
"1303",1861,"81",1463,1056,2519
"1304",1861,"82",1138,857,1995
"1305",1861,"83",949,742,1691
"1306",1861,"84",748,583,1331
"1307",1861,"85",632,457,1089
"1308",1861,"86",537,368,905
"1309",1861,"87",357,298,655
"1310",1861,"88",292,192,484
"1311",1861,"89",209,135,344
"1312",1861,"90",144,108,252
"1313",1861,"91",109,64,173
"1314",1861,"92",78,50,128
"1315",1861,"93",52,39,91
"1316",1861,"94",32,26,58
"1317",1861,"95",15,11,26
"1318",1861,"96",13,7,20
"1319",1861,"97",14,8,22
"1320",1861,"98",4,4,8
"1321",1861,"99",2,3,5
"1322",1861,"100",0,1,1
"1323",1861,"101",0,0,0
"1324",1861,"102",0,0,0
"1325",1861,"103",0,0,0
"1326",1861,"104",0,0,0
"1327",1861,"105",0,0,0
"1328",1861,"106",0,0,0
"1329",1861,"107",0,0,0
"1330",1861,"108",0,0,0
"1331",1861,"109",0,0,0
"1332",1861,"110+",0,0,0
"1333",1862,"0",50227,51739,101966
"1334",1862,"1",40716,41875,82591
"1335",1862,"2",41060,41355,82415
"1336",1862,"3",35873,36325,72198
"1337",1862,"4",37571,37658,75229
"1338",1862,"5",35794,36112,71906
"1339",1862,"6",33805,34600,68405
"1340",1862,"7",34314,34928,69242
"1341",1862,"8",34424,34852,69276
"1342",1862,"9",35609,36042,71651
"1343",1862,"10",34840,35428,70268
"1344",1862,"11",34702,35561,70263
"1345",1862,"12",35116,35516,70632
"1346",1862,"13",30080,30960,61040
"1347",1862,"14",28129,28319,56448
"1348",1862,"15",28752,29317,58069
"1349",1862,"16",31696,32299,63995
"1350",1862,"17",31816,32625,64441
"1351",1862,"18",31131,31399,62530
"1352",1862,"19",31216,30840,62056
"1353",1862,"20",30508,31835,62343
"1354",1862,"21",32012,31282,63294
"1355",1862,"22",31791,31170,62961
"1356",1862,"23",30854,29800,60654
"1357",1862,"24",29370,28679,58049
"1358",1862,"25",29781,28634,58415
"1359",1862,"26",27795,26745,54540
"1360",1862,"27",27327,26032,53359
"1361",1862,"28",26465,25560,52025
"1362",1862,"29",24347,23309,47656
"1363",1862,"30",23383,22806,46189
"1364",1862,"31",26180,24869,51049
"1365",1862,"32",25715,24736,50451
"1366",1862,"33",22851,22466,45317
"1367",1862,"34",22395,21916,44311
"1368",1862,"35",23798,22707,46505
"1369",1862,"36",24033,22948,46981
"1370",1862,"37",24088,23636,47724
"1371",1862,"38",23527,23022,46549
"1372",1862,"39",22394,22319,44713
"1373",1862,"40",21145,21032,42177
"1374",1862,"41",20997,19983,40980
"1375",1862,"42",20540,20424,40964
"1376",1862,"43",18467,18148,36615
"1377",1862,"44",18018,17765,35783
"1378",1862,"45",19550,18660,38210
"1379",1862,"46",18194,17526,35720
"1380",1862,"47",17302,16457,33759
"1381",1862,"48",16905,15890,32795
"1382",1862,"49",15811,15100,30911
"1383",1862,"50",16713,15508,32221
"1384",1862,"51",16435,15007,31442
"1385",1862,"52",14533,13406,27939
"1386",1862,"53",13127,12479,25606
"1387",1862,"54",13869,12770,26639
"1388",1862,"55",13635,12534,26169
"1389",1862,"56",13241,12070,25311
"1390",1862,"57",13059,11760,24819
"1391",1862,"58",12806,11611,24417
"1392",1862,"59",12585,11523,24108
"1393",1862,"60",12285,10677,22962
"1394",1862,"61",12965,11208,24173
"1395",1862,"62",11811,10545,22356
"1396",1862,"63",10118,9253,19371
"1397",1862,"64",10415,8923,19338
"1398",1862,"65",9365,7934,17299
"1399",1862,"66",8884,7085,15969
"1400",1862,"67",8184,6740,14924
"1401",1862,"68",7725,6235,13960
"1402",1862,"69",7504,5816,13320
"1403",1862,"70",6665,5316,11981
"1404",1862,"71",6977,4838,11815
"1405",1862,"72",5245,3744,8989
"1406",1862,"73",4853,3774,8627
"1407",1862,"74",4863,3773,8636
"1408",1862,"75",4046,3022,7068
"1409",1862,"76",3633,2765,6398
"1410",1862,"77",2984,2198,5182
"1411",1862,"78",2325,2251,4576
"1412",1862,"79",1993,1551,3544
"1413",1862,"80",1673,1336,3009
"1414",1862,"81",1534,1131,2665
"1415",1862,"82",1228,887,2115
"1416",1862,"83",928,701,1629
"1417",1862,"84",752,566,1318
"1418",1862,"85",587,451,1038
"1419",1862,"86",483,355,838
"1420",1862,"87",412,276,688
"1421",1862,"88",263,209,472
"1422",1862,"89",227,142,369
"1423",1862,"90",157,87,244
"1424",1862,"91",100,68,168
"1425",1862,"92",79,48,127
"1426",1862,"93",54,37,91
"1427",1862,"94",34,27,61
"1428",1862,"95",19,16,35
"1429",1862,"96",11,6,17
"1430",1862,"97",7,3,10
"1431",1862,"98",9,4,13
"1432",1862,"99",3,1,4
"1433",1862,"100",1,1,2
"1434",1862,"101",0,0,0
"1435",1862,"102",0,0,0
"1436",1862,"103",0,0,0
"1437",1862,"104",0,0,0
"1438",1862,"105",0,0,0
"1439",1862,"106",0,0,0
"1440",1862,"107",0,0,0
"1441",1862,"108",0,0,0
"1442",1862,"109",0,0,0
"1443",1862,"110+",0,0,0
"1444",1863,"0",48270,50183,98453
"1445",1863,"1",45088,45854,90942
"1446",1863,"2",38708,39917,78625
"1447",1863,"3",39660,40078,79738
"1448",1863,"4",35089,35587,70676
"1449",1863,"5",36917,37087,74004
"1450",1863,"6",35284,35595,70879
"1451",1863,"7",33466,34253,67719
"1452",1863,"8",34021,34636,68657
"1453",1863,"9",34155,34604,68759
"1454",1863,"10",35351,35820,71171
"1455",1863,"11",34618,35212,69830
"1456",1863,"12",34501,35393,69894
"1457",1863,"13",34936,35379,70315
"1458",1863,"14",29898,30826,60724
"1459",1863,"15",27952,28188,56140
"1460",1863,"16",28581,29174,57755
"1461",1863,"17",31501,32134,63635
"1462",1863,"18",31624,32408,64032
"1463",1863,"19",30924,31172,62096
"1464",1863,"20",30980,30587,61567
"1465",1863,"21",30294,31539,61833
"1466",1863,"22",31801,30966,62767
"1467",1863,"23",31569,30859,62428
"1468",1863,"24",30620,29530,60150
"1469",1863,"25",29157,28433,57590
"1470",1863,"26",29538,28383,57921
"1471",1863,"27",27547,26498,54045
"1472",1863,"28",27068,25805,52873
"1473",1863,"29",26212,25339,51551
"1474",1863,"30",24107,23091,47198
"1475",1863,"31",23143,22616,45759
"1476",1863,"32",25913,24660,50573
"1477",1863,"33",25439,24494,49933
"1478",1863,"34",22570,22247,44817
"1479",1863,"35",22120,21703,43823
"1480",1863,"36",23511,22472,45983
"1481",1863,"37",23737,22698,46435
"1482",1863,"38",23789,23376,47165
"1483",1863,"39",23220,22771,45991
"1484",1863,"40",22078,22065,44143
"1485",1863,"41",20824,20787,41611
"1486",1863,"42",20711,19723,40434
"1487",1863,"43",20260,20181,40441
"1488",1863,"44",18213,17896,36109
"1489",1863,"45",17793,17497,35290
"1490",1863,"46",19324,18366,37690
"1491",1863,"47",17960,17247,35207
"1492",1863,"48",17062,16172,33234
"1493",1863,"49",16674,15607,32281
"1494",1863,"50",15595,14813,30408
"1495",1863,"51",16495,15227,31722
"1496",1863,"52",16174,14703,30877
"1497",1863,"53",14279,13117,27396
"1498",1863,"54",12880,12190,25070
"1499",1863,"55",13617,12454,26071
"1500",1863,"56",13366,12199,25565
"1501",1863,"57",12958,11738,24696
"1502",1863,"58",12800,11430,24230
"1503",1863,"59",12513,11253,23766
"1504",1863,"60",12265,11148,23413
"1505",1863,"61",11956,10301,22257
"1506",1863,"62",12579,10787,23366
"1507",1863,"63",11422,10131,21553
"1508",1863,"64",9703,8849,18552
"1509",1863,"65",9984,8542,18526
"1510",1863,"66",8943,7545,16488
"1511",1863,"67",8489,6723,15212
"1512",1863,"68",7777,6363,14140
"1513",1863,"69",7299,5859,13158
"1514",1863,"70",7046,5439,12485
"1515",1863,"71",6212,4944,11156
"1516",1863,"72",6513,4466,10979
"1517",1863,"73",4789,3403,8192
"1518",1863,"74",4407,3425,7832
"1519",1863,"75",4399,3395,7794
"1520",1863,"76",3634,2664,6298
"1521",1863,"77",3272,2462,5734
"1522",1863,"78",2631,1946,4577
"1523",1863,"79",2019,2020,4039
"1524",1863,"80",1754,1296,3050
"1525",1863,"81",1440,1155,2595
"1526",1863,"82",1299,964,2263
"1527",1863,"83",1003,735,1738
"1528",1863,"84",744,561,1305
"1529",1863,"85",608,454,1062
"1530",1863,"86",452,358,810
"1531",1863,"87",368,279,647
"1532",1863,"88",318,206,524
"1533",1863,"89",197,163,360
"1534",1863,"90",172,104,276
"1535",1863,"91",117,64,181
"1536",1863,"92",79,48,127
"1537",1863,"93",61,38,99
"1538",1863,"94",33,23,56
"1539",1863,"95",24,21,45
"1540",1863,"96",14,9,23
"1541",1863,"97",9,4,13
"1542",1863,"98",5,2,7
"1543",1863,"99",3,2,5
"1544",1863,"100",1,1,2
"1545",1863,"101",0,0,0
"1546",1863,"102",0,0,0
"1547",1863,"103",0,0,0
"1548",1863,"104",0,0,0
"1549",1863,"105",0,0,0
"1550",1863,"106",0,0,0
"1551",1863,"107",0,0,0
"1552",1863,"108",0,0,0
"1553",1863,"109",0,0,0
"1554",1863,"110+",0,0,0
"1555",1864,"0",53262,55248,108510
"1556",1864,"1",43272,44564,87836
"1557",1864,"2",42894,43625,86519
"1558",1864,"3",37427,38608,76035
"1559",1864,"4",38797,39221,78018
"1560",1864,"5",34512,35031,69543
"1561",1864,"6",36433,36553,72986
"1562",1864,"7",34910,35209,70119
"1563",1864,"8",33171,33948,67119
"1564",1864,"9",33785,34407,68192
"1565",1864,"10",33927,34392,68319
"1566",1864,"11",35141,35611,70752
"1567",1864,"12",34417,35033,69450
"1568",1864,"13",34323,35219,69542
"1569",1864,"14",34763,35212,69975
"1570",1864,"15",29727,30695,60422
"1571",1864,"16",27787,28072,55859
"1572",1864,"17",28394,29033,57427
"1573",1864,"18",31314,31939,63253
"1574",1864,"19",31450,32180,63630
"1575",1864,"20",30736,30920,61656
"1576",1864,"21",30789,30334,61123
"1577",1864,"22",30074,31282,61356
"1578",1864,"23",31575,30687,62262
"1579",1864,"24",31342,30603,61945
"1580",1864,"25",30403,29294,59697
"1581",1864,"26",28912,28180,57092
"1582",1864,"27",29310,28147,57457
"1583",1864,"28",27300,26286,53586
"1584",1864,"29",26817,25572,52389
"1585",1864,"30",25968,25109,51077
"1586",1864,"31",23872,22900,46772
"1587",1864,"32",22889,22420,45309
"1588",1864,"33",25633,24446,50079
"1589",1864,"34",25154,24282,49436
"1590",1864,"35",22301,22030,44331
"1591",1864,"36",21857,21470,43327
"1592",1864,"37",23228,22249,45477
"1593",1864,"38",23417,22463,45880
"1594",1864,"39",23475,23112,46587
"1595",1864,"40",22911,22506,45417
"1596",1864,"41",21785,21824,43609
"1597",1864,"42",20549,20512,41061
"1598",1864,"43",20440,19455,39895
"1599",1864,"44",20006,19903,39909
"1600",1864,"45",17969,17643,35612
"1601",1864,"46",17565,17230,34795
"1602",1864,"47",19090,18089,37179
"1603",1864,"48",17737,16959,34696
"1604",1864,"49",16829,15877,32706
"1605",1864,"50",16422,15324,31746
"1606",1864,"51",15368,14562,29930
"1607",1864,"52",16249,14947,31196
"1608",1864,"53",15928,14426,30354
"1609",1864,"54",14048,12831,26879
"1610",1864,"55",12642,11909,24551
"1611",1864,"56",13353,12153,25506
"1612",1864,"57",13088,11878,24966
"1613",1864,"58",12701,11396,24097
"1614",1864,"59",12525,11074,23599
"1615",1864,"60",12182,10909,23091
"1616",1864,"61",11924,10816,22740
"1617",1864,"62",11611,9925,21536
"1618",1864,"63",12183,10374,22557
"1619",1864,"64",11000,9711,20711
"1620",1864,"65",9295,8445,17740
"1621",1864,"66",9575,8112,17687
"1622",1864,"67",8553,7146,15699
"1623",1864,"68",8062,6341,14403
"1624",1864,"69",7359,6006,13365
"1625",1864,"70",6866,5479,12345
"1626",1864,"71",6593,5065,11658
"1627",1864,"72",5746,4541,10287
"1628",1864,"73",6048,4095,10143
"1629",1864,"74",4334,3092,7426
"1630",1864,"75",3963,3118,7081
"1631",1864,"76",4002,3076,7078
"1632",1864,"77",3258,2351,5609
"1633",1864,"78",2889,2177,5066
"1634",1864,"79",2300,1690,3990
"1635",1864,"80",1875,1376,3251
"1636",1864,"81",1515,1106,2621
"1637",1864,"82",1231,983,2214
"1638",1864,"83",1088,801,1889
"1639",1864,"84",821,580,1401
"1640",1864,"85",613,450,1063
"1641",1864,"86",497,355,852
"1642",1864,"87",345,264,609
"1643",1864,"88",273,204,477
"1644",1864,"89",249,171,420
"1645",1864,"90",147,120,267
"1646",1864,"91",126,74,200
"1647",1864,"92",80,46,126
"1648",1864,"93",56,32,88
"1649",1864,"94",46,26,72
"1650",1864,"95",27,19,46
"1651",1864,"96",17,6,23
"1652",1864,"97",8,6,14
"1653",1864,"98",5,2,7
"1654",1864,"99",2,2,4
"1655",1864,"100",2,0,2
"1656",1864,"101",0,0,0
"1657",1864,"102",0,0,0
"1658",1864,"103",0,0,0
"1659",1864,"104",0,0,0
"1660",1864,"105",0,0,0
"1661",1864,"106",0,0,0
"1662",1864,"107",0,0,0
"1663",1864,"108",0,0,0
"1664",1864,"109",0,0,0
"1665",1864,"110+",0,0,0
"1666",1865,"0",53215,54662,107877
"1667",1865,"1",47975,49026,97001
"1668",1865,"2",41291,42438,83729
"1669",1865,"3",41514,42178,83692
"1670",1865,"4",36639,37699,74338
"1671",1865,"5",38161,38523,76684
"1672",1865,"6",33984,34450,68434
"1673",1865,"7",36017,36115,72132
"1674",1865,"8",34574,34857,69431
"1675",1865,"9",32888,33683,66571
"1676",1865,"10",33535,34194,67729
"1677",1865,"11",33729,34195,67924
"1678",1865,"12",34948,35425,70373
"1679",1865,"13",34243,34860,69103
"1680",1865,"14",34162,35054,69216
"1681",1865,"15",34566,35058,69624
"1682",1865,"16",29535,30546,60081
"1683",1865,"17",27607,27918,55525
"1684",1865,"18",28187,28832,57019
"1685",1865,"19",31099,31704,62803
"1686",1865,"20",31230,31899,63129
"1687",1865,"21",30529,30616,61145
"1688",1865,"22",30555,30050,60605
"1689",1865,"23",29843,30997,60840
"1690",1865,"24",31344,30416,61760
"1691",1865,"25",31111,30337,61448
"1692",1865,"26",30139,29025,59164
"1693",1865,"27",28648,27912,56560
"1694",1865,"28",29021,27900,56921
"1695",1865,"29",27011,26067,53078
"1696",1865,"30",26537,25347,51884
"1697",1865,"31",25691,24903,50594
"1698",1865,"32",23589,22711,46300
"1699",1865,"33",22602,22208,44810
"1700",1865,"34",25329,24210,49539
"1701",1865,"35",24852,24034,48886
"1702",1865,"36",21996,21787,43783
"1703",1865,"37",21558,21251,42809
"1704",1865,"38",22908,22000,44908
"1705",1865,"39",23076,22193,45269
"1706",1865,"40",23129,22842,45971
"1707",1865,"41",22586,22237,44823
"1708",1865,"42",21479,21539,43018
"1709",1865,"43",20236,20236,40472
"1710",1865,"44",20147,19149,39296
"1711",1865,"45",19726,19612,39338
"1712",1865,"46",17711,17367,35078
"1713",1865,"47",17314,16979,34293
"1714",1865,"48",18829,17801,36630
"1715",1865,"49",17457,16665,34122
"1716",1865,"50",16547,15594,32141
"1717",1865,"51",16171,15032,31203
"1718",1865,"52",15088,14234,29322
"1719",1865,"53",15962,14618,30580
"1720",1865,"54",15635,14062,29697
"1721",1865,"55",13755,12503,26258
"1722",1865,"56",12354,11599,23953
"1723",1865,"57",13034,11810,24844
"1724",1865,"58",12749,11522,24271
"1725",1865,"59",12337,11045,23382
"1726",1865,"60",12143,10710,22853
"1727",1865,"61",11822,10546,22368
"1728",1865,"62",11542,10422,21964
"1729",1865,"63",11166,9482,20648
"1730",1865,"64",11692,9898,21590
"1731",1865,"65",10530,9244,19774
"1732",1865,"66",8822,8003,16825
"1733",1865,"67",9100,7718,16818
"1734",1865,"68",8045,6728,14773
"1735",1865,"69",7560,5931,13491
"1736",1865,"70",6861,5589,12450
"1737",1865,"71",6394,5082,11476
"1738",1865,"72",6088,4656,10744
"1739",1865,"73",5211,4134,9345
"1740",1865,"74",5529,3687,9216
"1741",1865,"75",3832,2738,6570
"1742",1865,"76",3473,2767,6240
"1743",1865,"77",3550,2704,6254
"1744",1865,"78",2826,2026,4852
"1745",1865,"79",2486,1894,4380
"1746",1865,"80",2004,1465,3469
"1747",1865,"81",1597,1153,2750
"1748",1865,"82",1286,911,2197
"1749",1865,"83",994,809,1803
"1750",1865,"84",861,627,1488
"1751",1865,"85",651,450,1101
"1752",1865,"86",470,337,807
"1753",1865,"87",376,257,633
"1754",1865,"88",250,181,431
"1755",1865,"89",201,149,350
"1756",1865,"90",172,109,281
"1757",1865,"91",87,77,164
"1758",1865,"92",88,47,135
"1759",1865,"93",47,33,80
"1760",1865,"94",42,22,64
"1761",1865,"95",34,21,55
"1762",1865,"96",14,9,23
"1763",1865,"97",9,4,13
"1764",1865,"98",2,3,5
"1765",1865,"99",3,2,5
"1766",1865,"100",0,1,1
"1767",1865,"101",0,0,0
"1768",1865,"102",0,0,0
"1769",1865,"103",0,0,0
"1770",1865,"104",0,0,0
"1771",1865,"105",0,0,0
"1772",1865,"106",0,0,0
"1773",1865,"107",0,0,0
"1774",1865,"108",0,0,0
"1775",1865,"109",0,0,0
"1776",1865,"110+",0,0,0
"1777",1866,"0",53034,54025,107059
"1778",1866,"1",47401,48059,95460
"1779",1866,"2",45721,46727,92448
"1780",1866,"3",40018,41061,81079
"1781",1866,"4",40609,41239,81848
"1782",1866,"5",36066,37061,73127
"1783",1866,"6",37630,37945,75575
"1784",1866,"7",33596,34042,67638
"1785",1866,"8",35695,35785,71480
"1786",1866,"9",34292,34590,68882
"1787",1866,"10",32641,33455,66096
"1788",1866,"11",33324,33977,67301
"1789",1866,"12",33518,34008,67526
"1790",1866,"13",34752,35237,69989
"1791",1866,"14",34042,34669,68711
"1792",1866,"15",33937,34884,68821
"1793",1866,"16",34340,34884,69224
"1794",1866,"17",29322,30368,59690
"1795",1866,"18",27401,27732,55133
"1796",1866,"19",27968,28602,56570
"1797",1866,"20",30851,31393,62244
"1798",1866,"21",30978,31576,62554
"1799",1866,"22",30265,30326,60591
"1800",1866,"23",30286,29756,60042
"1801",1866,"24",29572,30705,60277
"1802",1866,"25",31093,30148,61241
"1803",1866,"26",30815,30066,60881
"1804",1866,"27",29837,28767,58604
"1805",1866,"28",28351,27676,56027
"1806",1866,"29",28737,27667,56404
"1807",1866,"30",26715,25828,52543
"1808",1866,"31",26239,25114,51353
"1809",1866,"32",25390,24677,50067
"1810",1866,"33",23294,22494,45788
"1811",1866,"34",22294,21981,44275
"1812",1866,"35",25030,23970,49000
"1813",1866,"36",24561,23790,48351
"1814",1866,"37",21697,21561,43258
"1815",1866,"38",21251,21028,42279
"1816",1866,"39",22584,21758,44342
"1817",1866,"40",22742,21922,44664
"1818",1866,"41",22820,22571,45391
"1819",1866,"42",22287,21939,44226
"1820",1866,"43",21170,21265,42435
"1821",1866,"44",19949,19962,39911
"1822",1866,"45",19883,18883,38766
"1823",1866,"46",19501,19329,38830
"1824",1866,"47",17482,17089,34571
"1825",1866,"48",17058,16701,33759
"1826",1866,"49",18575,17513,36088
"1827",1866,"50",17210,16356,33566
"1828",1866,"51",16317,15294,31611
"1829",1866,"52",15905,14713,30618
"1830",1866,"53",14813,13937,28750
"1831",1866,"54",15683,14317,30000
"1832",1866,"55",15351,13743,29094
"1833",1866,"56",13507,12181,25688
"1834",1866,"57",12095,11287,23382
"1835",1866,"58",12749,11478,24227
"1836",1866,"59",12414,11172,23586
"1837",1866,"60",11976,10680,22656
"1838",1866,"61",11800,10356,22156
"1839",1866,"62",11459,10180,21639
"1840",1866,"63",11169,10042,21211
"1841",1866,"64",10760,9060,19820
"1842",1866,"65",11241,9459,20700
"1843",1866,"66",10085,8805,18890
"1844",1866,"67",8412,7595,16007
"1845",1866,"68",8669,7305,15974
"1846",1866,"69",7615,6370,13985
"1847",1866,"70",7102,5538,12640
"1848",1866,"71",6424,5202,11626
"1849",1866,"72",5946,4700,10646
"1850",1866,"73",5598,4295,9893
"1851",1866,"74",4720,3767,8487
"1852",1866,"75",5041,3335,8376
"1853",1866,"76",3392,2418,5810
"1854",1866,"77",3084,2459,5543
"1855",1866,"78",3155,2415,5570
"1856",1866,"79",2465,1741,4206
"1857",1866,"80",2168,1575,3743
"1858",1866,"81",1717,1214,2931
"1859",1866,"82",1363,955,2318
"1860",1866,"83",1066,759,1825
"1861",1866,"84",797,655,1452
"1862",1866,"85",698,509,1207
"1863",1866,"86",505,351,856
"1864",1866,"87",353,259,612
"1865",1866,"88",290,201,491
"1866",1866,"89",187,145,332
"1867",1866,"90",138,102,240
"1868",1866,"91",126,71,197
"1869",1866,"92",64,49,113
"1870",1866,"93",48,33,81
"1871",1866,"94",34,20,54
"1872",1866,"95",30,11,41
"1873",1866,"96",26,11,37
"1874",1866,"97",9,6,15
"1875",1866,"98",6,1,7
"1876",1866,"99",0,3,3
"1877",1866,"100",2,0,2
"1878",1866,"101",0,0,0
"1879",1866,"102",0,0,0
"1880",1866,"103",0,0,0
"1881",1866,"104",0,0,0
"1882",1866,"105",0,0,0
"1883",1866,"106",0,0,0
"1884",1866,"107",0,0,0
"1885",1866,"108",0,0,0
"1886",1866,"109",0,0,0
"1887",1866,"110+",0,0,0
"1888",1867,"0",53717,55120,108837
"1889",1867,"1",47406,47800,95206
"1890",1867,"2",44870,45470,90340
"1891",1867,"3",44043,44928,88971
"1892",1867,"4",38939,39993,78932
"1893",1867,"5",39800,40340,80140
"1894",1867,"6",35388,36347,71735
"1895",1867,"7",37088,37371,74459
"1896",1867,"8",33163,33574,66737
"1897",1867,"9",35322,35395,70717
"1898",1867,"10",33930,34241,68171
"1899",1867,"11",32340,33128,65468
"1900",1867,"12",33063,33735,66798
"1901",1867,"13",33294,33761,67055
"1902",1867,"14",34529,34955,69484
"1903",1867,"15",33789,34417,68206
"1904",1867,"16",33671,34635,68306
"1905",1867,"17",34084,34635,68719
"1906",1867,"18",29096,30096,59192
"1907",1867,"19",27178,27457,54635
"1908",1867,"20",27733,28269,56002
"1909",1867,"21",30611,31004,61615
"1910",1867,"22",30694,31194,61888
"1911",1867,"23",29975,29946,59921
"1912",1867,"24",29972,29385,59357
"1913",1867,"25",29262,30332,59594
"1914",1867,"26",30733,29768,60501
"1915",1867,"27",30448,29704,60152
"1916",1867,"28",29467,28429,57896
"1917",1867,"29",27992,27320,55312
"1918",1867,"30",28361,27279,55640
"1919",1867,"31",26335,25478,51813
"1920",1867,"32",25854,24757,50611
"1921",1867,"33",24993,24298,49291
"1922",1867,"34",22904,22163,45067
"1923",1867,"35",21908,21641,43549
"1924",1867,"36",24608,23585,48193
"1925",1867,"37",24148,23430,47578
"1926",1867,"38",21295,21189,42484
"1927",1867,"39",20843,20648,41491
"1928",1867,"40",22157,21362,43519
"1929",1867,"41",22321,21512,43833
"1930",1867,"42",22413,22142,44555
"1931",1867,"43",21874,21535,43409
"1932",1867,"44",20754,20822,41576
"1933",1867,"45",19563,19530,39093
"1934",1867,"46",19537,18463,38000
"1935",1867,"47",19145,18927,38072
"1936",1867,"48",17156,16705,33861
"1937",1867,"49",16734,16337,33071
"1938",1867,"50",18195,17097,35292
"1939",1867,"51",16868,15971,32839
"1940",1867,"52",15978,14889,30867
"1941",1867,"53",15578,14318,29896
"1942",1867,"54",14489,13543,28032
"1943",1867,"55",15316,13904,29220
"1944",1867,"56",14966,13329,28295
"1945",1867,"57",13124,11789,24913
"1946",1867,"58",11721,10889,22610
"1947",1867,"59",12351,11052,23403
"1948",1867,"60",11995,10749,22744
"1949",1867,"61",11545,10270,21815
"1950",1867,"62",11353,9925,21278
"1951",1867,"63",10995,9726,20721
"1952",1867,"64",10673,9573,20246
"1953",1867,"65",10233,8597,18830
"1954",1867,"66",10667,8944,19611
"1955",1867,"67",9552,8320,17872
"1956",1867,"68",7865,7119,14984
"1957",1867,"69",8094,6836,14930
"1958",1867,"70",7048,5911,12959
"1959",1867,"71",6600,5133,11733
"1960",1867,"72",5927,4793,10720
"1961",1867,"73",5413,4286,9699
"1962",1867,"74",5075,3889,8964
"1963",1867,"75",4213,3384,7597
"1964",1867,"76",4572,2983,7555
"1965",1867,"77",2969,2106,5075
"1966",1867,"78",2635,2158,4793
"1967",1867,"79",2728,2116,4844
"1968",1867,"80",2176,1661,3837
"1969",1867,"81",1867,1345,3212
"1970",1867,"82",1457,1008,2465
"1971",1867,"83",1108,786,1894
"1972",1867,"84",860,615,1475
"1973",1867,"85",640,529,1169
"1974",1867,"86",544,406,950
"1975",1867,"87",381,276,657
"1976",1867,"88",260,194,454
"1977",1867,"89",225,160,385
"1978",1867,"90",124,113,237
"1979",1867,"91",101,75,176
"1980",1867,"92",90,45,135
"1981",1867,"93",50,33,83
"1982",1867,"94",32,22,54
"1983",1867,"95",25,14,39
"1984",1867,"96",18,4,22
"1985",1867,"97",17,4,21
"1986",1867,"98",8,2,10
"1987",1867,"99",4,0,4
"1988",1867,"100",0,2,2
"1989",1867,"101",0,0,0
"1990",1867,"102",0,0,0
"1991",1867,"103",0,0,0
"1992",1867,"104",0,0,0
"1993",1867,"105",0,0,0
"1994",1867,"106",0,0,0
"1995",1867,"107",0,0,0
"1996",1867,"108",0,0,0
"1997",1867,"109",0,0,0
"1998",1867,"110+",0,0,0
"1999",1868,"0",53876,55513,109389
"2000",1868,"1",48273,48893,97166
"2001",1868,"2",45285,45712,90997
"2002",1868,"3",43621,44089,87710
"2003",1868,"4",43270,44145,87415
"2004",1868,"5",38426,39409,77835
"2005",1868,"6",39383,39918,79301
"2006",1868,"7",35070,36012,71082
"2007",1868,"8",36821,37083,73904
"2008",1868,"9",32931,33350,66281
"2009",1868,"10",35106,35198,70304
"2010",1868,"11",33737,34051,67788
"2011",1868,"12",32169,32980,65149
"2012",1868,"13",32915,33605,66520
"2013",1868,"14",33125,33615,66740
"2014",1868,"15",34349,34816,69165
"2015",1868,"16",33601,34264,67865
"2016",1868,"17",33467,34452,67919
"2017",1868,"18",33887,34416,68303
"2018",1868,"19",28914,29878,58792
"2019",1868,"20",27002,27205,54207
"2020",1868,"21",27558,27992,55550
"2021",1868,"22",30396,30732,61128
"2022",1868,"23",30468,30903,61371
"2023",1868,"24",29747,29674,59421
"2024",1868,"25",29756,29130,58886
"2025",1868,"26",29018,30074,59092
"2026",1868,"27",30489,29512,60001
"2027",1868,"28",30180,29467,59647
"2028",1868,"29",29196,28194,57390
"2029",1868,"30",27727,27090,54817
"2030",1868,"31",28106,27084,55190
"2031",1868,"32",26062,25277,51339
"2032",1868,"33",25561,24541,50102
"2033",1868,"34",24714,24102,48816
"2034",1868,"35",22658,21978,44636
"2035",1868,"36",21655,21431,43086
"2036",1868,"37",24333,23348,47681
"2037",1868,"38",23856,23181,47037
"2038",1868,"39",21008,20955,41963
"2039",1868,"40",20573,20416,40989
"2040",1868,"41",21879,21151,43030
"2041",1868,"42",22033,21284,43317
"2042",1868,"43",22119,21893,44012
"2043",1868,"44",21590,21253,42843
"2044",1868,"45",20494,20537,41031
"2045",1868,"46",19315,19235,38550
"2046",1868,"47",19290,18187,37477
"2047",1868,"48",18910,18647,37557
"2048",1868,"49",16936,16442,33378
"2049",1868,"50",16506,16067,32573
"2050",1868,"51",17949,16820,34769
"2051",1868,"52",16616,15653,32269
"2052",1868,"53",15737,14588,30325
"2053",1868,"54",15331,14015,29346
"2054",1868,"55",14222,13224,27446
"2055",1868,"56",15038,13568,28606
"2056",1868,"57",14682,13003,27685
"2057",1868,"58",12868,11493,24361
"2058",1868,"59",11440,10576,22016
"2059",1868,"60",12018,10712,22730
"2060",1868,"61",11660,10407,22067
"2061",1868,"62",11203,9891,21094
"2062",1868,"63",10986,9549,20535
"2063",1868,"64",10600,9338,19938
"2064",1868,"65",10267,9196,19463
"2065",1868,"66",9790,8162,17952
"2066",1868,"67",10189,8502,18691
"2067",1868,"68",9074,7881,16955
"2068",1868,"69",7416,6703,14119
"2069",1868,"70",7598,6387,13985
"2070",1868,"71",6584,5485,12069
"2071",1868,"72",6167,4717,10884
"2072",1868,"73",5467,4405,9872
"2073",1868,"74",4974,3905,8879
"2074",1868,"75",4635,3524,8159
"2075",1868,"76",3750,3039,6789
"2076",1868,"77",4109,2668,6777
"2077",1868,"78",2545,1817,4362
"2078",1868,"79",2279,1864,4143
"2079",1868,"80",2367,1687,4054
"2080",1868,"81",1848,1425,3273
"2081",1868,"82",1594,1121,2715
"2082",1868,"83",1194,832,2026
"2083",1868,"84",895,625,1520
"2084",1868,"85",710,488,1198
"2085",1868,"86",489,424,913
"2086",1868,"87",414,316,730
"2087",1868,"88",280,205,485
"2088",1868,"89",199,151,350
"2089",1868,"90",166,114,280
"2090",1868,"91",86,74,160
"2091",1868,"92",66,52,118
"2092",1868,"93",50,32,82
"2093",1868,"94",29,23,52
"2094",1868,"95",20,16,36
"2095",1868,"96",15,9,24
"2096",1868,"97",7,3,10
"2097",1868,"98",9,2,11
"2098",1868,"99",7,0,7
"2099",1868,"100",2,0,2
"2100",1868,"101",0,0,0
"2101",1868,"102",0,0,0
"2102",1868,"103",0,0,0
"2103",1868,"104",0,0,0
"2104",1868,"105",0,0,0
"2105",1868,"106",0,0,0
"2106",1868,"107",0,0,0
"2107",1868,"108",0,0,0
"2108",1868,"109",0,0,0
"2109",1868,"110+",0,0,0
"2110",1869,"0",51851,53153,105004
"2111",1869,"1",47763,48712,96475
"2112",1869,"2",46009,46574,92583
"2113",1869,"3",44015,44416,88431
"2114",1869,"4",42811,43310,86121
"2115",1869,"5",42691,43535,86226
"2116",1869,"6",37971,38943,76914
"2117",1869,"7",39031,39576,78607
"2118",1869,"8",34808,35758,70566
"2119",1869,"9",36612,36878,73490
"2120",1869,"10",32732,33171,65903
"2121",1869,"11",34918,35039,69957
"2122",1869,"12",33554,33918,67472
"2123",1869,"13",32013,32835,64848
"2124",1869,"14",32748,33450,66198
"2125",1869,"15",32933,33476,66409
"2126",1869,"16",34167,34663,68830
"2127",1869,"17",33392,34074,67466
"2128",1869,"18",33240,34216,67456
"2129",1869,"19",33676,34161,67837
"2130",1869,"20",28706,29590,58296
"2131",1869,"21",26804,26936,53740
"2132",1869,"22",27352,27745,55097
"2133",1869,"23",30186,30455,60641
"2134",1869,"24",30231,30636,60867
"2135",1869,"25",29523,29429,58952
"2136",1869,"26",29524,28888,58412
"2137",1869,"27",28763,29840,58603
"2138",1869,"28",30201,29271,59472
"2139",1869,"29",29903,29226,59129
"2140",1869,"30",28925,27974,56899
"2141",1869,"31",27470,26881,54351
"2142",1869,"32",27837,26865,54702
"2143",1869,"33",25789,25053,50842
"2144",1869,"34",25286,24334,49620
"2145",1869,"35",24450,23901,48351
"2146",1869,"36",22391,21766,44157
"2147",1869,"37",21382,21210,42592
"2148",1869,"38",24049,23117,47166
"2149",1869,"39",23576,22942,46518
"2150",1869,"40",20744,20719,41463
"2151",1869,"41",20305,20194,40499
"2152",1869,"42",21605,20900,42505
"2153",1869,"43",21746,21024,42770
"2154",1869,"44",21850,21594,43444
"2155",1869,"45",21345,20960,42305
"2156",1869,"46",20268,20255,40523
"2157",1869,"47",19076,18970,38046
"2158",1869,"48",19044,17907,36951
"2159",1869,"49",18676,18365,37041
"2160",1869,"50",16698,16158,32856
"2161",1869,"51",16264,15783,32047
"2162",1869,"52",17674,16490,34164
"2163",1869,"53",16376,15341,31717
"2164",1869,"54",15512,14267,29779
"2165",1869,"55",15067,13699,28766
"2166",1869,"56",13951,12914,26865
"2167",1869,"57",14767,13240,28007
"2168",1869,"58",14397,12671,27068
"2169",1869,"59",12575,11177,23752
"2170",1869,"60",11135,10240,21375
"2171",1869,"61",11687,10354,22041
"2172",1869,"62",11304,10040,21344
"2173",1869,"63",10834,9534,20368
"2174",1869,"64",10605,9178,19783
"2175",1869,"65",10208,8959,19167
"2176",1869,"66",9851,8761,18612
"2177",1869,"67",9335,7699,17034
"2178",1869,"68",9661,7988,17649
"2179",1869,"69",8587,7397,15984
"2180",1869,"70",6926,6235,13161
"2181",1869,"71",7109,5949,13058
"2182",1869,"72",6116,5063,11179
"2183",1869,"73",5679,4338,10017
"2184",1869,"74",5000,4006,9006
"2185",1869,"75",4491,3527,8018
"2186",1869,"76",4160,3173,7333
"2187",1869,"77",3284,2700,5984
"2188",1869,"78",3643,2364,6007
"2189",1869,"79",2147,1529,3676
"2190",1869,"80",2204,1537.47,3741.47
"2191",1869,"81",2050,1422,3472
"2192",1869,"82",1555,1184,2739
"2193",1869,"83",1310,926,2236
"2194",1869,"84",955,655,1610
"2195",1869,"85",724,494,1218
"2196",1869,"86",565,372,937
"2197",1869,"87",372,317,689
"2198",1869,"88",309,224,533
"2199",1869,"89",207,145,352
"2200",1869,"90",148,108,256
"2201",1869,"91",106,73,179
"2202",1869,"92",57,51,108
"2203",1869,"93",49,36,85
"2204",1869,"94",34,23,57
"2205",1869,"95",21,11,32
"2206",1869,"96",14,8,22
"2207",1869,"97",5,5,10
"2208",1869,"98",4,1,5
"2209",1869,"99",4,1,5
"2210",1869,"100",2,0,2
"2211",1869,"101",1,0,1
"2212",1869,"102",0,0,0
"2213",1869,"103",0,0,0
"2214",1869,"104",0,0,0
"2215",1869,"105",0,0,0
"2216",1869,"106",0,0,0
"2217",1869,"107",0,0,0
"2218",1869,"108",0,0,0
"2219",1869,"109",0,0,0
"2220",1869,"110+",0,0,0
"2221",1870,"0",52608,53590,106198
"2222",1870,"1",46348,46769,93117
"2223",1870,"2",46027,46549,92576
"2224",1870,"3",44309,44707,89016
"2225",1870,"4",42838,42900,85738
"2226",1870,"5",41805,42333,84138
"2227",1870,"6",41503,42629,84132
"2228",1870,"7",37646,38318,75964
"2229",1870,"8",37929,38531,76460
"2230",1870,"9",34462,35420,69882
"2231",1870,"10",35731,36056,71787
"2232",1870,"11",32263,32846,65109
"2233",1870,"12",34750,34827,69577
"2234",1870,"13",33209,33811,67020
"2235",1870,"14",31756,32848,64604
"2236",1870,"15",31969,32927,64896
"2237",1870,"16",32175,32599,64774
"2238",1870,"17",33727,33504,67231
"2239",1870,"18",32488,32902,65390
"2240",1870,"19",32993,32788,65781
"2241",1870,"20",32794,32036,64830
"2242",1870,"21",27676,27077,54753
"2243",1870,"22",26564,25242,51806
"2244",1870,"23",27308,25838,53146
"2245",1870,"24",29963,28553,58516
"2246",1870,"25",29941,28525,58466
"2247",1870,"26",28315,27098,55413
"2248",1870,"27",28925,27112,56037
"2249",1870,"28",27884,26919,54803
"2250",1870,"29",29083,27253,56336
"2251",1870,"30",28613,26848,55461
"2252",1870,"31",26848,25815,52663
"2253",1870,"32",25916,24815,50731
"2254",1870,"33",26190,25264,51454
"2255",1870,"34",24782,23764,48546
"2256",1870,"35",24261,23409,47670
"2257",1870,"36",24228,23493,47721
"2258",1870,"37",21413,20971,42384
"2259",1870,"38",21288,21101,42389
"2260",1870,"39",23613,22423,46036
"2261",1870,"40",22785,22395,45180
"2262",1870,"41",20280,20257,40537
"2263",1870,"42",20117,19767,39884
"2264",1870,"43",21064,20344,41408
"2265",1870,"44",21596,20862,42458
"2266",1870,"45",21253,21007,42260
"2267",1870,"46",20778,20469,41247
"2268",1870,"47",19722,19877,39599
"2269",1870,"48",18786,18574,37360
"2270",1870,"49",18419,17423,35842
"2271",1870,"50",18424,17975,36399
"2272",1870,"51",16113,15864,31977
"2273",1870,"52",16228,15681,31909
"2274",1870,"53",17114,16097,33211
"2275",1870,"54",15762,14861,30623
"2276",1870,"55",15304,14077,29381
"2277",1870,"56",14758,13563,28321
"2278",1870,"57",13375,12491,25866
"2279",1870,"58",14111,12622,26733
"2280",1870,"59",13496,11965,25461
"2281",1870,"60",11934,10524,22458
"2282",1870,"61",10741,9808,20549
"2283",1870,"62",11128,9934,21062
"2284",1870,"63",10779,9559,20338
"2285",1870,"64",10419,9205,19624
"2286",1870,"65",10082,8767,18849
"2287",1870,"66",10020,8436,18456
"2288",1870,"67",9327,8176,17503
"2289",1870,"68",8976,7210,16186
"2290",1870,"69",8929,7450,16379
"2291",1870,"70",7805,6761,14566
"2292",1870,"71",6623,6009,12632
"2293",1870,"72",6508,5389,11897
"2294",1870,"73",5700,4649,10349
"2295",1870,"74",5178,3973,9151
"2296",1870,"75",4642,3663,8305
"2297",1870,"76",4129,3170,7299
"2298",1870,"77",3800,2787,6587
"2299",1870,"78",3179,2416,5595
"2300",1870,"79",3009,2016,5025
"2301",1870,"80",2253,1538.53,3791.53
"2302",1870,"81",1855,1280.47,3135.47
"2303",1870,"82",1742,1186,2928
"2304",1870,"83",1238,978,2216
"2305",1870,"84",1046,730,1776
"2306",1870,"85",766,517,1283
"2307",1870,"86",570,377,947
"2308",1870,"87",446,269,715
"2309",1870,"88",286,230,516
"2310",1870,"89",252,176,428
"2311",1870,"90",145,102,247
"2312",1870,"91",105,73,178
"2313",1870,"92",73,45,118
"2314",1870,"93",37,33,70
"2315",1870,"94",29,19,48
"2316",1870,"95",25,11,36
"2317",1870,"96",15,10,25
"2318",1870,"97",7,6,13
"2319",1870,"98",3,3,6
"2320",1870,"99",2,1,3
"2321",1870,"100",1,0,1
"2322",1870,"101",0,0,0
"2323",1870,"102",0,0,0
"2324",1870,"103",0,0,0
"2325",1870,"104",0,0,0
"2326",1870,"105",0,0,0
"2327",1870,"106",0,0,0
"2328",1870,"107",0,0,0
"2329",1870,"108",0,0,0
"2330",1870,"109",0,0,0
"2331",1870,"110+",0,0,0
"2332",1871,"0",54721,56060,110781
"2333",1871,"1",47237,47684,94921
"2334",1871,"2",44849,45203,90052
"2335",1871,"3",44743,45279,90022
"2336",1871,"4",43481,43940,87421
"2337",1871,"5",42410,42478,84888
"2338",1871,"6",41815,42228,84043
"2339",1871,"7",41312,42217,83529
"2340",1871,"8",37419,38002,75421
"2341",1871,"9",37820,38315,76135
"2342",1871,"10",34755,34934,69689
"2343",1871,"11",35905,35992,71897
"2344",1871,"12",32076,32588,64664
"2345",1871,"13",34098,34215,68313
"2346",1871,"14",32983,33561,66544
"2347",1871,"15",31549,32387,63936
"2348",1871,"16",31744,32549,64293
"2349",1871,"17",31645,32082,63727
"2350",1871,"18",33530,33188,66718
"2351",1871,"19",32039,32124,64163
"2352",1871,"20",32377,32326,64703
"2353",1871,"21",32838,31730,64568
"2354",1871,"22",27707,27078,54785
"2355",1871,"23",26212,24853,51065
"2356",1871,"24",26872,25322,52194
"2357",1871,"25",29329,28025,57354
"2358",1871,"26",29689,28413,58102
"2359",1871,"27",28113,26885,54998
"2360",1871,"28",28522,26837,55359
"2361",1871,"29",27458,26662,54120
"2362",1871,"30",28506,26900,55406
"2363",1871,"31",28653,26756,55409
"2364",1871,"32",26734,25837,52571
"2365",1871,"33",25450,24389,49839
"2366",1871,"34",25926,25101,51027
"2367",1871,"35",24527,23613,48140
"2368",1871,"36",23933,23048,46981
"2369",1871,"37",23918,23368,47286
"2370",1871,"38",21426,20911,42337
"2371",1871,"39",20657,20703,41360
"2372",1871,"40",23186,22070,45256
"2373",1871,"41",22509,22181,44690
"2374",1871,"42",20103,20029,40132
"2375",1871,"43",19738,19532,39270
"2376",1871,"44",20732,19932,40664
"2377",1871,"45",21194,20514,41708
"2378",1871,"46",20892,20701,41593
"2379",1871,"47",20579,20098,40677
"2380",1871,"48",19426,19579,39005
"2381",1871,"49",18576,18337,36913
"2382",1871,"50",17985,17112,35097
"2383",1871,"51",18255,17619,35874
"2384",1871,"52",15959,15644,31603
"2385",1871,"53",15762,15244,31006
"2386",1871,"54",16903,15682,32585
"2387",1871,"55",15513,14680,30193
"2388",1871,"56",14883,13608,28491
"2389",1871,"57",14557,13167,27724
"2390",1871,"58",12936,12237,25173
"2391",1871,"59",13757,12170,25927
"2392",1871,"60",13054,11538,24592
"2393",1871,"61",11741,10258,21999
"2394",1871,"62",10425,9395,19820
"2395",1871,"63",10618,9507,20125
"2396",1871,"64",10417,9140,19557
"2397",1871,"65",9981,8734,18715
"2398",1871,"66",9599,8321,17920
"2399",1871,"67",9511,7957,17468
"2400",1871,"68",8814,7684,16498
"2401",1871,"69",8454,6842,15296
"2402",1871,"70",8131,6852,14983
"2403",1871,"71",7386,6286,13672
"2404",1871,"72",6077,5510,11587
"2405",1871,"73",5995,5003,10998
"2406",1871,"74",5123,4182,9305
"2407",1871,"75",4645,3508,8153
"2408",1871,"76",4123,3223,7346
"2409",1871,"77",3625,2791,6416
"2410",1871,"78",3291,2391,5682
"2411",1871,"79",2707,2066,4773
"2412",1871,"80",2659,1716,4375
"2413",1871,"81",1908,1290.53,3198.53
"2414",1871,"82",1526,1043.47,2569.47
"2415",1871,"83",1421,976,2397
"2416",1871,"84",983,742,1725
"2417",1871,"85",817,562,1379
"2418",1871,"86",604,387,991
"2419",1871,"87",400,284,684
"2420",1871,"88",344,203,547
"2421",1871,"89",215,159,374
"2422",1871,"90",178,125,303
"2423",1871,"91",100,63,163
"2424",1871,"92",63,44,107
"2425",1871,"93",49,28,77
"2426",1871,"94",27,17,44
"2427",1871,"95",18,14,32
"2428",1871,"96",17,10,27
"2429",1871,"97",9,6,15
"2430",1871,"98",5,2,7
"2431",1871,"99",2,3,5
"2432",1871,"100",1,1,2
"2433",1871,"101",0,0,0
"2434",1871,"102",0,0,0
"2435",1871,"103",0,0,0
"2436",1871,"104",0,0,0
"2437",1871,"105",0,0,0
"2438",1871,"106",0,0,0
"2439",1871,"107",0,0,0
"2440",1871,"108",0,0,0
"2441",1871,"109",0,0,0
"2442",1871,"110+",0,0,0
"2443",1872,"0",53924,54262,108186
"2444",1872,"1",48239,48867,97106
"2445",1872,"2",44458,44757,89215
"2446",1872,"3",43202,43545,86747
"2447",1872,"4",43513,43946,87459
"2448",1872,"5",42635,42988,85623
"2449",1872,"6",41656,41734,83390
"2450",1872,"7",41237,41642,82879
"2451",1872,"8",40849,41713,82562
"2452",1872,"9",37099,37614,74713
"2453",1872,"10",37411,37946,75357
"2454",1872,"11",34399,34618,69017
"2455",1872,"12",35676,35743,71419
"2456",1872,"13",31855,32331,64186
"2457",1872,"14",33700,33914,67614
"2458",1872,"15",32872,33213,66085
"2459",1872,"16",31235,31988,63223
"2460",1872,"17",31367,32170,63537
"2461",1872,"18",31337,31660,62997
"2462",1872,"19",33193,32743,65936
"2463",1872,"20",31589,31524,63113
"2464",1872,"21",32034,31794,63828
"2465",1872,"22",32498,31270,63768
"2466",1872,"23",27333,26691,54024
"2467",1872,"24",25815,24455,50270
"2468",1872,"25",26529,24947,51476
"2469",1872,"26",28916,27644,56560
"2470",1872,"27",29273,28053,57326
"2471",1872,"28",27752,26609,54361
"2472",1872,"29",28176,26551,54727
"2473",1872,"30",27081,26317,53398
"2474",1872,"31",28176,26633,54809
"2475",1872,"32",28276,26472,54748
"2476",1872,"33",26373,25582,51955
"2477",1872,"34",25023,24121,49144
"2478",1872,"35",25571,24792,50363
"2479",1872,"36",24165,23331,47496
"2480",1872,"37",23563,22747,46310
"2481",1872,"38",23509,23049,46558
"2482",1872,"39",21086,20601,41687
"2483",1872,"40",20293,20355,40648
"2484",1872,"41",22843,21776,44619
"2485",1872,"42",22115,21839,43954
"2486",1872,"43",19795,19736,39531
"2487",1872,"44",19408,19203,38611
"2488",1872,"45",20438,19623,40061
"2489",1872,"46",20854,20175,41029
"2490",1872,"47",20559,20378,40937
"2491",1872,"48",20272,19713,39985
"2492",1872,"49",19135,19212,38347
"2493",1872,"50",18241,17961,36202
"2494",1872,"51",17708,16749,34457
"2495",1872,"52",17883,17191,35074
"2496",1872,"53",15650,15254,30904
"2497",1872,"54",15434,14852,30286
"2498",1872,"55",16576,15249,31825
"2499",1872,"56",15190,14246,29436
"2500",1872,"57",14533,13258,27791
"2501",1872,"58",14211,12756,26967
"2502",1872,"59",12609,11854,24463
"2503",1872,"60",13369,11736,25105
"2504",1872,"61",12603,11099,23702
"2505",1872,"62",11339,9849,21188
"2506",1872,"63",10055,9007,19062
"2507",1872,"64",10184,9062,19246
"2508",1872,"65",9976,8700,18676
"2509",1872,"66",9519,8256,17775
"2510",1872,"67",9159,7885,17044
"2511",1872,"68",8989,7451,16440
"2512",1872,"69",8315,7221,15536
"2513",1872,"70",7950,6337,14287
"2514",1872,"71",7480,6348,13828
"2515",1872,"72",6822,5779,12601
"2516",1872,"73",5567,5026,10593
"2517",1872,"74",5451,4514,9965
"2518",1872,"75",4611,3756,8367
"2519",1872,"76",4147,3095,7242
"2520",1872,"77",3661,2829,6490
"2521",1872,"78",3131,2441,5572
"2522",1872,"79",2868,2012,4880
"2523",1872,"80",2383,1745,4128
"2524",1872,"81",2244,1460,3704
"2525",1872,"82",1589,1071.53,2660.53
"2526",1872,"83",1225,829.47,2054.47
"2527",1872,"84",1124,795,1919
"2528",1872,"85",779,572,1351
"2529",1872,"86",620,429,1049
"2530",1872,"87",453,293,746
"2531",1872,"88",295,194,489
"2532",1872,"89",238,141,379
"2533",1872,"90",149,107,256
"2534",1872,"91",122,81,203
"2535",1872,"92",68,41,109
"2536",1872,"93",40,25,65
"2537",1872,"94",27,22,49
"2538",1872,"95",20,8,28
"2539",1872,"96",8,7,15
"2540",1872,"97",10,6,16
"2541",1872,"98",7,6,13
"2542",1872,"99",3,1,4
"2543",1872,"100",1,0,1
"2544",1872,"101",0,0,0
"2545",1872,"102",0,0,0
"2546",1872,"103",0,0,0
"2547",1872,"104",0,0,0
"2548",1872,"105",0,0,0
"2549",1872,"106",0,0,0
"2550",1872,"107",0,0,0
"2551",1872,"108",0,0,0
"2552",1872,"109",0,0,0
"2553",1872,"110+",0,0,0
"2554",1873,"0",55729,56611,112340
"2555",1873,"1",47657,47296,94953
"2556",1873,"2",45744,46130,91874
"2557",1873,"3",43186,43417,86603
"2558",1873,"4",42377,42654,85031
"2559",1873,"5",42780,43237,86017
"2560",1873,"6",42087,42408,84495
"2561",1873,"7",41188,41244,82432
"2562",1873,"8",40852,41197,82049
"2563",1873,"9",40549,41343,81892
"2564",1873,"10",36869,37339,74208
"2565",1873,"11",37138,37690,74828
"2566",1873,"12",34140,34380,68520
"2567",1873,"13",35546,35530,71076
"2568",1873,"14",31666,32091,63757
"2569",1873,"15",33525,33661,67186
"2570",1873,"16",32689,33030,65719
"2571",1873,"17",30946,31633,62579
"2572",1873,"18",31306,31761,63067
"2573",1873,"19",31075,31258,62333
"2574",1873,"20",32917,32345,65262
"2575",1873,"21",31249,30992,62241
"2576",1873,"22",31744,31371,63115
"2577",1873,"23",32223,30860,63083
"2578",1873,"24",27002,26353,53355
"2579",1873,"25",25504,24115,49619
"2580",1873,"26",26223,24631,50854
"2581",1873,"27",28581,27345,55926
"2582",1873,"28",28925,27769,56694
"2583",1873,"29",27431,26359,53790
"2584",1873,"30",27868,26322,54190
"2585",1873,"31",26754,26037,52791
"2586",1873,"32",27903,26428,54331
"2587",1873,"33",27974,26263,54237
"2588",1873,"34",26091,25371,51462
"2589",1873,"35",24692,23924,48616
"2590",1873,"36",25275,24549,49824
"2591",1873,"37",23885,23109,46994
"2592",1873,"38",23287,22506,45793
"2593",1873,"39",23159,22797,45956
"2594",1873,"40",20830,20352,41182
"2595",1873,"41",19974,20088,40062
"2596",1873,"42",22523,21505,44028
"2597",1873,"43",21770,21557,43327
"2598",1873,"44",19534,19483,39017
"2599",1873,"45",19141,18903,38044
"2600",1873,"46",20223,19357,39580
"2601",1873,"47",20538,19875,40413
"2602",1873,"48",20270,20096,40366
"2603",1873,"49",20011,19394,39405
"2604",1873,"50",18876,18859,37735
"2605",1873,"51",17930,17625,35555
"2606",1873,"52",17446,16444,33890
"2607",1873,"53",17553,16833,34386
"2608",1873,"54",15420,14921,30341
"2609",1873,"55",15130,14520,29650
"2610",1873,"56",16290,14858,31148
"2611",1873,"57",14894,13893,28787
"2612",1873,"58",14230,12914,27144
"2613",1873,"59",13871,12332,26203
"2614",1873,"60",12291,11465,23756
"2615",1873,"61",13057,11353,24410
"2616",1873,"62",12208,10725,22933
"2617",1873,"63",10991,9464,20455
"2618",1873,"64",9741,8610,18351
"2619",1873,"65",9797,8678,18475
"2620",1873,"66",9584,8321,17905
"2621",1873,"67",9112,7864,16976
"2622",1873,"68",8723,7492,16215
"2623",1873,"69",8533,6993,15526
"2624",1873,"70",7870,6798,14668
"2625",1873,"71",7465,5909,13374
"2626",1873,"72",6911,5860,12771
"2627",1873,"73",6296,5340,11636
"2628",1873,"74",5143,4567,9710
"2629",1873,"75",4945,4117,9062
"2630",1873,"76",4183,3348,7531
"2631",1873,"77",3742,2751,6493
"2632",1873,"78",3232,2538,5770
"2633",1873,"79",2749,2132,4881
"2634",1873,"80",2548,1722,4270
"2635",1873,"81",2054,1502,3556
"2636",1873,"82",1922,1233,3155
"2637",1873,"83",1329,881.53,2210.53
"2638",1873,"84",1003,664.47,1667.47
"2639",1873,"85",915,627,1542
"2640",1873,"86",622,446,1068
"2641",1873,"87",481,341,822
"2642",1873,"88",343,214,557
"2643",1873,"89",222,152,374
"2644",1873,"90",175,100,275
"2645",1873,"91",119,77,196
"2646",1873,"92",88,58,146
"2647",1873,"93",41,24,65
"2648",1873,"94",26,15,41
"2649",1873,"95",19,16,35
"2650",1873,"96",13,7,20
"2651",1873,"97",5,4,9
"2652",1873,"98",5,5,10
"2653",1873,"99",4,4,8
"2654",1873,"100",3,0,3
"2655",1873,"101",0,0,0
"2656",1873,"102",0,0,0
"2657",1873,"103",0,0,0
"2658",1873,"104",0,0,0
"2659",1873,"105",0,0,0
"2660",1873,"106",0,0,0
"2661",1873,"107",0,0,0
"2662",1873,"108",0,0,0
"2663",1873,"109",0,0,0
"2664",1873,"110+",0,0,0
"2665",1874,"0",57079,57729,114808
"2666",1874,"1",50121,50385,100506
"2667",1874,"2",45540,45178,90718
"2668",1874,"3",44751,44989,89740
"2669",1874,"4",42548,42766,85314
"2670",1874,"5",41924,42177,84101
"2671",1874,"6",42337,42814,85151
"2672",1874,"7",41787,42089,83876
"2673",1874,"8",40911,40921,81832
"2674",1874,"9",40587,40853,81440
"2675",1874,"10",40265,41062,81327
"2676",1874,"11",36704,37089,73793
"2677",1874,"12",36910,37501,74411
"2678",1874,"13",33909,34179,68088
"2679",1874,"14",35437,35370,70807
"2680",1874,"15",31520,31878,63398
"2681",1874,"16",33293,33411,66704
"2682",1874,"17",32250,32779,65029
"2683",1874,"18",30699,31257,61956
"2684",1874,"19",31138,31351,62489
"2685",1874,"20",30826,30781,61607
"2686",1874,"21",32657,31940,64597
"2687",1874,"22",30913,30510,61423
"2688",1874,"23",31473,30979,62452
"2689",1874,"24",31925,30520,62445
"2690",1874,"25",26738,26052,52790
"2691",1874,"26",25181,23824,49005
"2692",1874,"27",25945,24347,50292
"2693",1874,"28",28286,27086,55372
"2694",1874,"29",28601,27501,56102
"2695",1874,"30",27124,26108,53232
"2696",1874,"31",27573,26111,53684
"2697",1874,"32",26427,25814,52241
"2698",1874,"33",27646,26242,53888
"2699",1874,"34",27671,26051,53722
"2700",1874,"35",25832,25147,50979
"2701",1874,"36",24388,23698,48086
"2702",1874,"37",25002,24334,49336
"2703",1874,"38",23599,22923,46522
"2704",1874,"39",23014,22266,45280
"2705",1874,"40",22832,22540,45372
"2706",1874,"41",20562,20127,40689
"2707",1874,"42",19700,19823,39523
"2708",1874,"43",22234,21266,43500
"2709",1874,"44",21503,21272,42775
"2710",1874,"45",19293,19266,38559
"2711",1874,"46",18882,18616,37498
"2712",1874,"47",19999,19093,39092
"2713",1874,"48",20257,19576,39833
"2714",1874,"49",20002,19834,39836
"2715",1874,"50",19734,19085,38819
"2716",1874,"51",18661,18526,37187
"2717",1874,"52",17624,17275,34899
"2718",1874,"53",17186,16122,33308
"2719",1874,"54",17226,16455,33681
"2720",1874,"55",15152,14587,29739
"2721",1874,"56",14847,14215,29062
"2722",1874,"57",15962,14474,30436
"2723",1874,"58",14585,13525,28110
"2724",1874,"59",13898,12539,26437
"2725",1874,"60",13511,11907,25418
"2726",1874,"61",11991,11138,23129
"2727",1874,"62",12683,10923,23606
"2728",1874,"63",11802,10293,22095
"2729",1874,"64",10557,9078,19635
"2730",1874,"65",9360,8239,17599
"2731",1874,"66",9384,8263,17647
"2732",1874,"67",9156,7916,17072
"2733",1874,"68",8651,7401,16052
"2734",1874,"69",8276,7011,15287
"2735",1874,"70",8007,6510,14517
"2736",1874,"71",7359,6301,13660
"2737",1874,"72",6951,5477,12428
"2738",1874,"73",6287,5386,11673
"2739",1874,"74",5795,4892,10687
"2740",1874,"75",4699,4040,8739
"2741",1874,"76",4484,3699,8183
"2742",1874,"77",3738,2964,6702
"2743",1874,"78",3293,2428,5721
"2744",1874,"79",2825,2231,5056
"2745",1874,"80",2459,1801,4260
"2746",1874,"81",2207,1473,3680
"2747",1874,"82",1745,1245,2990
"2748",1874,"83",1603,1012,2615
"2749",1874,"84",1065,694.53,1759.53
"2750",1874,"85",816,532.47,1348.47
"2751",1874,"86",710,510,1220
"2752",1874,"87",494,341,835
"2753",1874,"88",372,257,629
"2754",1874,"89",257,151,408
"2755",1874,"90",168,117,285
"2756",1874,"91",126,79,205
"2757",1874,"92",82,58,140
"2758",1874,"93",58,39,97
"2759",1874,"94",26,15,41
"2760",1874,"95",14,9,23
"2761",1874,"96",11,10,21
"2762",1874,"97",8,1,9
"2763",1874,"98",2,1,3
"2764",1874,"99",3,3,6
"2765",1874,"100",4,2,6
"2766",1874,"101",0,0,0
"2767",1874,"102",0,0,0
"2768",1874,"103",0,0,0
"2769",1874,"104",0,0,0
"2770",1874,"105",0,0,0
"2771",1874,"106",0,0,0
"2772",1874,"107",0,0,0
"2773",1874,"108",0,0,0
"2774",1874,"109",0,0,0
"2775",1874,"110+",0,0,0
"2776",1875,"0",58303,59593,117896
"2777",1875,"1",52112,51963,104075
"2778",1875,"2",48342,48515,96857
"2779",1875,"3",44657,44188,88845
"2780",1875,"4",44226,44312,88538
"2781",1875,"5",42192,42356,84548
"2782",1875,"6",41644,41838,83482
"2783",1875,"7",42031,42508,84539
"2784",1875,"8",41586,41886,83472
"2785",1875,"9",40697,40745,81442
"2786",1875,"10",40380,40622,81002
"2787",1875,"11",40090,40845,80935
"2788",1875,"12",36587,36897,73484
"2789",1875,"13",36723,37322,74045
"2790",1875,"14",33700,34000,67700
"2791",1875,"15",35311,35222,70533
"2792",1875,"16",31366,31677,63043
"2793",1875,"17",33068,33149,66217
"2794",1875,"18",32376,32513,64889
"2795",1875,"19",30454,30860,61314
"2796",1875,"20",30988,30942,61930
"2797",1875,"21",30591,30366,60957
"2798",1875,"22",32384,31568,63952
"2799",1875,"23",30590,30046,60636
"2800",1875,"24",31206,30627,61833
"2801",1875,"25",31655,30219,61874
"2802",1875,"26",26420,25751,52171
"2803",1875,"27",24847,23541,48388
"2804",1875,"28",25658,24091,49749
"2805",1875,"29",27930,26843,54773
"2806",1875,"30",28264,27261,55525
"2807",1875,"31",26821,25904,52725
"2808",1875,"32",27262,25942,53204
"2809",1875,"33",26087,25565,51652
"2810",1875,"34",27396,26064,53460
"2811",1875,"35",27394,25862,53256
"2812",1875,"36",25575,24956,50531
"2813",1875,"37",24071,23522,47593
"2814",1875,"38",24702,24111,48813
"2815",1875,"39",23357,22705,46062
"2816",1875,"40",22757,22025,44782
"2817",1875,"41",22546,22285,44831
"2818",1875,"42",20294,19873,40167
"2819",1875,"43",19427,19559,38986
"2820",1875,"44",21947,21008,42955
"2821",1875,"45",21233,20995,42228
"2822",1875,"46",19079,19005,38084
"2823",1875,"47",18610,18340,36950
"2824",1875,"48",19796,18833,38629
"2825",1875,"49",19998,19250,39248
"2826",1875,"50",19734,19530,39264
"2827",1875,"51",19456,18786,38242
"2828",1875,"52",18371,18182,36553
"2829",1875,"53",17334,16935,34269
"2830",1875,"54",16927,15771,32698
"2831",1875,"55",16881,16076,32957
"2832",1875,"56",14880,14249,29129
"2833",1875,"57",14548,13827,28375
"2834",1875,"58",15641,14116,29757
"2835",1875,"59",14248,13164,27412
"2836",1875,"60",13518,12133,25651
"2837",1875,"61",13139,11498,24637
"2838",1875,"62",11664,10739,22403
"2839",1875,"63",12318,10499,22817
"2840",1875,"64",11333,9847,21180
"2841",1875,"65",10163,8689,18852
"2842",1875,"66",9001,7832,16833
"2843",1875,"67",8986,7760,16746
"2844",1875,"68",8760,7512,16272
"2845",1875,"69",8184,6977,15161
"2846",1875,"70",7766,6587,14353
"2847",1875,"71",7507,6066,13573
"2848",1875,"72",6872,5808,12680
"2849",1875,"73",6367,5031,11398
"2850",1875,"74",5629,4950,10579
"2851",1875,"75",5252,4408,9660
"2852",1875,"76",4262,3718,7980
"2853",1875,"77",4008,3291,7299
"2854",1875,"78",3302,2622,5924
"2855",1875,"79",2881,2111,4992
"2856",1875,"80",2466,1905,4371
"2857",1875,"81",2105,1564,3669
"2858",1875,"82",1851,1236,3087
"2859",1875,"83",1456,1040,2496
"2860",1875,"84",1336,802,2138
"2861",1875,"85",862,576.53,1438.53
"2862",1875,"86",647,404.47,1051.47
"2863",1875,"87",550,396,946
"2864",1875,"88",409,245,654
"2865",1875,"89",284,189,473
"2866",1875,"90",192,112,304
"2867",1875,"91",117,84,201
"2868",1875,"92",89,51,140
"2869",1875,"93",58,41,99
"2870",1875,"94",29,33,62
"2871",1875,"95",19,9,28
"2872",1875,"96",7,7,14
"2873",1875,"97",6,6,12
"2874",1875,"98",4,0,4
"2875",1875,"99",2,1,3
"2876",1875,"100",1,3,4
"2877",1875,"101",1,0,1
"2878",1875,"102",0,0,0
"2879",1875,"103",0,0,0
"2880",1875,"104",0,0,0
"2881",1875,"105",0,0,0
"2882",1875,"106",0,0,0
"2883",1875,"107",0,0,0
"2884",1875,"108",0,0,0
"2885",1875,"109",0,0,0
"2886",1875,"110+",0,0,0
"2887",1876,"0",58104,59556,117660
"2888",1876,"1",51862,52424,104286
"2889",1876,"2",49986,49688,99674
"2890",1876,"3",47164,47336,94500
"2891",1876,"4",43886,43437,87323
"2892",1876,"5",43763,43752,87515
"2893",1876,"6",41924,42032,83956
"2894",1876,"7",41409,41576,82985
"2895",1876,"8",41784,42276,84060
"2896",1876,"9",41409,41670,83079
"2897",1876,"10",40495,40565,81060
"2898",1876,"11",40174,40402,80576
"2899",1876,"12",39935,40644,80579
"2900",1876,"13",36449,36719,73168
"2901",1876,"14",36510,37166,73676
"2902",1876,"15",33467,33804,67271
"2903",1876,"16",35157,35053,70210
"2904",1876,"17",31139,31424,62563
"2905",1876,"18",32797,32834,65631
"2906",1876,"19",32181,32186,64367
"2907",1876,"20",30206,30413,60619
"2908",1876,"21",30778,30522,61300
"2909",1876,"22",30354,29926,60280
"2910",1876,"23",32086,31200,63286
"2911",1876,"24",30213,29598,59811
"2912",1876,"25",30880,30274,61154
"2913",1876,"26",31345,29895,61240
"2914",1876,"27",26079,25484,51563
"2915",1876,"28",24517,23255,47772
"2916",1876,"29",25350,23829,49179
"2917",1876,"30",27572,26581,54153
"2918",1876,"31",27917,27018,54935
"2919",1876,"32",26468,25690,52158
"2920",1876,"33",26900,25741,52641
"2921",1876,"34",25743,25286,51029
"2922",1876,"35",27100,25887,52987
"2923",1876,"36",27036,25614,52650
"2924",1876,"37",25270,24733,50003
"2925",1876,"38",23743,23289,47032
"2926",1876,"39",24411,23862,48273
"2927",1876,"40",23084,22495,45579
"2928",1876,"41",22498,21755,44253
"2929",1876,"42",22264,21986,44250
"2930",1876,"43",20028,19606,39634
"2931",1876,"44",19157,19262,38419
"2932",1876,"45",21642,20721,42363
"2933",1876,"46",20950,20657,41607
"2934",1876,"47",18847,18717,37564
"2935",1876,"48",18356,18055,36411
"2936",1876,"49",19536,18522,38058
"2937",1876,"50",19691,18859,38550
"2938",1876,"51",19444,19188,38632
"2939",1876,"52",19146,18442,37588
"2940",1876,"53",17899,17771,35670
"2941",1876,"54",17019,16585,33604
"2942",1876,"55",16647,15380,32027
"2943",1876,"56",16517,15662,32179
"2944",1876,"57",14573,13851,28424
"2945",1876,"58",14208,13421,27629
"2946",1876,"59",15253,13663,28916
"2947",1876,"60",13885,12739,26624
"2948",1876,"61",13139,11693,24832
"2949",1876,"62",12739,11041,23780
"2950",1876,"63",11295,10257,21552
"2951",1876,"64",11886,10066,21952
"2952",1876,"65",10813,9368,20181
"2953",1876,"66",9665,8260,17925
"2954",1876,"67",8544,7375,15919
"2955",1876,"68",8502,7402,15904
"2956",1876,"69",8266,7047,15313
"2957",1876,"70",7670,6517,14187
"2958",1876,"71",7240,6144,13384
"2959",1876,"72",6912,5574,12486
"2960",1876,"73",6302,5280,11582
"2961",1876,"74",5781,4557,10338
"2962",1876,"75",4953,4462,9415
"2963",1876,"76",4680,3915,8595
"2964",1876,"77",3766,3266,7032
"2965",1876,"78",3501,2879,6380
"2966",1876,"79",2877,2249,5126
"2967",1876,"80",2481,1798,4279
"2968",1876,"81",2098,1599,3697
"2969",1876,"82",1740,1272,3012
"2970",1876,"83",1535,994,2529
"2971",1876,"84",1147,819,1966
"2972",1876,"85",1041,601,1642
"2973",1876,"86",672,440.53,1112.53
"2974",1876,"87",490,297.47,787.47
"2975",1876,"88",394,288,682
"2976",1876,"89",299,167,466
"2977",1876,"90",203,140,343
"2978",1876,"91",121,80,201
"2979",1876,"92",79,59,138
"2980",1876,"93",57,33,90
"2981",1876,"94",36,30,66
"2982",1876,"95",11,15,26
"2983",1876,"96",9,6,15
"2984",1876,"97",4,4,8
"2985",1876,"98",4,3,7
"2986",1876,"99",1,0,1
"2987",1876,"100",1,1,2
"2988",1876,"101",0,0,0
"2989",1876,"102",1,0,1
"2990",1876,"103",0,0,0
"2991",1876,"104",0,0,0
"2992",1876,"105",0,0,0
"2993",1876,"106",0,0,0
"2994",1876,"107",0,0,0
"2995",1876,"108",0,0,0
"2996",1876,"109",0,0,0
"2997",1876,"110+",0,0,0
"2998",1877,"0",60587,62081,122668
"2999",1877,"1",52294,52886,105180
"3000",1877,"2",49983,50450,100433
"3001",1877,"3",49183,48696,97879
"3002",1877,"4",46534,46666,93200
"3003",1877,"5",43384,42894,86278
"3004",1877,"6",43520,43353,86873
"3005",1877,"7",41747,41828,83575
"3006",1877,"8",41221,41372,82593
"3007",1877,"9",41553,42099,83652
"3008",1877,"10",41269,41475,82744
"3009",1877,"11",40342,40421,80763
"3010",1877,"12",39990,40173,80163
"3011",1877,"13",39756,40452,80208
"3012",1877,"14",36301,36535,72836
"3013",1877,"15",36272,36977,73249
"3014",1877,"16",33218,33604,66822
"3015",1877,"17",34297,34854,69151
"3016",1877,"18",30980,31143,62123
"3017",1877,"19",32513,32488,65001
"3018",1877,"20",32014,31804,63818
"3019",1877,"21",29934,29967,59901
"3020",1877,"22",30612,30103,60715
"3021",1877,"23",30093,29492,59585
"3022",1877,"24",31808,30811,62619
"3023",1877,"25",29869,29164,59033
"3024",1877,"26",30579,29924,60503
"3025",1877,"27",31072,29555,60627
"3026",1877,"28",25761,25185,50946
"3027",1877,"29",24189,22980,47169
"3028",1877,"30",25025,23558,48583
"3029",1877,"31",27227,26320,53547
"3030",1877,"32",27585,26785,54370
"3031",1877,"33",26113,25454,51567
"3032",1877,"34",26558,25523,52081
"3033",1877,"35",25407,25038,50445
"3034",1877,"36",26821,25731,52552
"3035",1877,"37",26741,25398,52139
"3036",1877,"38",24971,24504,49475
"3037",1877,"39",23447,23071,46518
"3038",1877,"40",24126,23644,47770
"3039",1877,"41",22829,22242,45071
"3040",1877,"42",22265,21510,43775
"3041",1877,"43",21963,21718,43681
"3042",1877,"44",19767,19380,39147
"3043",1877,"45",18914,18993,37907
"3044",1877,"46",21389,20433,41822
"3045",1877,"47",20697,20361,41058
"3046",1877,"48",18620,18460,37080
"3047",1877,"49",18106,17762,35868
"3048",1877,"50",19281,18236,37517
"3049",1877,"51",19392,18501,37893
"3050",1877,"52",19166,18863,38029
"3051",1877,"53",18862,18056,36918
"3052",1877,"54",17823,17376,35199
"3053",1877,"55",16716,16244,32960
"3054",1877,"56",16362,15017,31379
"3055",1877,"57",16172,15240,31412
"3056",1877,"58",14281,13469,27750
"3057",1877,"59",13872,13052,26924
"3058",1877,"60",14890,13227,28117
"3059",1877,"61",13537,12336,25873
"3060",1877,"62",12743,11277,24020
"3061",1877,"63",12355,10603,22958
"3062",1877,"64",10922,9859,20781
"3063",1877,"65",11430,9609,21039
"3064",1877,"66",10381,8962,19343
"3065",1877,"67",9223,7800,17023
"3066",1877,"68",8103,6967,15070
"3067",1877,"69",8056,6985,15041
"3068",1877,"70",7820,6617,14437
"3069",1877,"71",7184,6085,13269
"3070",1877,"72",6748,5648,12396
"3071",1877,"73",6346,5119,11465
"3072",1877,"74",5776,4790,10566
"3073",1877,"75",5252,4142,9394
"3074",1877,"76",4336,4015,8351
"3075",1877,"77",4183,3483,7666
"3076",1877,"78",3348,2881,6229
"3077",1877,"79",3094,2503,5597
"3078",1877,"80",2521,1936,4457
"3079",1877,"81",2134,1539,3673
"3080",1877,"82",1793,1340,3133
"3081",1877,"83",1443,1060,2503
"3082",1877,"84",1257,811,2068
"3083",1877,"85",915,658,1573
"3084",1877,"86",838,458,1296
"3085",1877,"87",521,326.53,847.53
"3086",1877,"88",370,215.47,585.47
"3087",1877,"89",294,209,503
"3088",1877,"90",216,115,331
"3089",1877,"91",155,95,250
"3090",1877,"92",85,55,140
"3091",1877,"93",46,35,81
"3092",1877,"94",31,22,53
"3093",1877,"95",26,17,43
"3094",1877,"96",6,9,15
"3095",1877,"97",1,5,6
"3096",1877,"98",2,2,4
"3097",1877,"99",3,2,5
"3098",1877,"100",0,0,0
"3099",1877,"101",0,1,1
"3100",1877,"102",0,0,0
"3101",1877,"103",0,0,0
"3102",1877,"104",0,0,0
"3103",1877,"105",0,0,0
"3104",1877,"106",0,0,0
"3105",1877,"107",0,0,0
"3106",1877,"108",0,0,0
"3107",1877,"109",0,0,0
"3108",1877,"110+",0,0,0
"3109",1878,"0",61462,62909,124371
"3110",1878,"1",54913,55425,110338
"3111",1878,"2",50338,50863,101201
"3112",1878,"3",49123,49516,98639
"3113",1878,"4",47707,48138,95845
"3114",1878,"5",46116,46175,92291
"3115",1878,"6",42994,42469,85463
"3116",1878,"7",42339,43018,85357
"3117",1878,"8",41656,41689,83345
"3118",1878,"9",41085,41253,82338
"3119",1878,"10",41359,41959,83318
"3120",1878,"11",41148,41341,82489
"3121",1878,"12",40190,40298,80488
"3122",1878,"13",39793,39994,79787
"3123",1878,"14",39582,40273,79855
"3124",1878,"15",36142,36340,72482
"3125",1878,"16",36054,36778,72832
"3126",1878,"17",32957,33387,66344
"3127",1878,"18",34821,34638,69459
"3128",1878,"19",30798,30844,61642
"3129",1878,"20",32244,32100,64344
"3130",1878,"21",31857,31457,63314
"3131",1878,"22",29700,29539,59239
"3132",1878,"23",30439,29715,60154
"3133",1878,"24",29849,29112,58961
"3134",1878,"25",31548,30458,62006
"3135",1878,"26",29529,28728,58257
"3136",1878,"27",30276,29597,59873
"3137",1878,"28",30801,29250,60051
"3138",1878,"29",25457,24926,50383
"3139",1878,"30",23854,22692,46546
"3140",1878,"31",24728,23302,48030
"3141",1878,"32",26916,26084,53000
"3142",1878,"33",27270,26539,53809
"3143",1878,"34",25804,25253,51057
"3144",1878,"35",26246,25317,51563
"3145",1878,"36",25086,24767,49853
"3146",1878,"37",26564,25548,52112
"3147",1878,"38",26439,25191,51630
"3148",1878,"39",24736,24294,49030
"3149",1878,"40",23151,22887,46038
"3150",1878,"41",23873,23410,47283
"3151",1878,"42",22574,22030,44604
"3152",1878,"43",22048,21232,43280
"3153",1878,"44",21704,21464,43168
"3154",1878,"45",19521,19145,38666
"3155",1878,"46",18668,18737,37405
"3156",1878,"47",21135,20140,41275
"3157",1878,"48",20437,20086,40523
"3158",1878,"49",18397,18205,36602
"3159",1878,"50",17869,17482,35351
"3160",1878,"51",19054,17946,37000
"3161",1878,"52",19102,18160,37262
"3162",1878,"53",18901,18549,37450
"3163",1878,"54",18551,17720,36271
"3164",1878,"55",17542,16995,34537
"3165",1878,"56",16409,15882,32291
"3166",1878,"57",16105,14676,30781
"3167",1878,"58",15837,14827,30664
"3168",1878,"59",13974,13095,27069
"3169",1878,"60",13533,12694,26227
"3170",1878,"61",14540,12801,27341
"3171",1878,"62",13144,11958,25102
"3172",1878,"63",12358,10836,23194
"3173",1878,"64",11946,10204,22150
"3174",1878,"65",10531,9427,19958
"3175",1878,"66",10989,9172,20161
"3176",1878,"67",9914,8544,18458
"3177",1878,"68",8761,7377,16138
"3178",1878,"69",7651,6628,14279
"3179",1878,"70",7596,6598,14194
"3180",1878,"71",7370,6203,13573
"3181",1878,"72",6724,5627,12351
"3182",1878,"73",6240,5197,11437
"3183",1878,"74",5838,4697,10535
"3184",1878,"75",5308,4378,9686
"3185",1878,"76",4756,3719,8475
"3186",1878,"77",3787,3577,7364
"3187",1878,"78",3715,3090,6805
"3188",1878,"79",2973,2507,5480
"3189",1878,"80",2786,2190,4976
"3190",1878,"81",2177,1661,3838
"3191",1878,"82",1829,1301,3130
"3192",1878,"83",1515,1097,2612
"3193",1878,"84",1190,848,2038
"3194",1878,"85",1033,639,1672
"3195",1878,"86",722,519,1241
"3196",1878,"87",652,364,1016
"3197",1878,"88",412,233.53,645.53
"3198",1878,"89",284,160.47,444.47
"3199",1878,"90",221,151,372
"3200",1878,"91",162,85,247
"3201",1878,"92",109,78,187
"3202",1878,"93",61,33,94
"3203",1878,"94",31,23,54
"3204",1878,"95",21,13,34
"3205",1878,"96",22,9,31
"3206",1878,"97",4,5,9
"3207",1878,"98",0,3,3
"3208",1878,"99",2,2,4
"3209",1878,"100",2,1,3
"3210",1878,"101",0,0,0
"3211",1878,"102",0,0,0
"3212",1878,"103",0,0,0
"3213",1878,"104",0,0,0
"3214",1878,"105",0,0,0
"3215",1878,"106",0,0,0
"3216",1878,"107",0,0,0
"3217",1878,"108",0,0,0
"3218",1878,"109",0,0,0
"3219",1878,"110+",0,0,0
"3220",1879,"0",61017,62772,123789
"3221",1879,"1",55199,55789,110988
"3222",1879,"2",52744,53048,105792
"3223",1879,"3",49315,49819,99134
"3224",1879,"4",48506,48855,97361
"3225",1879,"5",47377,47629,95006
"3226",1879,"6",45767,45794,91561
"3227",1879,"7",42667,42108,84775
"3228",1879,"8",42189,42759,84948
"3229",1879,"9",41565,41577,83142
"3230",1879,"10",40967,41127,82094
"3231",1879,"11",41170,41834,83004
"3232",1879,"12",41060,41227,82287
"3233",1879,"13",40028,40182,80210
"3234",1879,"14",39583,39785,79368
"3235",1879,"15",39391,40091,79482
"3236",1879,"16",35990,36132,72122
"3237",1879,"17",35829,36573,72402
"3238",1879,"18",32706,33152,65858
"3239",1879,"19",34665,34397,69062
"3240",1879,"20",30543,30536,61079
"3241",1879,"21",32004,31742,63746
"3242",1879,"22",31684,31122,62806
"3243",1879,"23",29425,29128,58553
"3244",1879,"24",29769,29335,59104
"3245",1879,"25",29581,28742,58323
"3246",1879,"26",31266,30100,61366
"3247",1879,"27",29185,28316,57501
"3248",1879,"28",29998,29285,59283
"3249",1879,"29",30537,28962,59499
"3250",1879,"30",25144,24673,49817
"3251",1879,"31",23515,22402,45917
"3252",1879,"32",24413,23040,47453
"3253",1879,"33",26578,25830,52408
"3254",1879,"34",26934,26290,53224
"3255",1879,"35",25502,25016,50518
"3256",1879,"36",25946,25118,51064
"3257",1879,"37",24743,24501,49244
"3258",1879,"38",26279,25319,51598
"3259",1879,"39",26154,24998,51152
"3260",1879,"40",24500,24087,48587
"3261",1879,"41",22878,22706,45584
"3262",1879,"42",23614,23177,46791
"3263",1879,"43",22357,21802,44159
"3264",1879,"44",21805,20967,42772
"3265",1879,"45",21423,21203,42626
"3266",1879,"46",19279,18896,38175
"3267",1879,"47",18427,18470,36897
"3268",1879,"48",20880,19854,40734
"3269",1879,"49",20157,19796,39953
"3270",1879,"50",18181,17978,36159
"3271",1879,"51",17599,17192,34791
"3272",1879,"52",18814,17657,36471
"3273",1879,"53",18792,17780,36572
"3274",1879,"54",18583,18196,36779
"3275",1879,"55",18244,17343,35587
"3276",1879,"56",17264,16612,33876
"3277",1879,"57",16099,15489,31588
"3278",1879,"58",15809,14301,30110
"3279",1879,"59",15435,14407,29842
"3280",1879,"60",13644,12718,26362
"3281",1879,"61",13163,12293,25456
"3282",1879,"62",14154,12330,26484
"3283",1879,"63",12713,11513,24226
"3284",1879,"64",11960,10426,22386
"3285",1879,"65",11477,9751,21228
"3286",1879,"66",9999,8957,18956
"3287",1879,"67",10523,8749,19272
"3288",1879,"68",9383,8123,17506
"3289",1879,"69",8271,6962,15233
"3290",1879,"70",7233,6095,13328
"3291",1879,"71",7121,6148,13269
"3292",1879,"72",6874,5769,12643
"3293",1879,"73",6203,5143,11346
"3294",1879,"74",5744,4739,10483
"3295",1879,"75",5270,4273,9543
"3296",1879,"76",4808,3916,8724
"3297",1879,"77",4262,3295,7557
"3298",1879,"78",3184,3118,6302
"3299",1879,"79",3268,2659,5927
"3300",1879,"80",2710.21,2217,4927.21
"3301",1879,"81",2389,1848,4237
"3302",1879,"82",1831,1400,3231
"3303",1879,"83",1526,1051,2577
"3304",1879,"84",1238,894,2132
"3305",1879,"85",964,678,1642
"3306",1879,"86",816,513,1329
"3307",1879,"87",561,396,957
"3308",1879,"88",481,282,763
"3309",1879,"89",311,166.53,477.53
"3310",1879,"90",207,116.47,323.47
"3311",1879,"91",160,97,257
"3312",1879,"92",115,57,172
"3313",1879,"93",75,51,126
"3314",1879,"94",36,19,55
"3315",1879,"95",20,13,33
"3316",1879,"96",13,6,19
"3317",1879,"97",10,7,17
"3318",1879,"98",3,1,4
"3319",1879,"99",0,1,1
"3320",1879,"100",0,0,0
"3321",1879,"101",2,0,2
"3322",1879,"102",0,0,0
"3323",1879,"103",0,0,0
"3324",1879,"104",0,0,0
"3325",1879,"105",0,0,0
"3326",1879,"106",0,0,0
"3327",1879,"107",0,0,0
"3328",1879,"108",0,0,0
"3329",1879,"109",0,0,0
"3330",1879,"110+",0,0,0
"3331",1880,"0",63889,65243,129132
"3332",1880,"1",55419,56325,111744
"3333",1880,"2",53038,53510,106548
"3334",1880,"3",51727,51995,103722
"3335",1880,"4",48696,49138,97834
"3336",1880,"5",48024,48327,96351
"3337",1880,"6",47034,47186,94220
"3338",1880,"7",45462,45464,90926
"3339",1880,"8",42333,41795,84128
"3340",1880,"9",41997,42496,84493
"3341",1880,"10",41398,41379,82777
"3342",1880,"11",40809,40907,81716
"3343",1880,"12",40959,41604,82563
"3344",1880,"13",40880,40976,81856
"3345",1880,"14",39794,39945,79739
"3346",1880,"15",39345,39493,78838
"3347",1880,"16",39142,39786,78928
"3348",1880,"17",35762,35844,71606
"3349",1880,"18",35535,36236,71771
"3350",1880,"19",32482,32834,65316
"3351",1880,"20",34422,34032,68454
"3352",1880,"21",30406,30178,60584
"3353",1880,"22",31736,31369,63105
"3354",1880,"23",31433,30763,62196
"3355",1880,"24",29164,28786,57950
"3356",1880,"25",29999,29009,59008
"3357",1880,"26",29304,28432,57736
"3358",1880,"27",30978,29804,60782
"3359",1880,"28",28869,27991,56860
"3360",1880,"29",29695,29017,58712
"3361",1880,"30",30219,28657,58876
"3362",1880,"31",24849,24474,49323
"3363",1880,"32",23269,22166,45435
"3364",1880,"33",24127,22820,46947
"3365",1880,"34",26294,25525,51819
"3366",1880,"35",26629,26046,52675
"3367",1880,"36",25176,24798,49974
"3368",1880,"37",25636,24921,50557
"3369",1880,"38",24424,24301,48725
"3370",1880,"39",26016,25112,51128
"3371",1880,"40",25810,24755,50565
"3372",1880,"41",24218,23868,48086
"3373",1880,"42",22612,22486,45098
"3374",1880,"43",23324,22912,46236
"3375",1880,"44",22088,21529,43617
"3376",1880,"45",21563,20732,42295
"3377",1880,"46",21156,20938,42094
"3378",1880,"47",19043,18624,37667
"3379",1880,"48",18206,18186,36392
"3380",1880,"49",20608,19563,40171
"3381",1880,"50",19880,19479,39359
"3382",1880,"51",17932,17688,35620
"3383",1880,"52",17359,16886,34245
"3384",1880,"53",18545,17324,35869
"3385",1880,"54",18465,17419,35884
"3386",1880,"55",18306,17836,36142
"3387",1880,"56",17907,16967,34874
"3388",1880,"57",16976,16225,33201
"3389",1880,"58",15757,15096,30853
"3390",1880,"59",15445,13900,29345
"3391",1880,"60",15019,13931,28950
"3392",1880,"61",13280,12322,25602
"3393",1880,"62",12742,11873,24615
"3394",1880,"63",13713,11871,25584
"3395",1880,"64",12255,11004,23259
"3396",1880,"65",11506,10005,21511
"3397",1880,"66",11016,9392,20408
"3398",1880,"67",9740,8505,18245
"3399",1880,"68",10033,8253,18286
"3400",1880,"69",9243,7614,16857
"3401",1880,"70",7778,6501,14279
"3402",1880,"71",6786,5839,12625
"3403",1880,"72",6605,5660,12265
"3404",1880,"73",6325,5281,11606
"3405",1880,"74",5704,4683,10387
"3406",1880,"75",5224,4262,9486
"3407",1880,"76",4746,3784,8530
"3408",1880,"77",4269,3456,7725
"3409",1880,"78",3739,2875,6614
"3410",1880,"79",3497,2669,6166
"3411",1880,"80",2811.79,2215,5026.79
"3412",1880,"81",2283.21,1891,4174.21
"3413",1880,"82",2018,1535,3553
"3414",1880,"83",1506,1143,2649
"3415",1880,"84",1231,837,2068
"3416",1880,"85",971,719,1690
"3417",1880,"86",742,520,1262
"3418",1880,"87",615,400,1015
"3419",1880,"88",432,293,725
"3420",1880,"89",370,203,573
"3421",1880,"90",228,115.53,343.53
"3422",1880,"91",154,73.47,227.47
"3423",1880,"92",110,59,169
"3424",1880,"93",79,39,118
"3425",1880,"94",43,31,74
"3426",1880,"95",25,11,36
"3427",1880,"96",12,6,18
"3428",1880,"97",8,4,12
"3429",1880,"98",4,4,8
"3430",1880,"99",1,1,2
"3431",1880,"100",0,0,0
"3432",1880,"101",0,0,0
"3433",1880,"102",1,0,1
"3434",1880,"103",0,0,0
"3435",1880,"104",0,0,0
"3436",1880,"105",0,0,0
"3437",1880,"106",0,0,0
"3438",1880,"107",0,0,0
"3439",1880,"108",0,0,0
"3440",1880,"109",0,0,0
"3441",1880,"110+",0,0,0
"3442",1881,"0",60767,61723,122490
"3443",1881,"1",57160,57249,114409
"3444",1881,"2",52970,53793,106763
"3445",1881,"3",51881,52311,104192
"3446",1881,"4",50935,51219,102154
"3447",1881,"5",48162,48583,96745
"3448",1881,"6",47592,47863,95455
"3449",1881,"7",46706,46814,93520
"3450",1881,"8",45165,45159,90324
"3451",1881,"9",42039,41485,83524
"3452",1881,"10",41776,42196,83972
"3453",1881,"11",41178,41061,82239
"3454",1881,"12",40609,40568,81177
"3455",1881,"13",40688,41228,81916
"3456",1881,"14",40603,40597,81200
"3457",1881,"15",39525,39584,79109
"3458",1881,"16",39078,39099,78177
"3459",1881,"17",38853,39383,78236
"3460",1881,"18",35462,35432,70894
"3461",1881,"19",35198,35744,70942
"3462",1881,"20",32219,32396,64615
"3463",1881,"21",34124,33565,67689
"3464",1881,"22",30147,29859,60006
"3465",1881,"23",31489,31029,62518
"3466",1881,"24",31123,30390,61513
"3467",1881,"25",28865,28469,57334
"3468",1881,"26",29708,28712,58420
"3469",1881,"27",29069,28171,57240
"3470",1881,"28",30690,29515,60205
"3471",1881,"29",28618,27782,56400
"3472",1881,"30",29376,28751,58127
"3473",1881,"31",29924,28450,58374
"3474",1881,"32",24610,24292,48902
"3475",1881,"33",23047,21957,45004
"3476",1881,"34",23862,22639,46501
"3477",1881,"35",26047,25319,51366
"3478",1881,"36",26331,25823,52154
"3479",1881,"37",24894,24548,49442
"3480",1881,"38",25359,24692,50051
"3481",1881,"39",24122,24088,48210
"3482",1881,"40",25686,24822,50508
"3483",1881,"41",25461,24489,49950
"3484",1881,"42",23950,23635,47585
"3485",1881,"43",22355,22222,44577
"3486",1881,"44",23057,22636,45693
"3487",1881,"45",21814,21259,43073
"3488",1881,"46",21317,20443,41760
"3489",1881,"47",20917,20671,41588
"3490",1881,"48",18815,18319,37134
"3491",1881,"49",18003,17905,35908
"3492",1881,"50",20327,19239,39566
"3493",1881,"51",19594,19143,38737
"3494",1881,"52",17695,17358,35053
"3495",1881,"53",17107,16565,33672
"3496",1881,"54",18251,16980,35231
"3497",1881,"55",18187,17069,35256
"3498",1881,"56",18016,17422,35438
"3499",1881,"57",17576,16544,34120
"3500",1881,"58",16660,15814,32474
"3501",1881,"59",15434,14674,30108
"3502",1881,"60",15090,13501,28591
"3503",1881,"61",14632,13488,28120
"3504",1881,"62",12925,11944,24869
"3505",1881,"63",12363,11457,23820
"3506",1881,"64",13213,11386,24599
"3507",1881,"65",11817,10543,22360
"3508",1881,"66",11096,9547,20643
"3509",1881,"67",10555,8909,19464
"3510",1881,"68",9243,8039,17282
"3511",1881,"69",9511,7771,17282
"3512",1881,"70",8723,7104,15827
"3513",1881,"71",7314,5996,13310
"3514",1881,"72",6318,5401,11719
"3515",1881,"73",6122,5228,11350
"3516",1881,"74",5811,4835,10646
"3517",1881,"75",5182,4266,9448
"3518",1881,"76",4752,3783,8535
"3519",1881,"77",4245,3376,7621
"3520",1881,"78",3768,3080,6848
"3521",1881,"79",3277,2537,5814
"3522",1881,"80",3159,2390,5549
"3523",1881,"81",2406.79,1867,4273.79
"3524",1881,"82",1894.21,1598,3492.21
"3525",1881,"83",1696,1257,2953
"3526",1881,"84",1243,892,2135
"3527",1881,"85",1014,654,1668
"3528",1881,"86",766,567,1333
"3529",1881,"87",579,411,990
"3530",1881,"88",466,312,778
"3531",1881,"89",335,228,563
"3532",1881,"90",273,138,411
"3533",1881,"91",174,85.53,259.53
"3534",1881,"92",109,48.47,157.47
"3535",1881,"93",75,31,106
"3536",1881,"94",48,23,71
"3537",1881,"95",30,24,54
"3538",1881,"96",13,5,18
"3539",1881,"97",6,4,10
"3540",1881,"98",6,2,8
"3541",1881,"99",3,2,5
"3542",1881,"100",0,0,0
"3543",1881,"101",0,0,0
"3544",1881,"102",0,0,0
"3545",1881,"103",0,0,0
"3546",1881,"104",0,0,0
"3547",1881,"105",0,0,0
"3548",1881,"106",0,0,0
"3549",1881,"107",0,0,0
"3550",1881,"108",0,0,0
"3551",1881,"109",0,0,0
"3552",1881,"110+",0,0,0
"3553",1882,"0",61825,63314,125139
"3554",1882,"1",55135,55265,110400
"3555",1882,"2",55029,55115,110144
"3556",1882,"3",51930,52719,104649
"3557",1882,"4",51187,51593,102780
"3558",1882,"5",50427,50695,101122
"3559",1882,"6",47791,48202,95993
"3560",1882,"7",47258,47510,94768
"3561",1882,"8",46411,46484,92895
"3562",1882,"9",44963,44895,89858
"3563",1882,"10",41762,41204,82966
"3564",1882,"11",41574,41931,83505
"3565",1882,"12",40977,40786,81763
"3566",1882,"13",40389,40224,80613
"3567",1882,"14",40436,40869,81305
"3568",1882,"15",40345,40230,80575
"3569",1882,"16",39266,39191,78457
"3570",1882,"17",38822,38683,77505
"3571",1882,"18",38551,38904,77455
"3572",1882,"19",35165,35002,70167
"3573",1882,"20",34900,35260,70160
"3574",1882,"21",31980,31999,63979
"3575",1882,"22",33819,33132,66951
"3576",1882,"23",29916,29519,59435
"3577",1882,"24",31218,30663,61881
"3578",1882,"25",30825,30038,60863
"3579",1882,"26",28582,28175,56757
"3580",1882,"27",29441,28450,57891
"3581",1882,"28",28783,27910,56693
"3582",1882,"29",30379,29247,59626
"3583",1882,"30",28357,27556,55913
"3584",1882,"31",29062,28506,57568
"3585",1882,"32",29626,28198,57824
"3586",1882,"33",24365,24118,48483
"3587",1882,"34",22799,21783,44582
"3588",1882,"35",23585,22464,46049
"3589",1882,"36",25763,25079,50842
"3590",1882,"37",26041,25573,51614
"3591",1882,"38",24621,24304,48925
"3592",1882,"39",25070,24456,49526
"3593",1882,"40",23851,23860,47711
"3594",1882,"41",25366,24550,49916
"3595",1882,"42",25123,24197,49320
"3596",1882,"43",23670,23376,47046
"3597",1882,"44",22112,21958,44070
"3598",1882,"45",22801,22366,45167
"3599",1882,"46",21550,20961,42511
"3600",1882,"47",21087,20162,41249
"3601",1882,"48",20689,20358,41047
"3602",1882,"49",18587,18044,36631
"3603",1882,"50",17778,17609,35387
"3604",1882,"51",20040,18886,38926
"3605",1882,"52",19314,18758,38072
"3606",1882,"53",17429,17053,34482
"3607",1882,"54",16856,16231,33087
"3608",1882,"55",17945,16616,34561
"3609",1882,"56",17850,16681,34531
"3610",1882,"57",17697,16996,34693
"3611",1882,"58",17221,16094,33315
"3612",1882,"59",16310,15410,31720
"3613",1882,"60",15100,14268,29368
"3614",1882,"61",14679,13099,27778
"3615",1882,"62",14241,13049,27290
"3616",1882,"63",12561,11555,24116
"3617",1882,"64",11937,11002,22939
"3618",1882,"65",12734,10937,23671
"3619",1882,"66",11376,10056,21432
"3620",1882,"67",10639,9096,19735
"3621",1882,"68",10059,8433,18492
"3622",1882,"69",8794,7586,16380
"3623",1882,"70",8989,7268,16257
"3624",1882,"71",8161,6600,14761
"3625",1882,"72",6808,5538,12346
"3626",1882,"73",5840,4977,10817
"3627",1882,"74",5638,4739,10377
"3628",1882,"75",5286,4365,9651
"3629",1882,"76",4681,3796,8477
"3630",1882,"77",4275,3364,7639
"3631",1882,"78",3801,2972,6773
"3632",1882,"79",3309,2698,6007
"3633",1882,"80",2767,2151,4918
"3634",1882,"81",2709,2030,4739
"3635",1882,"82",2059.79,1550,3609.79
"3636",1882,"83",1584.21,1324,2908.21
"3637",1882,"84",1391,1011,2402
"3638",1882,"85",960,722,1682
"3639",1882,"86",803,522,1325
"3640",1882,"87",587,447,1034
"3641",1882,"88",443,310,753
"3642",1882,"89",369,237,606
"3643",1882,"90",267,154,421
"3644",1882,"91",186,105,291
"3645",1882,"92",121,60.53,181.53
"3646",1882,"93",77,33.47,110.47
"3647",1882,"94",51,26,77
"3648",1882,"95",35,18,53
"3649",1882,"96",20,16,36
"3650",1882,"97",8,4,12
"3651",1882,"98",4,3,7
"3652",1882,"99",3,1,4
"3653",1882,"100",0,0,0
"3654",1882,"101",0,0,0
"3655",1882,"102",0,0,0
"3656",1882,"103",0,0,0
"3657",1882,"104",0,0,0
"3658",1882,"105",0,0,0
"3659",1882,"106",0,0,0
"3660",1882,"107",0,0,0
"3661",1882,"108",0,0,0
"3662",1882,"109",0,0,0
"3663",1882,"110+",0,0,0
"3664",1883,"0",63729,65436,129165
"3665",1883,"1",56215,56697,112912
"3666",1883,"2",53114,53175,106289
"3667",1883,"3",53971,54032,108003
"3668",1883,"4",51264,51987,103251
"3669",1883,"5",50699,51061,101760
"3670",1883,"6",50071,50266,100337
"3671",1883,"7",47519,47871,95390
"3672",1883,"8",46976,47258,94234
"3673",1883,"9",46167,46211,92378
"3674",1883,"10",44749,44681,89430
"3675",1883,"11",41516,40961,82477
"3676",1883,"12",41401,41660,83061
"3677",1883,"13",40757,40482,81239
"3678",1883,"14",40175,39916,80091
"3679",1883,"15",40161,40515,80676
"3680",1883,"16",40059,39871,79930
"3681",1883,"17",38973,38795,77768
"3682",1883,"18",38533,38254,76787
"3683",1883,"19",38279,38444,76723
"3684",1883,"20",34873,34568,69441
"3685",1883,"21",34580,34762,69342
"3686",1883,"22",31741,31589,63330
"3687",1883,"23",33530,32708,66238
"3688",1883,"24",29663,29208,58871
"3689",1883,"25",30951,30309,61260
"3690",1883,"26",30528,29722,60250
"3691",1883,"27",28286,27863,56149
"3692",1883,"28",29164,28178,57342
"3693",1883,"29",28524,27672,56196
"3694",1883,"30",30065,28998,59063
"3695",1883,"31",28091,27361,55452
"3696",1883,"32",28780,28254,57034
"3697",1883,"33",29275,27949,57224
"3698",1883,"34",24139,23912,48051
"3699",1883,"35",22566,21608,44174
"3700",1883,"36",23320,22268,45588
"3701",1883,"37",25506,24895,50401
"3702",1883,"38",25733,25352,51085
"3703",1883,"39",24360,24055,48415
"3704",1883,"40",24794,24213,49007
"3705",1883,"41",23588,23645,47233
"3706",1883,"42",25056,24274,49330
"3707",1883,"43",24793,23905,48698
"3708",1883,"44",23422,23083,46505
"3709",1883,"45",21873,21667,43540
"3710",1883,"46",22529,22098,44627
"3711",1883,"47",21291,20687,41978
"3712",1883,"48",20839,19872,40711
"3713",1883,"49",20481,20052,40533
"3714",1883,"50",18338,17752,36090
"3715",1883,"51",17535,17324,34859
"3716",1883,"52",19775,18555,38330
"3717",1883,"53",19036,18369,37405
"3718",1883,"54",17154,16714,33868
"3719",1883,"55",16591,15898,32489
"3720",1883,"56",17626,16256,33882
"3721",1883,"57",17548,16295,33843
"3722",1883,"58",17398,16584,33982
"3723",1883,"59",16881,15627,32508
"3724",1883,"60",15998,14983,30981
"3725",1883,"61",14763,13831,28594
"3726",1883,"62",14329,12711,27040
"3727",1883,"63",13841,12549,26390
"3728",1883,"64",12180,11131,23311
"3729",1883,"65",11569,10552,22121
"3730",1883,"66",12200,10520,22720
"3731",1883,"67",10906,9548,20454
"3732",1883,"68",10154,8598,18752
"3733",1883,"69",9586,7981,17567
"3734",1883,"70",8343,7104,15447
"3735",1883,"71",8486,6787,15273
"3736",1883,"72",7673,6117,13790
"3737",1883,"73",6342,5105,11447
"3738",1883,"74",5365,4517,9882
"3739",1883,"75",5145,4303,9448
"3740",1883,"76",4821,3939,8760
"3741",1883,"77",4220,3392,7612
"3742",1883,"78",3826,3009,6835
"3743",1883,"79",3382,2598,5980
"3744",1883,"80",2905,2305,5210
"3745",1883,"81",2399,1831,4230
"3746",1883,"82",2299,1704,4003
"3747",1883,"83",1732.79,1270,3002.79
"3748",1883,"84",1306.21,1077,2383.21
"3749",1883,"85",1135,818,1953
"3750",1883,"86",763,586,1349
"3751",1883,"87",646,397,1043
"3752",1883,"88",463,341,804
"3753",1883,"89",325,233,558
"3754",1883,"90",266,171,437
"3755",1883,"91",200,110,310
"3756",1883,"92",131,68,199
"3757",1883,"93",83,46.53,129.53
"3758",1883,"94",53,20.47,73.47
"3759",1883,"95",33,16,49
"3760",1883,"96",20,11,31
"3761",1883,"97",9,9,18
"3762",1883,"98",4,2,6
"3763",1883,"99",2,2,4
"3764",1883,"100",0,0,0
"3765",1883,"101",0,0,0
"3766",1883,"102",0,0,0
"3767",1883,"103",0,0,0
"3768",1883,"104",0,0,0
"3769",1883,"105",0,0,0
"3770",1883,"106",0,0,0
"3771",1883,"107",0,0,0
"3772",1883,"108",0,0,0
"3773",1883,"109",0,0,0
"3774",1883,"110+",0,0,0
"3775",1884,"0",62172,63731,125903
"3776",1884,"1",57834,58432,116266
"3777",1884,"2",53958,54359,108317
"3778",1884,"3",51965,52002,103967
"3779",1884,"4",53115,53183,106298
"3780",1884,"5",50659,51364,102023
"3781",1884,"6",50233,50602,100835
"3782",1884,"7",49712,49901,99613
"3783",1884,"8",47273,47562,94835
"3784",1884,"9",46745,46979,93724
"3785",1884,"10",45931,45940,91871
"3786",1884,"11",44572,44492,89064
"3787",1884,"12",41276,40741,82017
"3788",1884,"13",41220,41405,82625
"3789",1884,"14",40552,40164,80716
"3790",1884,"15",39932,39575,79507
"3791",1884,"16",39867,40152,80019
"3792",1884,"17",39735,39500,79235
"3793",1884,"18",38661,38376,77037
"3794",1884,"19",38258,37768,76026
"3795",1884,"20",37994,37941,75935
"3796",1884,"21",34571,34106,68677
"3797",1884,"22",34283,34274,68557
"3798",1884,"23",31453,31169,62622
"3799",1884,"24",33202,32277,65479
"3800",1884,"25",29392,28878,58270
"3801",1884,"26",30647,29975,60622
"3802",1884,"27",30194,29391,59585
"3803",1884,"28",27979,27566,55545
"3804",1884,"29",28851,27910,56761
"3805",1884,"30",28236,27402,55638
"3806",1884,"31",29770,28713,58483
"3807",1884,"32",27803,27140,54943
"3808",1884,"33",28457,27961,56418
"3809",1884,"34",28948,27700,56648
"3810",1884,"35",23873,23679,47552
"3811",1884,"36",22327,21409,43736
"3812",1884,"37",23042,22075,45117
"3813",1884,"38",25228,24661,49889
"3814",1884,"39",25460,25112,50572
"3815",1884,"40",24080,23809,47889
"3816",1884,"41",24495,23926,48421
"3817",1884,"42",23283,23386,46669
"3818",1884,"43",24714,23957,48671
"3819",1884,"44",24469,23601,48070
"3820",1884,"45",23200,22825,46025
"3821",1884,"46",21629,21392,43021
"3822",1884,"47",22267,21812,44079
"3823",1884,"48",21009,20392,41401
"3824",1884,"49",20578,19565,40143
"3825",1884,"50",20224,19698,39922
"3826",1884,"51",18093,17447,35540
"3827",1884,"52",17306,17014,34320
"3828",1884,"53",19468,18226,37694
"3829",1884,"54",18708,18019,36727
"3830",1884,"55",16875,16397,33272
"3831",1884,"56",16277,15528,31805
"3832",1884,"57",17275,15854,33129
"3833",1884,"58",17168,15894,33062
"3834",1884,"59",17036,16132,33168
"3835",1884,"60",16530,15168,31698
"3836",1884,"61",15605,14523,30128
"3837",1884,"62",14377,13411,27788
"3838",1884,"63",13920,12289,26209
"3839",1884,"64",13397,12054,25451
"3840",1884,"65",11717,10675,22392
"3841",1884,"66",11134,10069,21203
"3842",1884,"67",11690,9980,21670
"3843",1884,"68",10372,9045,19417
"3844",1884,"69",9612,8102,17714
"3845",1884,"70",9043,7477,16520
"3846",1884,"71",7853,6681,14534
"3847",1884,"72",7929,6281,14210
"3848",1884,"73",7092,5604,12696
"3849",1884,"74",5869,4587,10456
"3850",1884,"75",4901,4089,8990
"3851",1884,"76",4690,3874,8564
"3852",1884,"77",4317,3504,7821
"3853",1884,"78",3754,2957,6711
"3854",1884,"79",3349,2640,5989
"3855",1884,"80",2944,2231,5175
"3856",1884,"81",2534,1960,4494
"3857",1884,"82",2020,1524,3544
"3858",1884,"83",1910,1422,3332
"3859",1884,"84",1410.79,1043,2453.79
"3860",1884,"85",1036.21,858,1894.21
"3861",1884,"86",886,622,1508
"3862",1884,"87",565,451,1016
"3863",1884,"88",499,286,785
"3864",1884,"89",352,248,600
"3865",1884,"90",227,150,377
"3866",1884,"91",191,124,315
"3867",1884,"92",152,76,228
"3868",1884,"93",81,46,127
"3869",1884,"94",60,27.53,87.53
"3870",1884,"95",29,11.47,40.47
"3871",1884,"96",25,12,37
"3872",1884,"97",16,5,21
"3873",1884,"98",4,4,8
"3874",1884,"99",2,0,2
"3875",1884,"100",2,0,2
"3876",1884,"101",0,0,0
"3877",1884,"102",0,0,0
"3878",1884,"103",0,0,0
"3879",1884,"104",0,0,0
"3880",1884,"105",0,0,0
"3881",1884,"106",0,0,0
"3882",1884,"107",0,0,0
"3883",1884,"108",0,0,0
"3884",1884,"109",0,0,0
"3885",1884,"110+",0,0,0
"3886",1885,"0",63346,65273,128619
"3887",1885,"1",55792,56467,112259
"3888",1885,"2",55353,55757,111110
"3889",1885,"3",52610,52964,105574
"3890",1885,"4",51006,50980,101986
"3891",1885,"5",52373,52430,104803
"3892",1885,"6",50093,50816,100909
"3893",1885,"7",49852,50181,100033
"3894",1885,"8",49330,49562,98892
"3895",1885,"9",46991,47276,94267
"3896",1885,"10",46491,46706,93197
"3897",1885,"11",45707,45710,91417
"3898",1885,"12",44388,44267,88655
"3899",1885,"13",41020,40509,81529
"3900",1885,"14",41019,41143,82162
"3901",1885,"15",40317,39837,80154
"3902",1885,"16",39685,39234,78919
"3903",1885,"17",39542,39733,79275
"3904",1885,"18",39423,39065,78488
"3905",1885,"19",38385,37928,76313
"3906",1885,"20",37986,37270,75256
"3907",1885,"21",37710,37387,75097
"3908",1885,"22",34289,33659,67948
"3909",1885,"23",33978,33750,67728
"3910",1885,"24",31157,30812,61969
"3911",1885,"25",32876,31879,64755
"3912",1885,"26",29142,28555,57697
"3913",1885,"27",30344,29623,59967
"3914",1885,"28",29864,29019,58883
"3915",1885,"29",27682,27277,54959
"3916",1885,"30",28537,27665,56202
"3917",1885,"31",27949,27154,55103
"3918",1885,"32",29449,28482,57931
"3919",1885,"33",27519,26928,54447
"3920",1885,"34",28152,27705,55857
"3921",1885,"35",28660,27446,56106
"3922",1885,"36",23663,23462,47125
"3923",1885,"37",22087,21230,43317
"3924",1885,"38",22756,21882,44638
"3925",1885,"39",24982,24406,49388
"3926",1885,"40",25176,24858,50034
"3927",1885,"41",23812,23546,47358
"3928",1885,"42",24233,23667,47900
"3929",1885,"43",23017,23153,46170
"3930",1885,"44",24431,23665,48096
"3931",1885,"45",24176,23274,47450
"3932",1885,"46",22977,22572,45549
"3933",1885,"47",21408,21103,42511
"3934",1885,"48",22000,21523,43523
"3935",1885,"49",20744,20097,40841
"3936",1885,"50",20300,19284,39584
"3937",1885,"51",19969,19374,39343
"3938",1885,"52",17818,17186,35004
"3939",1885,"53",17038,16720,33758
"3940",1885,"54",19163,17860,37023
"3941",1885,"55",18404,17633,36037
"3942",1885,"56",16599,16082,32681
"3943",1885,"57",15997,15173,31170
"3944",1885,"58",16939,15452,32391
"3945",1885,"59",16807,15473,32280
"3946",1885,"60",16688,15681,32369
"3947",1885,"61",16173,14716,30889
"3948",1885,"62",15206,14105,29311
"3949",1885,"63",13964,12954,26918
"3950",1885,"64",13433,11796,25229
"3951",1885,"65",12948,11555,24503
"3952",1885,"66",11320,10240,21560
"3953",1885,"67",10677,9587,20264
"3954",1885,"68",11172,9495,20667
"3955",1885,"69",9849,8529,18378
"3956",1885,"70",9103,7623,16726
"3957",1885,"71",8522,7023,15545
"3958",1885,"72",7343,6226,13569
"3959",1885,"73",7389,5809,13198
"3960",1885,"74",6594,5139,11733
"3961",1885,"75",5397,4193,9590
"3962",1885,"76",4451,3681,8132
"3963",1885,"77",4225,3454,7679
"3964",1885,"78",3838,3126,6964
"3965",1885,"79",3319,2619,5938
"3966",1885,"80",3012,2313,5325
"3967",1885,"81",2536,1920,4456
"3968",1885,"82",2158,1666,3824
"3969",1885,"83",1717,1240,2957
"3970",1885,"84",1602,1161,2763
"3971",1885,"85",1145.79,853,1998.79
"3972",1885,"86",823.21,698,1521.21
"3973",1885,"87",708,485,1193
"3974",1885,"88",447,335,782
"3975",1885,"89",370,221,591
"3976",1885,"90",270,175,445
"3977",1885,"91",179,110,289
"3978",1885,"92",126,83,209
"3979",1885,"93",101,56,157
"3980",1885,"94",49,28,77
"3981",1885,"95",38,18.53,56.53
"3982",1885,"96",19,4.47,23.47
"3983",1885,"97",17,4,21
"3984",1885,"98",10,2,12
"3985",1885,"99",3,2,5
"3986",1885,"100",1,0,1
"3987",1885,"101",0,0,0
"3988",1885,"102",0,0,0
"3989",1885,"103",0,0,0
"3990",1885,"104",0,0,0
"3991",1885,"105",0,0,0
"3992",1885,"106",0,0,0
"3993",1885,"107",0,0,0
"3994",1885,"108",0,0,0
"3995",1885,"109",0,0,0
"3996",1885,"110+",0,0,0
"3997",1886,"0",64670,66687,131357
"3998",1886,"1",57702,58529,116231
"3999",1886,"2",53657,54287,107944
"4000",1886,"3",54121,54531,108652
"4001",1886,"4",51659,52001,103660
"4002",1886,"5",50346,50310,100656
"4003",1886,"6",51880,51892,103772
"4004",1886,"7",49667,50363,100030
"4005",1886,"8",49540,49835,99375
"4006",1886,"9",49077,49292,98369
"4007",1886,"10",46782,47031,93813
"4008",1886,"11",46259,46497,92756
"4009",1886,"12",45495,45490,90985
"4010",1886,"13",44179,44082,88261
"4011",1886,"14",40751,40285,81036
"4012",1886,"15",40783,40884,81667
"4013",1886,"16",40078,39522,79600
"4014",1886,"17",39409,38863,78272
"4015",1886,"18",39248,39302,78550
"4016",1886,"19",39122,38602,77724
"4017",1886,"20",38081,37409,75490
"4018",1886,"21",37730,36727,74457
"4019",1886,"22",37425,36895,74320
"4020",1886,"23",34001,33216,67217
"4021",1886,"24",33660,33268,66928
"4022",1886,"25",30890,30424,61314
"4023",1886,"26",32574,31448,64022
"4024",1886,"27",28865,28237,57102
"4025",1886,"28",30045,29307,59352
"4026",1886,"29",29531,28673,58204
"4027",1886,"30",27368,27002,54370
"4028",1886,"31",28231,27398,55629
"4029",1886,"32",27643,26917,54560
"4030",1886,"33",29118,28207,57325
"4031",1886,"34",27256,26735,53991
"4032",1886,"35",27849,27437,55286
"4033",1886,"36",28340,27184,55524
"4034",1886,"37",23400,23239,46639
"4035",1886,"38",21833,21002,42835
"4036",1886,"39",22472,21673,44145
"4037",1886,"40",24701,24158,48859
"4038",1886,"41",24855,24630,49485
"4039",1886,"42",23529,23291,46820
"4040",1886,"43",23940,23382,47322
"4041",1886,"44",22755,22935,45690
"4042",1886,"45",24142,23308,47450
"4043",1886,"46",23866,22973,46839
"4044",1886,"47",22721,22285,45006
"4045",1886,"48",21170,20809,41979
"4046",1886,"49",21727,21221,42948
"4047",1886,"50",20452,19781,40233
"4048",1886,"51",20030,18971,39001
"4049",1886,"52",19691,19046,38737
"4050",1886,"53",17558,16881,34439
"4051",1886,"54",16743,16401,33144
"4052",1886,"55",18845,17523,36368
"4053",1886,"56",18040,17237,35277
"4054",1886,"57",16289,15704,31993
"4055",1886,"58",15719,14810,30529
"4056",1886,"59",16561,15034,31595
"4057",1886,"60",16404,15080,31484
"4058",1886,"61",16307,15158,31465
"4059",1886,"62",15757,14214,29971
"4060",1886,"63",14757,13663,28420
"4061",1886,"64",13522,12484,26006
"4062",1886,"65",12898,11286,24184
"4063",1886,"66",12443,11050,23493
"4064",1886,"67",10874,9721,20595
"4065",1886,"68",10180,9115,19295
"4066",1886,"69",10624,8969,19593
"4067",1886,"70",9315,8014,17329
"4068",1886,"71",8525,7095,15620
"4069",1886,"72",8004,6561,14565
"4070",1886,"73",6832,5749,12581
"4071",1886,"74",6787,5323,12110
"4072",1886,"75",6017,4645,10662
"4073",1886,"76",4885,3737,8622
"4074",1886,"77",4046,3292,7338
"4075",1886,"78",3750,3054,6804
"4076",1886,"79",3375,2715,6090
"4077",1886,"80",2901,2258,5159
"4078",1886,"81",2612,1933,4545
"4079",1886,"82",2138,1594,3732
"4080",1886,"83",1783,1410,3193
"4081",1886,"84",1401,1024,2425
"4082",1886,"85",1312,949,2261
"4083",1886,"86",906.79,675,1581.79
"4084",1886,"87",634.21,534,1168.21
"4085",1886,"88",551,380,931
"4086",1886,"89",319,253,572
"4087",1886,"90",275,161,436
"4088",1886,"91",188,116,304
"4089",1886,"92",118,70,188
"4090",1886,"93",90,55,145
"4091",1886,"94",59,35,94
"4092",1886,"95",35,20,55
"4093",1886,"96",21,6.53,27.53
"4094",1886,"97",12,2.47,14.47
"4095",1886,"98",7,3,10
"4096",1886,"99",5,0,5
"4097",1886,"100",0,1,1
"4098",1886,"101",1,0,1
"4099",1886,"102",0,0,0
"4100",1886,"103",0,0,0
"4101",1886,"104",0,0,0
"4102",1886,"105",0,0,0
"4103",1886,"106",0,0,0
"4104",1886,"107",0,0,0
"4105",1886,"108",0,0,0
"4106",1886,"109",0,0,0
"4107",1886,"110+",0,0,0
"4108",1887,"0",64637,66049,130686
"4109",1887,"1",58485,59463,117948
"4110",1887,"2",55340,55967,111307
"4111",1887,"3",52490,52969,105459
"4112",1887,"4",53185,53554,106739
"4113",1887,"5",50970,51249,102219
"4114",1887,"6",49822,49748,99570
"4115",1887,"7",51466,51453,102919
"4116",1887,"8",49314,50013,99327
"4117",1887,"9",49293,49551,98844
"4118",1887,"10",48817,49064,97881
"4119",1887,"11",46566,46813,93379
"4120",1887,"12",46020,46296,92316
"4121",1887,"13",45292,45264,90556
"4122",1887,"14",43989,43879,87868
"4123",1887,"15",40489,40046,80535
"4124",1887,"16",40565,40611,81176
"4125",1887,"17",39864,39174,79038
"4126",1887,"18",39129,38462,77591
"4127",1887,"19",38927,38829,77756
"4128",1887,"20",38817,38132,76949
"4129",1887,"21",37810,36879,74689
"4130",1887,"22",37461,36207,73668
"4131",1887,"23",37124,36399,73523
"4132",1887,"24",33699,32764,66463
"4133",1887,"25",33308,32797,66105
"4134",1887,"26",30606,30049,60655
"4135",1887,"27",32231,31029,63260
"4136",1887,"28",28612,27920,56532
"4137",1887,"29",29791,28989,58780
"4138",1887,"30",29199,28330,57529
"4139",1887,"31",27071,26715,53786
"4140",1887,"32",27928,27115,55043
"4141",1887,"33",27355,26678,54033
"4142",1887,"34",28809,27943,56752
"4143",1887,"35",26969,26515,53484
"4144",1887,"36",27521,27144,54665
"4145",1887,"37",28010,26924,54934
"4146",1887,"38",23154,23017,46171
"4147",1887,"39",21560,20801,42361
"4148",1887,"40",22193,21451,43644
"4149",1887,"41",24433,23905,48338
"4150",1887,"42",24591,24378,48969
"4151",1887,"43",23237,23048,46285
"4152",1887,"44",23693,23130,46823
"4153",1887,"45",22511,22654,45165
"4154",1887,"46",23867,22987,46854
"4155",1887,"47",23558,22650,46208
"4156",1887,"48",22511,21972,44483
"4157",1887,"49",20936,20538,41474
"4158",1887,"50",21457,20858,42315
"4159",1887,"51",20193,19422,39615
"4160",1887,"52",19778,18669,38447
"4161",1887,"53",19397,18707,38104
"4162",1887,"54",17282,16545,33827
"4163",1887,"55",16483,16071,32554
"4164",1887,"56",18535,17163,35698
"4165",1887,"57",17701,16803,34504
"4166",1887,"58",15970,15302,31272
"4167",1887,"59",15422,14429,29851
"4168",1887,"60",16165,14610,30775
"4169",1887,"61",16019,14647,30666
"4170",1887,"62",15936,14651,30587
"4171",1887,"63",15318,13705,29023
"4172",1887,"64",14286,13159,27445
"4173",1887,"65",13093,11954,25047
"4174",1887,"66",12398,10799,23197
"4175",1887,"67",11909,10521,22430
"4176",1887,"68",10400,9223,19623
"4177",1887,"69",9733,8623,18356
"4178",1887,"70",10071,8432,18503
"4179",1887,"71",8791,7476,16267
"4180",1887,"72",8017,6599,14616
"4181",1887,"73",7489,6052,13541
"4182",1887,"74",6318,5250,11568
"4183",1887,"75",6216,4809,11025
"4184",1887,"76",5483,4198,9681
"4185",1887,"77",4374,3347,7721
"4186",1887,"78",3612,2897,6509
"4187",1887,"79",3300,2678,5978
"4188",1887,"80",3003,2337,5340
"4189",1887,"81",2505,1933,4438
"4190",1887,"82",2205,1630,3835
"4191",1887,"83",1787,1336,3123
"4192",1887,"84",1483,1146,2629
"4193",1887,"85",1160,821,1981
"4194",1887,"86",1059,747,1806
"4195",1887,"87",711.79,539,1250.79
"4196",1887,"88",486.21,394,880.21
"4197",1887,"89",419,278,697
"4198",1887,"90",237,190,427
"4199",1887,"91",196,115,311
"4200",1887,"92",143,75,218
"4201",1887,"93",86,44,130
"4202",1887,"94",58,32,90
"4203",1887,"95",40,23,63
"4204",1887,"96",20,13,33
"4205",1887,"97",9,3.53,12.53
"4206",1887,"98",6,0.47,6.47
"4207",1887,"99",5,2,7
"4208",1887,"100",1,0,1
"4209",1887,"101",0,1,1
"4210",1887,"102",1,0,1
"4211",1887,"103",0,0,0
"4212",1887,"104",0,0,0
"4213",1887,"105",0,0,0
"4214",1887,"106",0,0,0
"4215",1887,"107",0,0,0
"4216",1887,"108",0,0,0
"4217",1887,"109",0,0,0
"4218",1887,"110+",0,0,0
"4219",1888,"0",65719,67510,133229
"4220",1888,"1",59307,59802,119109
"4221",1888,"2",56480,57251,113731
"4222",1888,"3",54289,54812,109101
"4223",1888,"4",51780,52169,103949
"4224",1888,"5",52576,52948,105524
"4225",1888,"6",50480,50718,101198
"4226",1888,"7",49456,49371,98827
"4227",1888,"8",51139,51121,102260
"4228",1888,"9",49026,49736,98762
"4229",1888,"10",49073,49311,98384
"4230",1888,"11",48601,48857,97458
"4231",1888,"12",46404,46626,93030
"4232",1888,"13",45801,46107,91908
"4233",1888,"14",45102,45072,90174
"4234",1888,"15",43782,43691,87473
"4235",1888,"16",40222,39805,80027
"4236",1888,"17",40341,40287,80628
"4237",1888,"18",39630,38798,78428
"4238",1888,"19",38918,38030,76948
"4239",1888,"20",38633,38338,76971
"4240",1888,"21",38517,37630,76147
"4241",1888,"22",37539,36388,73927
"4242",1888,"23",37205,35696,72901
"4243",1888,"24",36834,35928,72762
"4244",1888,"25",33393,32339,65732
"4245",1888,"26",32988,32334,65322
"4246",1888,"27",30317,29676,59993
"4247",1888,"28",31871,30640,62511
"4248",1888,"29",28357,27649,56006
"4249",1888,"30",29518,28673,58191
"4250",1888,"31",28877,28025,56902
"4251",1888,"32",26802,26438,53240
"4252",1888,"33",27659,26861,54520
"4253",1888,"34",27080,26436,53516
"4254",1888,"35",28520,27686,56206
"4255",1888,"36",26683,26291,52974
"4256",1888,"37",27234,26879,54113
"4257",1888,"38",27714,26665,54379
"4258",1888,"39",22892,22786,45678
"4259",1888,"40",21335,20582,41917
"4260",1888,"41",21938,21260,43198
"4261",1888,"42",24166,23681,47847
"4262",1888,"43",24348,24106,48454
"4263",1888,"44",22969,22811,45780
"4264",1888,"45",23455,22884,46339
"4265",1888,"46",22276,22377,44653
"4266",1888,"47",23610,22646,46256
"4267",1888,"48",23265,22328,45593
"4268",1888,"49",22282,21656,43938
"4269",1888,"50",20694,20227,40921
"4270",1888,"51",21178,20583,41761
"4271",1888,"52",19916,19121,39037
"4272",1888,"53",19502,18353,37855
"4273",1888,"54",19093,18331,37424
"4274",1888,"55",17006,16199,33205
"4275",1888,"56",16224,15750,31974
"4276",1888,"57",18164,16775,34939
"4277",1888,"58",17339,16370,33709
"4278",1888,"59",15691,14892,30583
"4279",1888,"60",15111,14053,29164
"4280",1888,"61",15756,14206,29962
"4281",1888,"62",15619,14165,29784
"4282",1888,"63",15496,14095,29591
"4283",1888,"64",14859,13170,28029
"4284",1888,"65",13815,12675,26490
"4285",1888,"66",12608,11445,24053
"4286",1888,"67",11900,10335,22235
"4287",1888,"68",11351,9979,21330
"4288",1888,"69",9927,8733,18660
"4289",1888,"70",9206,8090,17296
"4290",1888,"71",9520,7918,17438
"4291",1888,"72",8195,6944,15139
"4292",1888,"73",7481,6112,13593
"4293",1888,"74",6962,5534,12496
"4294",1888,"75",5760,4766,10526
"4295",1888,"76",5639,4360,9999
"4296",1888,"77",4932,3759,8691
"4297",1888,"78",3920,2953,6873
"4298",1888,"79",3201,2558,5759
"4299",1888,"80",2961,2290,5251
"4300",1888,"81",2614,2003,4617
"4301",1888,"82",2115,1610,3725
"4302",1888,"83",1806,1357,3163
"4303",1888,"84",1472,1099,2571
"4304",1888,"85",1187,922,2109
"4305",1888,"86",943,647,1590
"4306",1888,"87",811,590,1401
"4307",1888,"88",559.79,415,974.79
"4308",1888,"89",371.21,296,667.21
"4309",1888,"90",310,185,495
"4310",1888,"91",165,144,309
"4311",1888,"92",138,81,219
"4312",1888,"93",105,53,158
"4313",1888,"94",51,30,81
"4314",1888,"95",41,17,58
"4315",1888,"96",24,15,39
"4316",1888,"97",13,8,21
"4317",1888,"98",7,2.53,9.53
"4318",1888,"99",4,0.47,4.47
"4319",1888,"100",3,0,3
"4320",1888,"101",1,0,1
"4321",1888,"102",0,1,1
"4322",1888,"103",1,0,1
"4323",1888,"104",0,0,0
"4324",1888,"105",0,0,0
"4325",1888,"106",0,0,0
"4326",1888,"107",0,0,0
"4327",1888,"108",0,0,0
"4328",1888,"109",0,0,0
"4329",1888,"110+",0,0,0
"4330",1889,"0",65767,67595,133362
"4331",1889,"1",59801,60807,120608
"4332",1889,"2",57196,57660,114856
"4333",1889,"3",55422,56127,111549
"4334",1889,"4",53548,54006,107554
"4335",1889,"5",51234,51609,102843
"4336",1889,"6",52141,52483,104624
"4337",1889,"7",50097,50315,100412
"4338",1889,"8",49164,49081,98245
"4339",1889,"9",50849,50852,101701
"4340",1889,"10",48776,49472,98248
"4341",1889,"11",48847,49103,97950
"4342",1889,"12",48390,48688,97078
"4343",1889,"13",46239,46446,92685
"4344",1889,"14",45572,45937,91509
"4345",1889,"15",44871,44857,89728
"4346",1889,"16",43571,43450,87021
"4347",1889,"17",39969,39530,79499
"4348",1889,"18",40112,39967,80079
"4349",1889,"19",39375,38395,77770
"4350",1889,"20",38680,37572,76252
"4351",1889,"21",38332,37825,76157
"4352",1889,"22",38208,37141,75349
"4353",1889,"23",37217,35930,73147
"4354",1889,"24",36956,35184,72140
"4355",1889,"25",36534,35472,72006
"4356",1889,"26",33101,31937,65038
"4357",1889,"27",32668,31888,64556
"4358",1889,"28",30028,29316,59344
"4359",1889,"29",31576,30240,61816
"4360",1889,"30",28082,27342,55424
"4361",1889,"31",29246,28363,57609
"4362",1889,"32",28551,27709,56260
"4363",1889,"33",26510,26155,52665
"4364",1889,"34",27356,26592,53948
"4365",1889,"35",26804,26193,52997
"4366",1889,"36",28228,27419,55647
"4367",1889,"37",26423,26072,52495
"4368",1889,"38",26900,26615,53515
"4369",1889,"39",27390,26408,53798
"4370",1889,"40",22634,22575,45209
"4371",1889,"41",21115,20365,41480
"4372",1889,"42",21678,21029,42707
"4373",1889,"43",23949,23437,47386
"4374",1889,"44",24115,23855,47970
"4375",1889,"45",22745,22520,45265
"4376",1889,"46",23238,22610,45848
"4377",1889,"47",22031,22101,44132
"4378",1889,"48",23353,22310,45663
"4379",1889,"49",22992,21990,44982
"4380",1889,"50",22032,21336,43368
"4381",1889,"51",20447,19898,40345
"4382",1889,"52",20864,20252,41116
"4383",1889,"53",19604,18757,38361
"4384",1889,"54",19191,18008,37199
"4385",1889,"55",18808,17976,36784
"4386",1889,"56",16721,15841,32562
"4387",1889,"57",15932,15370,31302
"4388",1889,"58",17791,16340,34131
"4389",1889,"59",16959,15888,32847
"4390",1889,"60",15326,14499,29825
"4391",1889,"61",14747,13624,28371
"4392",1889,"62",15348,13753,29101
"4393",1889,"63",15184,13676,28860
"4394",1889,"64",15007,13570,28577
"4395",1889,"65",14374,12612,26986
"4396",1889,"66",13279,12122,25401
"4397",1889,"67",12088,10911,22999
"4398",1889,"68",11397,9777,21174
"4399",1889,"69",10769,9429,20198
"4400",1889,"70",9399,8173,17572
"4401",1889,"71",8711,7547,16258
"4402",1889,"72",8887,7336,16223
"4403",1889,"73",7611,6365,13976
"4404",1889,"74",6920,5562,12482
"4405",1889,"75",6392,5043,11435
"4406",1889,"76",5239,4265,9504
"4407",1889,"77",5069,3846,8915
"4408",1889,"78",4407,3280,7687
"4409",1889,"79",3473,2606,6079
"4410",1889,"80",2848,2186,5034
"4411",1889,"81",2556,1957,4513
"4412",1889,"82",2232,1671,3903
"4413",1889,"83",1753,1304,3057
"4414",1889,"84",1490,1094,2584
"4415",1889,"85",1191,875,2066
"4416",1889,"86",918,706,1624
"4417",1889,"87",719,477,1196
"4418",1889,"88",628,433,1061
"4419",1889,"89",410.79,297,707.79
"4420",1889,"90",259.21,207,466.21
"4421",1889,"91",213,133,346
"4422",1889,"92",116,107,223
"4423",1889,"93",85,58,143
"4424",1889,"94",70,33,103
"4425",1889,"95",33,21,54
"4426",1889,"96",26,10,36
"4427",1889,"97",15,7,22
"4428",1889,"98",7,4,11
"4429",1889,"99",3,2.53,5.53
"4430",1889,"100",1,0.47,1.47
"4431",1889,"101",0,0,0
"4432",1889,"102",0,0,0
"4433",1889,"103",0,0,0
"4434",1889,"104",1,0,1
"4435",1889,"105",0,0,0
"4436",1889,"106",0,0,0
"4437",1889,"107",0,0,0
"4438",1889,"108",0,0,0
"4439",1889,"109",0,0,0
"4440",1889,"110+",0,0,0
"4441",1890,"0",65506,67464,132970
"4442",1890,"1",59771,60869,120640
"4443",1890,"2",57599,58616,116215
"4444",1890,"3",56125,56610,112735
"4445",1890,"4",54743,55375,110118
"4446",1890,"5",53050,53479,106529
"4447",1890,"6",50855,51182,102037
"4448",1890,"7",51777,52115,103892
"4449",1890,"8",49777,49999,99776
"4450",1890,"9",48898,48789,97687
"4451",1890,"10",50555,50523,101078
"4452",1890,"11",48530,49148,97678
"4453",1890,"12",48588,48785,97373
"4454",1890,"13",48140,48394,96534
"4455",1890,"14",45984,46103,92087
"4456",1890,"15",45311,45611,90922
"4457",1890,"16",44563,44476,89039
"4458",1890,"17",43315,43084,86399
"4459",1890,"18",39629,39172,78801
"4460",1890,"19",39852,39544,79396
"4461",1890,"20",39097,37961,77058
"4462",1890,"21",38386,37152,75538
"4463",1890,"22",38051,37363,75414
"4464",1890,"23",37890,36696,74586
"4465",1890,"24",36909,35500,72409
"4466",1890,"25",36636,34776,71412
"4467",1890,"26",36262,35089,71351
"4468",1890,"27",32794,31600,64394
"4469",1890,"28",32368,31567,63935
"4470",1890,"29",29794,29014,58808
"4471",1890,"30",31283,29958,61241
"4472",1890,"31",27849,27113,54962
"4473",1890,"32",28972,28082,57054
"4474",1890,"33",28245,27432,55677
"4475",1890,"34",26203,25911,52114
"4476",1890,"35",27088,26312,53400
"4477",1890,"36",26511,25957,52468
"4478",1890,"37",27948,27129,55077
"4479",1890,"38",26156,25865,52021
"4480",1890,"39",26598,26328,52926
"4481",1890,"40",27101,26152,53253
"4482",1890,"41",22410,22375,44785
"4483",1890,"42",20890,20165,41055
"4484",1890,"43",21443,20796,42239
"4485",1890,"44",23701,23185,46886
"4486",1890,"45",23883,23575,47458
"4487",1890,"46",22493,22211,44704
"4488",1890,"47",22970,22299,45269
"4489",1890,"48",21766,21832,43598
"4490",1890,"49",23049,21994,45043
"4491",1890,"50",22681,21646,44327
"4492",1890,"51",21762,21029,42791
"4493",1890,"52",20199,19589,39788
"4494",1890,"53",20557,19928,40485
"4495",1890,"54",19300,18433,37733
"4496",1890,"55",18892,17656,36548
"4497",1890,"56",18496,17576,36072
"4498",1890,"57",16380,15488,31868
"4499",1890,"58",15620,15031,30651
"4500",1890,"59",17402,15903,33305
"4501",1890,"60",16592,15457,32049
"4502",1890,"61",14982,14097,29079
"4503",1890,"62",14344,13162,27506
"4504",1890,"63",14935,13308,28243
"4505",1890,"64",14726,13173,27899
"4506",1890,"65",14529,13047,27576
"4507",1890,"66",13836,12057,25893
"4508",1890,"67",12680,11561,24241
"4509",1890,"68",11553,10350,21903
"4510",1890,"69",10823,9239,20062
"4511",1890,"70",10201,8869,19070
"4512",1890,"71",8885,7700,16585
"4513",1890,"72",8152,7006,15158
"4514",1890,"73",8274,6772,15046
"4515",1890,"74",7058,5876,12934
"4516",1890,"75",6399,5036,11435
"4517",1890,"76",5828,4545,10373
"4518",1890,"77",4723,3808,8531
"4519",1890,"78",4563,3390,7953
"4520",1890,"79",3934,2812,6746
"4521",1890,"80",3046,2250,5296
"4522",1890,"81",2454,1857,4311
"4523",1890,"82",2190,1630,3820
"4524",1890,"83",1871,1388,3259
"4525",1890,"84",1415,1050,2465
"4526",1890,"85",1214,886,2100
"4527",1890,"86",961,691,1652
"4528",1890,"87",708,550,1258
"4529",1890,"88",548,379,927
"4530",1890,"89",444,312,756
"4531",1890,"90",312.79,216,528.79
"4532",1890,"91",195.21,151,346.21
"4533",1890,"92",161,100,261
"4534",1890,"93",76,75,151
"4535",1890,"94",63,37,100
"4536",1890,"95",48,18,66
"4537",1890,"96",21,18,39
"4538",1890,"97",14,6,20
"4539",1890,"98",6,2,8
"4540",1890,"99",3,3,6
"4541",1890,"100",2,0.53,2.53
"4542",1890,"101",0,0.47,0.47
"4543",1890,"102",0,0,0
"4544",1890,"103",0,0,0
"4545",1890,"104",0,0,0
"4546",1890,"105",0,0,0
"4547",1890,"106",0,0,0
"4548",1890,"107",0,0,0
"4549",1890,"108",0,0,0
"4550",1890,"109",0,0,0
"4551",1890,"110+",0,0,0
"4552",1891,"0",65170,66901,132071
"4553",1891,"1",59657,60681,120338
"4554",1891,"2",57692,58853,116545
"4555",1891,"3",56627,57597,114224
"4556",1891,"4",55469,55944,111413
"4557",1891,"5",54255,54905,109160
"4558",1891,"6",52691,53153,105844
"4559",1891,"7",50568,50882,101450
"4560",1891,"8",51495,51798,103293
"4561",1891,"9",49482,49720,99202
"4562",1891,"10",48673,48486,97159
"4563",1891,"11",50281,50151,100432
"4564",1891,"12",48279,48758,97037
"4565",1891,"13",48305,48377,96682
"4566",1891,"14",47869,47954,95823
"4567",1891,"15",45653,45622,91275
"4568",1891,"16",45022,45121,90143
"4569",1891,"17",44227,43950,88177
"4570",1891,"18",43025,42572,85597
"4571",1891,"19",39333,38684,78017
"4572",1891,"20",39530,39045,78575
"4573",1891,"21",38795,37481,76276
"4574",1891,"22",38120,36720,74840
"4575",1891,"23",37744,36955,74699
"4576",1891,"24",37573,36327,73900
"4577",1891,"25",36607,35113,71720
"4578",1891,"26",36311,34457,70768
"4579",1891,"27",36001,34795,70796
"4580",1891,"28",32461,31323,63784
"4581",1891,"29",32115,31314,63429
"4582",1891,"30",29556,28784,58340
"4583",1891,"31",30941,29721,60662
"4584",1891,"32",27623,26927,54550
"4585",1891,"33",28698,27844,56542
"4586",1891,"34",27944,27205,55149
"4587",1891,"35",25954,25696,51650
"4588",1891,"36",26797,26042,52839
"4589",1891,"37",26256,25744,52000
"4590",1891,"38",27662,26899,54561
"4591",1891,"39",25832,25608,51440
"4592",1891,"40",26295,26064,52359
"4593",1891,"41",26813,25873,52686
"4594",1891,"42",22204,22147,44351
"4595",1891,"43",20647,19906,40553
"4596",1891,"44",21225,20540,41765
"4597",1891,"45",23404,22870,46274
"4598",1891,"46",23597,23294,46891
"4599",1891,"47",22239,21920,44159
"4600",1891,"48",22720,22000,44720
"4601",1891,"49",21460,21499,42959
"4602",1891,"50",22716,21636,44352
"4603",1891,"51",22339,21266,43605
"4604",1891,"52",21463,20636,42099
"4605",1891,"53",19858,19195,39053
"4606",1891,"54",20216,19519,39735
"4607",1891,"55",18965,18061,37026
"4608",1891,"56",18568,17280,35848
"4609",1891,"57",18173,17146,35319
"4610",1891,"58",16028,15098,31126
"4611",1891,"59",15290,14628,29918
"4612",1891,"60",17002,15406,32408
"4613",1891,"61",16150,14964,31114
"4614",1891,"62",14589,13644,28233
"4615",1891,"63",13905,12688,26593
"4616",1891,"64",14418,12776,27194
"4617",1891,"65",14137,12612,26749
"4618",1891,"66",13956,12477,26433
"4619",1891,"67",13224,11448,24672
"4620",1891,"68",12086,10945,23031
"4621",1891,"69",10961,9793,20754
"4622",1891,"70",10228,8679,18907
"4623",1891,"71",9534,8219,17753
"4624",1891,"72",8271,7133,15404
"4625",1891,"73",7571,6462,14033
"4626",1891,"74",7630,6163,13793
"4627",1891,"75",6433,5318,11751
"4628",1891,"76",5789,4532,10321
"4629",1891,"77",5223,4034,9257
"4630",1891,"78",4168,3321,7489
"4631",1891,"79",4009,2907,6916
"4632",1891,"80",3434,2439,5873
"4633",1891,"81",2569,1884,4453
"4634",1891,"82",2027,1511,3538
"4635",1891,"83",1774,1311,3085
"4636",1891,"84",1513,1117,2630
"4637",1891,"85",1134,836,1970
"4638",1891,"86",953,674,1627
"4639",1891,"87",727,519,1246
"4640",1891,"88",535,397,932
"4641",1891,"89",399,258,657
"4642",1891,"90",306,214,520
"4643",1891,"91",215.79,156,371.79
"4644",1891,"92",132.21,103,235.21
"4645",1891,"93",105,54,159
"4646",1891,"94",49,51,100
"4647",1891,"95",47,24,71
"4648",1891,"96",30,8,38
"4649",1891,"97",11,10,21
"4650",1891,"98",8,3,11
"4651",1891,"99",3,1,4
"4652",1891,"100",0,1,1
"4653",1891,"101",0,0.53,0.53
"4654",1891,"102",0,0.47,0.47
"4655",1891,"103",0,0,0
"4656",1891,"104",0,0,0
"4657",1891,"105",0,0,0
"4658",1891,"106",0,0,0
"4659",1891,"107",0,0,0
"4660",1891,"108",0,0,0
"4661",1891,"109",0,0,0
"4662",1891,"110+",0,0,0
"4663",1892,"0",67456,69255,136711
"4664",1892,"1",59362,60044,119406
"4665",1892,"2",57466,58471,115937
"4666",1892,"3",56676,57814,114490
"4667",1892,"4",55885,56857,112742
"4668",1892,"5",55022,55418,110440
"4669",1892,"6",53865,54446,108311
"4670",1892,"7",52360,52819,105179
"4671",1892,"8",50299,50633,100932
"4672",1892,"9",51244,51495,102739
"4673",1892,"10",49193,49489,98682
"4674",1892,"11",48484,48222,96706
"4675",1892,"12",50014,49772,99786
"4676",1892,"13",48004,48374,96378
"4677",1892,"14",47967,47976,95943
"4678",1892,"15",47586,47485,95071
"4679",1892,"16",45304,45111,90415
"4680",1892,"17",44731,44603,89334
"4681",1892,"18",43894,43382,87276
"4682",1892,"19",42714,42023,84737
"4683",1892,"20",39013,38164,77177
"4684",1892,"21",39243,38506,77749
"4685",1892,"22",38514,36998,75512
"4686",1892,"23",37849,36313,74162
"4687",1892,"24",37444,36548,73992
"4688",1892,"25",37243,35952,73195
"4689",1892,"26",36299,34748,71047
"4690",1892,"27",35968,34164,70132
"4691",1892,"28",35744,34488,70232
"4692",1892,"29",32173,31075,63248
"4693",1892,"30",31879,31059,62938
"4694",1892,"31",29324,28563,57887
"4695",1892,"32",30622,29476,60098
"4696",1892,"33",27362,26747,54109
"4697",1892,"34",28387,27608,55995
"4698",1892,"35",27670,26992,54662
"4699",1892,"36",25684,25480,51164
"4700",1892,"37",26524,25813,52337
"4701",1892,"38",25964,25509,51473
"4702",1892,"39",27347,26664,54011
"4703",1892,"40",25542,25355,50897
"4704",1892,"41",26053,25814,51867
"4705",1892,"42",26552,25605,52157
"4706",1892,"43",21980,21904,43884
"4707",1892,"44",20430,19697,40127
"4708",1892,"45",21001,20311,41312
"4709",1892,"46",23128,22586,45714
"4710",1892,"47",23311,22972,46283
"4711",1892,"48",21973,21622,43595
"4712",1892,"49",22446,21685,44131
"4713",1892,"50",21160,21143,42303
"4714",1892,"51",22432,21272,43704
"4715",1892,"52",21978,20861,42839
"4716",1892,"53",21106,20230,41336
"4717",1892,"54",19533,18820,38353
"4718",1892,"55",19866,19143,39009
"4719",1892,"56",18633,17710,36343
"4720",1892,"57",18253,16915,35168
"4721",1892,"58",17825,16701,34526
"4722",1892,"59",15687,14675,30362
"4723",1892,"60",14918,14234,29152
"4724",1892,"61",16580,14905,31485
"4725",1892,"62",15681,14426,30107
"4726",1892,"63",14145,13141,27286
"4727",1892,"64",13431,12152,25583
"4728",1892,"65",13881,12204,26085
"4729",1892,"66",13510,12034,25544
"4730",1892,"67",13359,11872,25231
"4731",1892,"68",12598,10842,23440
"4732",1892,"69",11457,10344,21801
"4733",1892,"70",10346,9188,19534
"4734",1892,"71",9613,8093,17706
"4735",1892,"72",8858,7580,16438
"4736",1892,"73",7613,6553,14166
"4737",1892,"74",6889,5866,12755
"4738",1892,"75",6885,5562,12447
"4739",1892,"76",5810,4737,10547
"4740",1892,"77",5174,3975,9149
"4741",1892,"78",4590,3502,8092
"4742",1892,"79",3655,2829,6484
"4743",1892,"80",3407,2424,5831
"4744",1892,"81",2902,2029,4931
"4745",1892,"82",2174,1572,3746
"4746",1892,"83",1650,1246,2896
"4747",1892,"84",1437,1060,2497
"4748",1892,"85",1207,886,2093
"4749",1892,"86",904,622,1526
"4750",1892,"87",720,515,1235
"4751",1892,"88",551,389,940
"4752",1892,"89",387,284,671
"4753",1892,"90",279,171,450
"4754",1892,"91",211,143,354
"4755",1892,"92",146.79,109,255.79
"4756",1892,"93",81.21,61,142.21
"4757",1892,"94",60,36,96
"4758",1892,"95",26,32,58
"4759",1892,"96",22,10,32
"4760",1892,"97",20,4,24
"4761",1892,"98",5,5,10
"4762",1892,"99",6,2,8
"4763",1892,"100",1,1,2
"4764",1892,"101",0,0,0
"4765",1892,"102",0,0.53,0.53
"4766",1892,"103",0,0.47,0.47
"4767",1892,"104",0,0,0
"4768",1892,"105",0,0,0
"4769",1892,"106",0,0,0
"4770",1892,"107",0,0,0
"4771",1892,"108",0,0,0
"4772",1892,"109",0,0,0
"4773",1892,"110+",0,0,0
"4774",1893,"0",64925,66674,131599
"4775",1893,"1",61448,62342,123790
"4776",1893,"2",57104,57739,114843
"4777",1893,"3",56420,57373,113793
"4778",1893,"4",56011,57098,113109
"4779",1893,"5",55351,56304,111655
"4780",1893,"6",54656,54982,109638
"4781",1893,"7",53534,54125,107659
"4782",1893,"8",52110,52578,104688
"4783",1893,"9",50058,50394,100452
"4784",1893,"10",50989,51226,102215
"4785",1893,"11",48921,49281,98202
"4786",1893,"12",48289,47947,96236
"4787",1893,"13",49746,49403,99149
"4788",1893,"14",47723,47988,95711
"4789",1893,"15",47651,47573,95224
"4790",1893,"16",47232,47008,94240
"4791",1893,"17",44966,44559,89525
"4792",1893,"18",44422,44052,88474
"4793",1893,"19",43567,42802,86369
"4794",1893,"20",42427,41448,83875
"4795",1893,"21",38681,37620,76301
"4796",1893,"22",38944,37988,76932
"4797",1893,"23",38233,36532,74765
"4798",1893,"24",37559,35869,73428
"4799",1893,"25",37139,36132,73271
"4800",1893,"26",36909,35611,72520
"4801",1893,"27",35996,34394,70390
"4802",1893,"28",35630,33881,69511
"4803",1893,"29",35481,34227,69708
"4804",1893,"30",31845,30848,62693
"4805",1893,"31",31614,30791,62405
"4806",1893,"32",29059,28378,57437
"4807",1893,"33",30288,29236,59524
"4808",1893,"34",27117,26533,53650
"4809",1893,"35",28074,27353,55427
"4810",1893,"36",27363,26770,54133
"4811",1893,"37",25418,25261,50679
"4812",1893,"38",26239,25562,51801
"4813",1893,"39",25662,25233,50895
"4814",1893,"40",27047,26409,53456
"4815",1893,"41",25242,25103,50345
"4816",1893,"42",25785,25525,51310
"4817",1893,"43",26266,25330,51596
"4818",1893,"44",21775,21636,43411
"4819",1893,"45",20192,19491,39683
"4820",1893,"46",20764,20039,40803
"4821",1893,"47",22837,22244,45081
"4822",1893,"48",23029,22652,45681
"4823",1893,"49",21717,21288,43005
"4824",1893,"50",22157,21331,43488
"4825",1893,"51",20860,20742,41602
"4826",1893,"52",22098,20924,43022
"4827",1893,"53",21627,20434,42061
"4828",1893,"54",20746,19758,40504
"4829",1893,"55",19159,18409,37568
"4830",1893,"56",19481,18664,38145
"4831",1893,"57",18235,17302,35537
"4832",1893,"58",17835,16460,34295
"4833",1893,"59",17414,16239,33653
"4834",1893,"60",15277,14203,29480
"4835",1893,"61",14526,13774,28300
"4836",1893,"62",16071,14385,30456
"4837",1893,"63",15143,13861,29004
"4838",1893,"64",13642,12610,26252
"4839",1893,"65",12884,11611,24495
"4840",1893,"66",13273,11606,24879
"4841",1893,"67",12875,11390,24265
"4842",1893,"68",12669,11220,23889
"4843",1893,"69",11862,10175,22037
"4844",1893,"70",10781,9645,20426
"4845",1893,"71",9606,8498,18104
"4846",1893,"72",8878,7449,16327
"4847",1893,"73",8119,6920,15039
"4848",1893,"74",6949,5959,12908
"4849",1893,"75",6262,5240,11502
"4850",1893,"76",6143,4979,11122
"4851",1893,"77",5119,4145,9264
"4852",1893,"78",4513,3462,7975
"4853",1893,"79",3990,2999,6989
"4854",1893,"80",3222,2407,5629
"4855",1893,"81",2847,2000,4847
"4856",1893,"82",2376,1654,4030
"4857",1893,"83",1744,1246,2990
"4858",1893,"84",1301,965,2266
"4859",1893,"85",1131,828,1959
"4860",1893,"86",921,672,1593
"4861",1893,"87",681,461,1142
"4862",1893,"88",528,383,911
"4863",1893,"89",395,266,661
"4864",1893,"90",278,192,470
"4865",1893,"91",184,114,298
"4866",1893,"92",137,93,230
"4867",1893,"93",88.79,70,158.79
"4868",1893,"94",54.21,37,91.21
"4869",1893,"95",35,22,57
"4870",1893,"96",17,20,37
"4871",1893,"97",12,4,16
"4872",1893,"98",10,3,13
"4873",1893,"99",3,3,6
"4874",1893,"100",5,1,6
"4875",1893,"101",0,0,0
"4876",1893,"102",0,0,0
"4877",1893,"103",0,0.53,0.53
"4878",1893,"104",0,0.47,0.47
"4879",1893,"105",0,0,0
"4880",1893,"106",0,0,0
"4881",1893,"107",0,0,0
"4882",1893,"108",0,0,0
"4883",1893,"109",0,0,0
"4884",1893,"110+",0,0,0
"4885",1894,"0",69373,71261,140634
"4886",1894,"1",59717,60614,120331
"4887",1894,"2",59611,60411,120022
"4888",1894,"3",56161,56781,112942
"4889",1894,"4",55761,56681,112442
"4890",1894,"5",55559,56590,112149
"4891",1894,"6",54921,55908,110829
"4892",1894,"7",54333,54650,108983
"4893",1894,"8",53263,53885,107148
"4894",1894,"9",51870,52365,104235
"4895",1894,"10",49833,50163,99996
"4896",1894,"11",50762,50990,101752
"4897",1894,"12",48647,49057,97704
"4898",1894,"13",48081,47695,95776
"4899",1894,"14",49462,49032,98494
"4900",1894,"15",47472,47615,95087
"4901",1894,"16",47335,47124,94459
"4902",1894,"17",46907,46493,93400
"4903",1894,"18",44606,44013,88619
"4904",1894,"19",44113,43470,87583
"4905",1894,"20",43242,42175,85417
"4906",1894,"21",42116,40885,83001
"4907",1894,"22",38355,37074,75429
"4908",1894,"23",38630,37525,76155
"4909",1894,"24",37944,36127,74071
"4910",1894,"25",37250,35443,72693
"4911",1894,"26",36827,35765,72592
"4912",1894,"27",36579,35276,71855
"4913",1894,"28",35701,34043,69744
"4914",1894,"29",35300,33606,68906
"4915",1894,"30",35221,33969,69190
"4916",1894,"31",31548,30608,62156
"4917",1894,"32",31317,30556,61873
"4918",1894,"33",28815,28166,56981
"4919",1894,"34",29989,29010,58999
"4920",1894,"35",26878,26333,53211
"4921",1894,"36",27831,27110,54941
"4922",1894,"37",27090,26540,53630
"4923",1894,"38",25162,25050,50212
"4924",1894,"39",25957,25314,51271
"4925",1894,"40",25373,25010,50383
"4926",1894,"41",26758,26178,52936
"4927",1894,"42",24970,24839,49809
"4928",1894,"43",25505,25293,50798
"4929",1894,"44",26021,25068,51089
"4930",1894,"45",21586,21412,42998
"4931",1894,"46",19966,19277,39243
"4932",1894,"47",20531,19785,40316
"4933",1894,"48",22554,21890,44444
"4934",1894,"49",22770,22344,45114
"4935",1894,"50",21437,20947,42384
"4936",1894,"51",21888,20958,42846
"4937",1894,"52",20575,20366,40941
"4938",1894,"53",21776,20588,42364
"4939",1894,"54",21312,20021,41333
"4940",1894,"55",20410,19388,39798
"4941",1894,"56",18826,18004,36830
"4942",1894,"57",19157,18212,37369
"4943",1894,"58",17872,16878,34750
"4944",1894,"59",17489,16034,33523
"4945",1894,"60",17081,15797,32878
"4946",1894,"61",14896,13797,28693
"4947",1894,"62",14119,13338,27457
"4948",1894,"63",15628,13890,29518
"4949",1894,"64",14684,13353,28037
"4950",1894,"65",13164,12054,25218
"4951",1894,"66",12384,11078,23462
"4952",1894,"67",12775,11076,23851
"4953",1894,"68",12311,10800,23111
"4954",1894,"69",12076,10582,22658
"4955",1894,"70",11211,9538,20749
"4956",1894,"71",10197,8978,19175
"4957",1894,"72",9003,7898,16901
"4958",1894,"73",8263,6850,15113
"4959",1894,"74",7455,6336,13791
"4960",1894,"75",6367,5404,11771
"4961",1894,"76",5647,4750,10397
"4962",1894,"77",5501,4457,9958
"4963",1894,"78",4544,3639,8183
"4964",1894,"79",3972,3032,7004
"4965",1894,"80",3321,2542,5863
"4966",1894,"81",2830,2069,4899
"4967",1894,"82",2410,1701,4111
"4968",1894,"83",1973,1363,3336
"4969",1894,"84",1442,1028,2470
"4970",1894,"85",1045,785,1830
"4971",1894,"86",893,663,1556
"4972",1894,"87",716,521,1237
"4973",1894,"88",524,351,875
"4974",1894,"89",411,271,682
"4975",1894,"90",279,187,466
"4976",1894,"91",200,137,337
"4977",1894,"92",129,72,201
"4978",1894,"93",99,61,160
"4979",1894,"94",65.79,50,115.79
"4980",1894,"95",37.21,25,62.21
"4981",1894,"96",22,14,36
"4982",1894,"97",11,13,24
"4983",1894,"98",5,2,7
"4984",1894,"99",4,2,6
"4985",1894,"100",2,0,2
"4986",1894,"101",0,0,0
"4987",1894,"102",0,0,0
"4988",1894,"103",0,0,0
"4989",1894,"104",0,0.53,0.53
"4990",1894,"105",0,0.47,0.47
"4991",1894,"106",0,0,0
"4992",1894,"107",0,0,0
"4993",1894,"108",0,0,0
"4994",1894,"109",0,0,0
"4995",1894,"110+",0,0,0
"4996",1895,"0",68895,70646,139541
"4997",1895,"1",63883,64717,128600
"4998",1895,"2",58119,58749,116868
"4999",1895,"3",58618,59359,117977
"5000",1895,"4",55577,56099,111676
"5001",1895,"5",55297,56150,111447
"5002",1895,"6",55186,56196,111382
"5003",1895,"7",54579,55598,110177
"5004",1895,"8",54077,54397,108474
"5005",1895,"9",53023,53659,106682
"5006",1895,"10",51646,52186,103832
"5007",1895,"11",49631,49969,99600
"5008",1895,"12",50551,50759,101310
"5009",1895,"13",48385,48830,97215
"5010",1895,"14",47871,47416,95287
"5011",1895,"15",49186,48667,97853
"5012",1895,"16",47165,47201,94366
"5013",1895,"17",47021,46663,93684
"5014",1895,"18",46597,45943,92540
"5015",1895,"19",44270,43417,87687
"5016",1895,"20",43835,42869,86704
"5017",1895,"21",42885,41556,84441
"5018",1895,"22",41800,40313,82113
"5019",1895,"23",38010,36509,74519
"5020",1895,"24",38313,37066,75379
"5021",1895,"25",37614,35695,73309
"5022",1895,"26",36921,35039,71960
"5023",1895,"27",36506,35393,71899
"5024",1895,"28",36268,34932,71200
"5025",1895,"29",35386,33732,69118
"5026",1895,"30",34948,33308,68256
"5027",1895,"31",34938,33697,68635
"5028",1895,"32",31240,30362,61602
"5029",1895,"33",31028,30325,61353
"5030",1895,"34",28545,27950,56495
"5031",1895,"35",29660,28748,58408
"5032",1895,"36",26635,26108,52743
"5033",1895,"37",27528,26856,54384
"5034",1895,"38",26808,26296,53104
"5035",1895,"39",24895,24837,49732
"5036",1895,"40",25679,25075,50754
"5037",1895,"41",25075,24759,49834
"5038",1895,"42",26486,25901,52387
"5039",1895,"43",24693,24559,49252
"5040",1895,"44",25201,25008,50209
"5041",1895,"45",25779,24819,50598
"5042",1895,"46",21380,21180,42560
"5043",1895,"47",19749,19059,38808
"5044",1895,"48",20305,19536,39841
"5045",1895,"49",22283,21589,43872
"5046",1895,"50",22480,22001,44481
"5047",1895,"51",21152,20616,41768
"5048",1895,"52",21605,20609,42214
"5049",1895,"53",20261,20028,40289
"5050",1895,"54",21487,20224,41711
"5051",1895,"55",20931,19618,40549
"5052",1895,"56",20103,18980,39083
"5053",1895,"57",18500,17619,36119
"5054",1895,"58",18804,17800,36604
"5055",1895,"59",17530,16503,34033
"5056",1895,"60",17121,15614,32735
"5057",1895,"61",16656,15361,32017
"5058",1895,"62",14512,13348,27860
"5059",1895,"63",13679,12864,26543
"5060",1895,"64",15151,13356,28507
"5061",1895,"65",14192,12866,27058
"5062",1895,"66",12720,11515,24235
"5063",1895,"67",11882,10577,22459
"5064",1895,"68",12210,10513,22723
"5065",1895,"69",11718,10228,21946
"5066",1895,"70",11418,9963,21381
"5067",1895,"71",10600,8924,19524
"5068",1895,"72",9561,8332,17893
"5069",1895,"73",8415,7310,15725
"5070",1895,"74",7645,6275,13920
"5071",1895,"75",6807,5758,12565
"5072",1895,"76",5814,4876,10690
"5073",1895,"77",5075,4264,9339
"5074",1895,"78",4864,3955,8819
"5075",1895,"79",4004,3171,7175
"5076",1895,"80",3515,2573,6088
"5077",1895,"81",2876,2167,5043
"5078",1895,"82",2421,1744,4165
"5079",1895,"83",2028,1403,3431
"5080",1895,"84",1633,1107,2740
"5081",1895,"85",1175,821,1996
"5082",1895,"86",849,619,1468
"5083",1895,"87",688,503,1191
"5084",1895,"88",561,387,948
"5085",1895,"89",395,253,648
"5086",1895,"90",307,190,497
"5087",1895,"91",198,133,331
"5088",1895,"92",137,95,232
"5089",1895,"93",89,49,138
"5090",1895,"94",57,42,99
"5091",1895,"95",47.79,25,72.79
"5092",1895,"96",21.21,15,36.21
"5093",1895,"97",12,8,20
"5094",1895,"98",3,10,13
"5095",1895,"99",3,1,4
"5096",1895,"100",2,0,2
"5097",1895,"101",2,0,2
"5098",1895,"102",0,0,0
"5099",1895,"103",0,0,0
"5100",1895,"104",0,0,0
"5101",1895,"105",0,0.53,0.53
"5102",1895,"106",0,0.47,0.47
"5103",1895,"107",0,0,0
"5104",1895,"108",0,0,0
"5105",1895,"109",0,0,0
"5106",1895,"110+",0,0,0
"5107",1896,"0",68974,70868,139842
"5108",1896,"1",63328,64269,127597
"5109",1896,"2",61917,62713,124630
"5110",1896,"3",57379,57959,115338
"5111",1896,"4",58033,58678,116711
"5112",1896,"5",55160,55666,110826
"5113",1896,"6",54972,55786,110758
"5114",1896,"7",54919,55919,110838
"5115",1896,"8",54293,55305,109598
"5116",1896,"9",53874,54172,108046
"5117",1896,"10",52821,53444,106265
"5118",1896,"11",51453,52035,103488
"5119",1896,"12",49415,49793,99208
"5120",1896,"13",50328,50535,100863
"5121",1896,"14",48134,48616,96750
"5122",1896,"15",47650,47137,94787
"5123",1896,"16",48867,48302,97169
"5124",1896,"17",46894,46755,93649
"5125",1896,"18",46697,46184,92881
"5126",1896,"19",46300,45391,91691
"5127",1896,"20",43935,42798,86733
"5128",1896,"21",43539,42255,85794
"5129",1896,"22",42547,40944,83491
"5130",1896,"23",41505,39752,81257
"5131",1896,"24",37680,36005,73685
"5132",1896,"25",37989,36575,74564
"5133",1896,"26",37306,35276,72582
"5134",1896,"27",36621,34654,71275
"5135",1896,"28",36213,35049,71262
"5136",1896,"29",35941,34600,70541
"5137",1896,"30",35063,33409,68472
"5138",1896,"31",34593,33015,67608
"5139",1896,"32",34660,33436,68096
"5140",1896,"33",30931,30112,61043
"5141",1896,"34",30752,30094,60846
"5142",1896,"35",28265,27743,56008
"5143",1896,"36",29343,28522,57865
"5144",1896,"37",26404,25897,52301
"5145",1896,"38",27261,26625,53886
"5146",1896,"39",26549,26087,52636
"5147",1896,"40",24662,24650,49312
"5148",1896,"41",25437,24854,50291
"5149",1896,"42",24799,24535,49334
"5150",1896,"43",26240,25610,51850
"5151",1896,"44",24452,24265,48717
"5152",1896,"45",24952,24752,49704
"5153",1896,"46",25570,24526,50096
"5154",1896,"47",21186,20945,42131
"5155",1896,"48",19529,18834,38363
"5156",1896,"49",20090,19256,39346
"5157",1896,"50",22000,21273,43273
"5158",1896,"51",22219,21680,43899
"5159",1896,"52",20887,20268,41155
"5160",1896,"53",21325,20266,41591
"5161",1896,"54",19943,19660,39603
"5162",1896,"55",21167,19850,41017
"5163",1896,"56",20587,19198,39785
"5164",1896,"57",19735,18579,38314
"5165",1896,"58",18154,17191,35345
"5166",1896,"59",18426,17324,35750
"5167",1896,"60",17174,16102,33276
"5168",1896,"61",16703,15180,31883
"5169",1896,"62",16230,14930,31160
"5170",1896,"63",14111,12868,26979
"5171",1896,"64",13254,12436,25690
"5172",1896,"65",14686,12800,27486
"5173",1896,"66",13641,12299,25940
"5174",1896,"67",12188,11013,23201
"5175",1896,"68",11347,10024,21371
"5176",1896,"69",11654,9932,21586
"5177",1896,"70",11078,9589,20667
"5178",1896,"71",10795,9370,20165
"5179",1896,"72",9956,8336,18292
"5180",1896,"73",8937,7690,16627
"5181",1896,"74",7847,6693,14540
"5182",1896,"75",7023,5706,12729
"5183",1896,"76",6145,5197,11342
"5184",1896,"77",5269,4386,9655
"5185",1896,"78",4560,3747,8307
"5186",1896,"79",4316,3418,7734
"5187",1896,"80",3645,2748,6393
"5188",1896,"81",3030,2214,5244
"5189",1896,"82",2451,1801,4252
"5190",1896,"83",2032,1447,3479
"5191",1896,"84",1695,1113,2808
"5192",1896,"85",1324,892,2216
"5193",1896,"86",901,639,1540
"5194",1896,"87",657,486,1143
"5195",1896,"88",514,375,889
"5196",1896,"89",440,288,728
"5197",1896,"90",308,177,485
"5198",1896,"91",225,124,349
"5199",1896,"92",130,98,228
"5200",1896,"93",89,71,160
"5201",1896,"94",56,35,91
"5202",1896,"95",38,26,64
"5203",1896,"96",28.79,15,43.79
"5204",1896,"97",16.21,8,24.21
"5205",1896,"98",8,6,14
"5206",1896,"99",1,5,6
"5207",1896,"100",2,0,2
"5208",1896,"101",1,0,1
"5209",1896,"102",1,0,1
"5210",1896,"103",0,0,0
"5211",1896,"104",0,0,0
"5212",1896,"105",0,0,0
"5213",1896,"106",0,0.53,0.53
"5214",1896,"107",0,0.47,0.47
"5215",1896,"108",0,0,0
"5216",1896,"109",0,0,0
"5217",1896,"110+",0,0,0
"5218",1897,"0",71048,73175,144223
"5219",1897,"1",63722,64682,128404
"5220",1897,"2",61604,62456,124060
"5221",1897,"3",61027,61762,122789
"5222",1897,"4",56890,57389,114279
"5223",1897,"5",57535,58172,115707
"5224",1897,"6",54836,55325,110161
"5225",1897,"7",54706,55493,110199
"5226",1897,"8",54687,55713,110400
"5227",1897,"9",54054,55082,109136
"5228",1897,"10",53692,53967,107659
"5229",1897,"11",52651,53270,105921
"5230",1897,"12",51279,51903,103182
"5231",1897,"13",49222,49637,98859
"5232",1897,"14",50112,50321,100433
"5233",1897,"15",47859,48386,96245
"5234",1897,"16",47444,46863,94307
"5235",1897,"17",48576,47881,96457
"5236",1897,"18",46601,46303,92904
"5237",1897,"19",46370,45662,92032
"5238",1897,"20",45988,44823,90811
"5239",1897,"21",43576,42196,85772
"5240",1897,"22",43236,41651,84887
"5241",1897,"23",42210,40339,82549
"5242",1897,"24",41198,39229,80427
"5243",1897,"25",37357,35518,72875
"5244",1897,"26",37697,36090,73787
"5245",1897,"27",37019,34884,71903
"5246",1897,"28",36332,34297,70629
"5247",1897,"29",35919,34699,70618
"5248",1897,"30",35612,34280,69892
"5249",1897,"31",34742,33123,67865
"5250",1897,"32",34277,32720,66997
"5251",1897,"33",34385,33202,67587
"5252",1897,"34",30639,29888,60527
"5253",1897,"35",30488,29875,60363
"5254",1897,"36",28024,27541,55565
"5255",1897,"37",29043,28250,57293
"5256",1897,"38",26200,25692,51892
"5257",1897,"39",26983,26392,53375
"5258",1897,"40",26303,25885,52188
"5259",1897,"41",24416,24445,48861
"5260",1897,"42",25216,24643,49859
"5261",1897,"43",24561,24306,48867
"5262",1897,"44",26011,25359,51370
"5263",1897,"45",24228,24022,48250
"5264",1897,"46",24718,24514,49232
"5265",1897,"47",25345,24247,49592
"5266",1897,"48",21004,20702,41706
"5267",1897,"49",19331,18576,37907
"5268",1897,"50",19848,19001,38849
"5269",1897,"51",21721,20992,42713
"5270",1897,"52",21950,21334,43284
"5271",1897,"53",20618,19936,40554
"5272",1897,"54",21031,19923,40954
"5273",1897,"55",19651,19318,38969
"5274",1897,"56",20823,19459,40282
"5275",1897,"57",20223,18777,39000
"5276",1897,"58",19372,18213,37585
"5277",1897,"59",17781,16780,34561
"5278",1897,"60",18048,16854,34902
"5279",1897,"61",16786,15686,32472
"5280",1897,"62",16310,14776,31086
"5281",1897,"63",15815,14491,30306
"5282",1897,"64",13703,12429,26132
"5283",1897,"65",12844,11978,24822
"5284",1897,"66",14212,12283,26495
"5285",1897,"67",13109,11743,24852
"5286",1897,"68",11698,10555,22253
"5287",1897,"69",10892,9496,20388
"5288",1897,"70",11122,9364,20486
"5289",1897,"71",10483,9016,19499
"5290",1897,"72",10188,8748,18936
"5291",1897,"73",9314,7758,17072
"5292",1897,"74",8283,7111,15394
"5293",1897,"75",7291,6125,13416
"5294",1897,"76",6491,5179,11670
"5295",1897,"77",5561,4692,10253
"5296",1897,"78",4745,3946,8691
"5297",1897,"79",4085,3298,7383
"5298",1897,"80",3717,2938,6655
"5299",1897,"81",3228,2362,5590
"5300",1897,"82",2595,1886,4481
"5301",1897,"83",2101,1513,3614
"5302",1897,"84",1694,1196,2890
"5303",1897,"85",1407,903,2310
"5304",1897,"86",1068,708,1776
"5305",1897,"87",723,513,1236
"5306",1897,"88",528,361,889
"5307",1897,"89",400,280,680
"5308",1897,"90",338,217,555
"5309",1897,"91",234,129,363
"5310",1897,"92",160,92,252
"5311",1897,"93",92,62,154
"5312",1897,"94",62,42,104
"5313",1897,"95",33,20,53
"5314",1897,"96",23,17,40
"5315",1897,"97",16.79,7,23.79
"5316",1897,"98",6.21,5,11.21
"5317",1897,"99",4,2,6
"5318",1897,"100",1,4,5
"5319",1897,"101",0,0,0
"5320",1897,"102",1,0,1
"5321",1897,"103",1,0,1
"5322",1897,"104",0,0,0
"5323",1897,"105",0,0,0
"5324",1897,"106",0,0,0
"5325",1897,"107",0,0.53,0.53
"5326",1897,"108",0,0.47,0.47
"5327",1897,"109",0,0,0
"5328",1897,"110+",0,0,0
"5329",1898,"0",71891,73515,145406
"5330",1898,"1",66138,67365,133503
"5331",1898,"2",62217,63101,125318
"5332",1898,"3",60935,61697,122632
"5333",1898,"4",60511,61196,121707
"5334",1898,"5",56588,57030,113618
"5335",1898,"6",57159,57739,114898
"5336",1898,"7",54566,55076,109642
"5337",1898,"8",54507,55273,109780
"5338",1898,"9",54469,55514,109983
"5339",1898,"10",53834,54884,108718
"5340",1898,"11",53505,53792,107297
"5341",1898,"12",52453,53109,105562
"5342",1898,"13",51081,51772,102853
"5343",1898,"14",49018,49465,98483
"5344",1898,"15",49879,50080,99959
"5345",1898,"16",47569,48149,95718
"5346",1898,"17",47216,46540,93756
"5347",1898,"18",48278,47446,95724
"5348",1898,"19",46330,45828,92158
"5349",1898,"20",46038,45128,91166
"5350",1898,"21",45705,44248,89953
"5351",1898,"22",43239,41568,84807
"5352",1898,"23",42951,41053,84004
"5353",1898,"24",41875,39734,81609
"5354",1898,"25",40886,38691,79577
"5355",1898,"26",37025,34997,72022
"5356",1898,"27",37412,35654,73066
"5357",1898,"28",36736,34470,71206
"5358",1898,"29",36032,33926,69958
"5359",1898,"30",35640,34367,70007
"5360",1898,"31",35301,33975,69276
"5361",1898,"32",34435,32808,67243
"5362",1898,"33",33961,32447,66408
"5363",1898,"34",34120,32953,67073
"5364",1898,"35",30366,29655,60021
"5365",1898,"36",30216,29631,59847
"5366",1898,"37",27796,27332,55128
"5367",1898,"38",28744,28072,56816
"5368",1898,"39",25980,25498,51478
"5369",1898,"40",26707,26163,52870
"5370",1898,"41",26079,25654,51733
"5371",1898,"42",24185,24259,48444
"5372",1898,"43",24996,24413,49409
"5373",1898,"44",24317,24058,48375
"5374",1898,"45",25786,25086,50872
"5375",1898,"46",24007,23740,47747
"5376",1898,"47",24449,24246,48695
"5377",1898,"48",25100,23964,49064
"5378",1898,"49",20831,20451,41282
"5379",1898,"50",19118,18297,37415
"5380",1898,"51",19637,18714,38351
"5381",1898,"52",21451,20663,42114
"5382",1898,"53",21654,20987,42641
"5383",1898,"54",20328,19584,39912
"5384",1898,"55",20706,19592,40298
"5385",1898,"56",19342,18933,38275
"5386",1898,"57",20466,19073,39539
"5387",1898,"58",19818,18371,38189
"5388",1898,"59",19001,17804,36805
"5389",1898,"60",17402,16352,33754
"5390",1898,"61",17670,16388,34058
"5391",1898,"62",16404,15243,31647
"5392",1898,"63",15858,14325,30183
"5393",1898,"64",15373,13970,29343
"5394",1898,"65",13249,11954,25203
"5395",1898,"66",12410,11488,23898
"5396",1898,"67",13692,11781,25473
"5397",1898,"68",12558,11168,23726
"5398",1898,"69",11181,10019,21200
"5399",1898,"70",10374,8937,19311
"5400",1898,"71",10524,8789,19313
"5401",1898,"72",9863,8425,18288
"5402",1898,"73",9580,8116,17696
"5403",1898,"74",8645,7150,15795
"5404",1898,"75",7662,6505,14167
"5405",1898,"76",6717,5502,12219
"5406",1898,"77",5876,4686,10562
"5407",1898,"78",5032,4164,9196
"5408",1898,"79",4199,3496,7695
"5409",1898,"80",3594,2864,6458
"5410",1898,"81",3284,2548,5832
"5411",1898,"82",2779,2004,4783
"5412",1898,"83",2216,1564,3780
"5413",1898,"84",1748,1254,3002
"5414",1898,"85",1406,956,2362
"5415",1898,"86",1148,701,1849
"5416",1898,"87",839,542,1381
"5417",1898,"88",572,389,961
"5418",1898,"89",424,272,696
"5419",1898,"90",313,189,502
"5420",1898,"91",258,162,420
"5421",1898,"92",169,88,257
"5422",1898,"93",114,68,182
"5423",1898,"94",64,45,109
"5424",1898,"95",37,31,68
"5425",1898,"96",18,14,32
"5426",1898,"97",16,14,30
"5427",1898,"98",13.79,4,17.79
"5428",1898,"99",3.21,5,8.21
"5429",1898,"100",0,1,1
"5430",1898,"101",1,2,3
"5431",1898,"102",0,0,0
"5432",1898,"103",1,0,1
"5433",1898,"104",1,0,1
"5434",1898,"105",0,0,0
"5435",1898,"106",0,0,0
"5436",1898,"107",0,0,0
"5437",1898,"108",0,0.53,0.53
"5438",1898,"109",0,0.47,0.47
"5439",1898,"110+",0,0,0
"5440",1899,"0",70789,72885,143674
"5441",1899,"1",66712,67491,134203
"5442",1899,"2",64558,65770,130328
"5443",1899,"3",61430,62282,123712
"5444",1899,"4",60455,61208,121663
"5445",1899,"5",60127,60757,120884
"5446",1899,"6",56330,56735,113065
"5447",1899,"7",56841,57413,114254
"5448",1899,"8",54321,54857,109178
"5449",1899,"9",54313,55072,109385
"5450",1899,"10",54301,55373,109674
"5451",1899,"11",53643,54703,108346
"5452",1899,"12",53355,53636,106991
"5453",1899,"13",52267,52955,105222
"5454",1899,"14",50914,51648,102562
"5455",1899,"15",48809,49308,98117
"5456",1899,"16",49656,49848,99504
"5457",1899,"17",47278,47897,95175
"5458",1899,"18",47014,46208,93222
"5459",1899,"19",47997,46965,94962
"5460",1899,"20",46047,45371,91418
"5461",1899,"21",45698,44581,90279
"5462",1899,"22",45417,43683,89100
"5463",1899,"23",42903,41008,83911
"5464",1899,"24",42653,40468,83121
"5465",1899,"25",41557,39153,80710
"5466",1899,"26",40609,38188,78797
"5467",1899,"27",36694,34509,71203
"5468",1899,"28",37097,35245,72342
"5469",1899,"29",36447,34080,70527
"5470",1899,"30",35752,33559,69311
"5471",1899,"31",35332,34021,69353
"5472",1899,"32",34966,33659,68625
"5473",1899,"33",34141,32489,66630
"5474",1899,"34",33658,32171,65829
"5475",1899,"35",33850,32715,66565
"5476",1899,"36",30098,29446,59544
"5477",1899,"37",29958,29390,59348
"5478",1899,"38",27535,27110,54645
"5479",1899,"39",28456,27848,56304
"5480",1899,"40",25775,25252,51027
"5481",1899,"41",26434,25916,52350
"5482",1899,"42",25825,25425,51250
"5483",1899,"43",23968,24056,48024
"5484",1899,"44",24757,24194,48951
"5485",1899,"45",24054,23827,47881
"5486",1899,"46",25549,24830,50379
"5487",1899,"47",23774,23446,47220
"5488",1899,"48",24220,23946,48166
"5489",1899,"49",24877,23676,48553
"5490",1899,"50",20641,20193,40834
"5491",1899,"51",18898,18043,36941
"5492",1899,"52",19413,18432,37845
"5493",1899,"53",21156,20337,41493
"5494",1899,"54",21374,20651,42025
"5495",1899,"55",20006,19246,39252
"5496",1899,"56",20370,19227,39597
"5497",1899,"57",19007,18570,37577
"5498",1899,"58",20089,18687,38776
"5499",1899,"59",19409,17938,37347
"5500",1899,"60",18621,17348,35969
"5501",1899,"61",17031,15886,32917
"5502",1899,"62",17222,15936,33158
"5503",1899,"63",15972,14743,30715
"5504",1899,"64",15371,13802,29173
"5505",1899,"65",14937,13491,28428
"5506",1899,"66",12818,11415,24233
"5507",1899,"67",11936,11010,22946
"5508",1899,"68",13145,11207,24352
"5509",1899,"69",11976,10570,22546
"5510",1899,"70",10619,9481,20100
"5511",1899,"71",9795,8394,18189
"5512",1899,"72",9910,8200,18110
"5513",1899,"73",9262,7834,17096
"5514",1899,"74",8897,7460,16357
"5515",1899,"75",7999,6591,14590
"5516",1899,"76",7011,5961,12972
"5517",1899,"77",6140,4976,11116
"5518",1899,"78",5313,4169,9482
"5519",1899,"79",4490,3687,8177
"5520",1899,"80",3753,3083,6836
"5521",1899,"81",3141,2469,5610
"5522",1899,"82",2849,2203,5052
"5523",1899,"83",2372,1691,4063
"5524",1899,"84",1831,1304,3135
"5525",1899,"85",1430,1057,2487
"5526",1899,"86",1141,765,1906
"5527",1899,"87",926,528,1454
"5528",1899,"88",645,430,1075
"5529",1899,"89",441,289,730
"5530",1899,"90",313,204,517
"5531",1899,"91",242,138,380
"5532",1899,"92",186,105,291
"5533",1899,"93",120,57,177
"5534",1899,"94",82,49,131
"5535",1899,"95",41,32,73
"5536",1899,"96",24,20,44
"5537",1899,"97",11,8,19
"5538",1899,"98",9,10,19
"5539",1899,"99",5.79,3,8.79
"5540",1899,"100",1.21,3,4.21
"5541",1899,"101",0,0,0
"5542",1899,"102",0,1,1
"5543",1899,"103",0,0,0
"5544",1899,"104",0,0,0
"5545",1899,"105",0,0,0
"5546",1899,"106",0,0,0
"5547",1899,"107",0,0,0
"5548",1899,"108",0,0,0
"5549",1899,"109",0,0.53,0.53
"5550",1899,"110+",0,0.47,0.47
"5551",1900,"0",72242,74119,146361
"5552",1900,"1",66026,67466,133492
"5553",1900,"2",65251,65938,131189
"5554",1900,"3",63789,65030,128819
"5555",1900,"4",60959,61799,122758
"5556",1900,"5",60081,60824,120905
"5557",1900,"6",59797,60450,120247
"5558",1900,"7",56084,56475,112559
"5559",1900,"8",56570,57138,113708
"5560",1900,"9",54133,54634,108767
"5561",1900,"10",54122,54806,108928
"5562",1900,"11",54075,55081,109156
"5563",1900,"12",53386,54387,107773
"5564",1900,"13",53111,53285,106396
"5565",1900,"14",52033,52627,104660
"5566",1900,"15",50651,51325,101976
"5567",1900,"16",48559,48957,97516
"5568",1900,"17",49370,49430,98800
"5569",1900,"18",46987,47504,94491
"5570",1900,"19",46756,45802,92558
"5571",1900,"20",47695,46507,94202
"5572",1900,"21",45731,44868,90599
"5573",1900,"22",45404,44051,89455
"5574",1900,"23",45126,43221,88347
"5575",1900,"24",42622,40565,83187
"5576",1900,"25",42344,40042,82386
"5577",1900,"26",41256,38751,80007
"5578",1900,"27",40303,37791,78094
"5579",1900,"28",36413,34194,70607
"5580",1900,"29",36783,34926,71709
"5581",1900,"30",36129,33781,69910
"5582",1900,"31",35467,33292,68759
"5583",1900,"32",35032,33741,68773
"5584",1900,"33",34687,33406,68093
"5585",1900,"34",33859,32260,66119
"5586",1900,"35",33374,31927,65301
"5587",1900,"36",33587,32485,66072
"5588",1900,"37",29844,29237,59081
"5589",1900,"38",29697,29181,58878
"5590",1900,"39",27297,26889,54186
"5591",1900,"40",28202,27652,55854
"5592",1900,"41",25542,25043,50585
"5593",1900,"42",26176,25694,51870
"5594",1900,"43",25598,25166,50764
"5595",1900,"44",23765,23829,47594
"5596",1900,"45",24540,23952,48492
"5597",1900,"46",23850,23580,47430
"5598",1900,"47",25314,24517,49831
"5599",1900,"48",23568,23170,46738
"5600",1900,"49",23995,23678,47673
"5601",1900,"50",24607,23373,47980
"5602",1900,"51",20439,19920,40359
"5603",1900,"52",18666,17776,36442
"5604",1900,"53",19155,18130,37285
"5605",1900,"54",20855,19991,40846
"5606",1900,"55",21072,20279,41351
"5607",1900,"56",19702,18868,38570
"5608",1900,"57",20007,18822,38829
"5609",1900,"58",18629,18198,36827
"5610",1900,"59",19669,18246,37915
"5611",1900,"60",18996,17487,36483
"5612",1900,"61",18198,16872,35070
"5613",1900,"62",16589,15414,32003
"5614",1900,"63",16747,15415,32162
"5615",1900,"64",15493,14208,29701
"5616",1900,"65",14887,13279,28166
"5617",1900,"66",14413,12962,27375
"5618",1900,"67",12277,10866,23143
"5619",1900,"68",11379,10463,21842
"5620",1900,"69",12549,10594,23143
"5621",1900,"70",11381,9921,21302
"5622",1900,"71",9998,8912,18910
"5623",1900,"72",9177,7816,16993
"5624",1900,"73",9229,7557,16786
"5625",1900,"74",8551,7209,15760
"5626",1900,"75",8208,6831,15039
"5627",1900,"76",7288,5933,13221
"5628",1900,"77",6337,5300,11637
"5629",1900,"78",5510,4401,9911
"5630",1900,"79",4665,3628,8293
"5631",1900,"80",3955,3187,7142
"5632",1900,"81",3219,2627,5846
"5633",1900,"82",2710,2105,4815
"5634",1900,"83",2335,1800,4135
"5635",1900,"84",2000,1369,3369
"5636",1900,"85",1464,1031,2495
"5637",1900,"86",1137,835,1972
"5638",1900,"87",883,590,1473
"5639",1900,"88",719,403,1122
"5640",1900,"89",500,325,825
"5641",1900,"90",310,212,522
"5642",1900,"91",224,140,364
"5643",1900,"92",156,94,250
"5644",1900,"93",128,76,204
"5645",1900,"94",84,36,120
"5646",1900,"95",56,29,85
"5647",1900,"96",31,27,58
"5648",1900,"97",13,11,24
"5649",1900,"98",6,6,12
"5650",1900,"99",4,8,12
"5651",1900,"100",5.79,3,8.79
"5652",1900,"101",1.21,1,2.21
"5653",1900,"102",0,0,0
"5654",1900,"103",0,0,0
"5655",1900,"104",0,0,0
"5656",1900,"105",0,0,0
"5657",1900,"106",0,0,0
"5658",1900,"107",0,0,0
"5659",1900,"108",0,0,0
"5660",1900,"109",0,0,0
"5661",1900,"110+",0,0,0
"5662",1901,"0",71419,73825,145244
"5663",1901,"1",67037,68109,135146
"5664",1901,"2",64474,65833,130307
"5665",1901,"3",64515,65119,129634
"5666",1901,"4",63275,64492,127767
"5667",1901,"5",60617,61441,122058
"5668",1901,"6",59774,60513,120287
"5669",1901,"7",59546,60205,119751
"5670",1901,"8",55810,56254,112064
"5671",1901,"9",56365,56896,113261
"5672",1901,"10",53942,54344,108286
"5673",1901,"11",53872,54425,108297
"5674",1901,"12",53811,54669,108480
"5675",1901,"13",53057,53942,106999
"5676",1901,"14",52828,52771,105599
"5677",1901,"15",51718,52141,103859
"5678",1901,"16",50278,50791,101069
"5679",1901,"17",48232,48437,96669
"5680",1901,"18",49028,48875,97903
"5681",1901,"19",46695,46932,93627
"5682",1901,"20",46435,45303,91738
"5683",1901,"21",47388,46013,93401
"5684",1901,"22",45390,44409,89799
"5685",1901,"23",45106,43600,88706
"5686",1901,"24",44785,42836,87621
"5687",1901,"25",42357,40233,82590
"5688",1901,"26",42017,39719,81736
"5689",1901,"27",41006,38523,79529
"5690",1901,"28",40004,37511,77515
"5691",1901,"29",36165,34013,70178
"5692",1901,"30",36538,34703,71241
"5693",1901,"31",35839,33562,69401
"5694",1901,"32",35211,33087,68298
"5695",1901,"33",34745,33532,68277
"5696",1901,"34",34428,33194,67622
"5697",1901,"35",33616,32058,65674
"5698",1901,"36",33105,31724,64829
"5699",1901,"37",33294,32246,65540
"5700",1901,"38",29585,29010,58595
"5701",1901,"39",29472,28950,58422
"5702",1901,"40",27057,26642,53699
"5703",1901,"41",27929,27406,55335
"5704",1901,"42",25284,24809,50093
"5705",1901,"43",25932,25433,51365
"5706",1901,"44",25344,24927,50271
"5707",1901,"45",23566,23582,47148
"5708",1901,"46",24295,23650,47945
"5709",1901,"47",23620,23321,46941
"5710",1901,"48",25071,24204,49275
"5711",1901,"49",23363,22879,46242
"5712",1901,"50",23708,23377,47085
"5713",1901,"51",24271,23037,47308
"5714",1901,"52",20196,19619,39815
"5715",1901,"53",18396,17491,35887
"5716",1901,"54",18879,17833,36712
"5717",1901,"55",20518,19608,40126
"5718",1901,"56",20731,19844,40575
"5719",1901,"57",19369,18485,37854
"5720",1901,"58",19612,18417,38029
"5721",1901,"59",18256,17800,36056
"5722",1901,"60",19259,17738,36997
"5723",1901,"61",18534,17028,35562
"5724",1901,"62",17719,16393,34112
"5725",1901,"63",16084,14903,30987
"5726",1901,"64",16216,14855,31071
"5727",1901,"65",14959,13710,28669
"5728",1901,"66",14301,12704,27005
"5729",1901,"67",13817,12339,26156
"5730",1901,"68",11693,10321,22014
"5731",1901,"69",10828,9887,20715
"5732",1901,"70",11856,9936,21792
"5733",1901,"71",10686,9256,19942
"5734",1901,"72",9394,8216,17610
"5735",1901,"73",8501,7188,15689
"5736",1901,"74",8437,6889,15326
"5737",1901,"75",7837,6521,14358
"5738",1901,"76",7437,6169,13606
"5739",1901,"77",6520,5264,11784
"5740",1901,"78",5612,4675,10287
"5741",1901,"79",4813,3844,8657
"5742",1901,"80",3927,3041,6968
"5743",1901,"81",3415,2675,6090
"5744",1901,"82",2718,2229,4947
"5745",1901,"83",2258,1739,3997
"5746",1901,"84",1864,1436,3300
"5747",1901,"85",1642,1056,2698
"5748",1901,"86",1143,821,1964
"5749",1901,"87",890,619,1509
"5750",1901,"88",678,438,1116
"5751",1901,"89",514,295,809
"5752",1901,"90",353,225,578
"5753",1901,"91",232,144,376
"5754",1901,"92",158,83,241
"5755",1901,"93",108,57,165
"5756",1901,"94",80,46,126
"5757",1901,"95",56,22,78
"5758",1901,"96",39,17,56
"5759",1901,"97",14,14,28
"5760",1901,"98",4,7,11
"5761",1901,"99",2,4,6
"5762",1901,"100",1,3,4
"5763",1901,"101",1.79,1,2.79
"5764",1901,"102",0.21,0,0.21
"5765",1901,"103",0,0,0
"5766",1901,"104",0,0,0
"5767",1901,"105",0,0,0
"5768",1901,"106",0,0,0
"5769",1901,"107",0,0,0
"5770",1901,"108",0,0,0
"5771",1901,"109",0,0,0
"5772",1901,"110+",0,0,0
"5773",1902,"0",74555,76532,151087
"5774",1902,"1",66043,67348,133391
"5775",1902,"2",65215,66171,131386
"5776",1902,"3",63567,64839,128406
"5777",1902,"4",63876,64424,128300
"5778",1902,"5",62806,64044,126850
"5779",1902,"6",60287,61116,121403
"5780",1902,"7",59488,60212,119700
"5781",1902,"8",59299,59961,119260
"5782",1902,"9",55554,56008,111562
"5783",1902,"10",56180,56669,112849
"5784",1902,"11",53742,54084,107826
"5785",1902,"12",53632,54049,107681
"5786",1902,"13",53564,54250,107814
"5787",1902,"14",52690,53468,106158
"5788",1902,"15",52506,52264,104770
"5789",1902,"16",51364,51614,102978
"5790",1902,"17",49918,50217,100135
"5791",1902,"18",47890,47869,95759
"5792",1902,"19",48718,48305,97023
"5793",1902,"20",46405,46317,92722
"5794",1902,"21",46129,44798,90927
"5795",1902,"22",47065,45520,92585
"5796",1902,"23",45058,43975,89033
"5797",1902,"24",44795,43184,87979
"5798",1902,"25",44438,42463,86901
"5799",1902,"26",42123,39969,82092
"5800",1902,"27",41664,39444,81108
"5801",1902,"28",40753,38315,79068
"5802",1902,"29",39689,37268,76957
"5803",1902,"30",35959,33860,69819
"5804",1902,"31",36288,34494,70782
"5805",1902,"32",35560,33380,68940
"5806",1902,"33",34947,32872,67819
"5807",1902,"34",34460,33325,67785
"5808",1902,"35",34208,32979,67187
"5809",1902,"36",33379,31865,65244
"5810",1902,"37",32873,31544,64417
"5811",1902,"38",33014,32025,65039
"5812",1902,"39",29319,28789,58108
"5813",1902,"40",29252,28769,58021
"5814",1902,"41",26847,26426,53273
"5815",1902,"42",27701,27185,54886
"5816",1902,"43",25081,24579,49660
"5817",1902,"44",25715,25190,50905
"5818",1902,"45",25120,24672,49792
"5819",1902,"46",23370,23353,46723
"5820",1902,"47",24054,23382,47436
"5821",1902,"48",23397,23043,46440
"5822",1902,"49",24811,23934,48745
"5823",1902,"50",23130,22621,45751
"5824",1902,"51",23427,23095,46522
"5825",1902,"52",23939,22705,46644
"5826",1902,"53",19948,19332,39280
"5827",1902,"54",18163,17213,35376
"5828",1902,"55",18618,17531,36149
"5829",1902,"56",20219,19228,39447
"5830",1902,"57",20411,19435,39846
"5831",1902,"58",19037,18116,37153
"5832",1902,"59",19263,17982,37245
"5833",1902,"60",17927,17412,35339
"5834",1902,"61",18844,17264,36108
"5835",1902,"62",18097,16558,34655
"5836",1902,"63",17271,15910,33181
"5837",1902,"64",15616,14415,30031
"5838",1902,"65",15695,14259,29954
"5839",1902,"66",14473,13160,27633
"5840",1902,"67",13770,12164,25934
"5841",1902,"68",13245,11795,25040
"5842",1902,"69",11162,9797,20959
"5843",1902,"70",10318,9294,19612
"5844",1902,"71",11214,9338,20552
"5845",1902,"72",10036,8638,18674
"5846",1902,"73",8745,7640,16385
"5847",1902,"74",7879,6626,14505
"5848",1902,"75",7746,6298,14044
"5849",1902,"76",7190,5923,13113
"5850",1902,"77",6735,5556,12291
"5851",1902,"78",5869,4723,10592
"5852",1902,"79",5056,4135,9191
"5853",1902,"80",4342,3407,7749
"5854",1902,"81",3403,2625,6028
"5855",1902,"82",2936,2257,5193
"5856",1902,"83",2322,1817,4139
"5857",1902,"84",1883,1418,3301
"5858",1902,"85",1498,1151,2649
"5859",1902,"86",1375,843,2218
"5860",1902,"87",918,617,1535
"5861",1902,"88",679,489,1168
"5862",1902,"89",517,324,841
"5863",1902,"90",392,225,617
"5864",1902,"91",246,157,403
"5865",1902,"92",160,97,257
"5866",1902,"93",108,58,166
"5867",1902,"94",69,37,106
"5868",1902,"95",53,28,81
"5869",1902,"96",39,12,51
"5870",1902,"97",15,9,24
"5871",1902,"98",11,8,19
"5872",1902,"99",2,4,6
"5873",1902,"100",1,2,3
"5874",1902,"101",1,2,3
"5875",1902,"102",1.79,0,1.79
"5876",1902,"103",0.21,0,0.21
"5877",1902,"104",0,0,0
"5878",1902,"105",0,0,0
"5879",1902,"106",0,0,0
"5880",1902,"107",0,0,0
"5881",1902,"108",0,0,0
"5882",1902,"109",0,0,0
"5883",1902,"110+",0,0,0
"5884",1903,"0",75551,78781,154332
"5885",1903,"1",69346,70590,139936
"5886",1903,"2",64439,65686,130125
"5887",1903,"3",64399,65337,129736
"5888",1903,"4",62963,64246,127209
"5889",1903,"5",63441,63996,127437
"5890",1903,"6",62452,63713,126165
"5891",1903,"7",60011,60858,120869
"5892",1903,"8",59231,59998,119229
"5893",1903,"9",59097,59770,118867
"5894",1903,"10",55327,55818,111145
"5895",1903,"11",55980,56438,112418
"5896",1903,"12",53560,53828,107388
"5897",1903,"13",53363,53687,107050
"5898",1903,"14",53298,53840,107138
"5899",1903,"15",52332,52982,105314
"5900",1903,"16",52165,51739,103904
"5901",1903,"17",51019,51072,102091
"5902",1903,"18",49562,49663,99225
"5903",1903,"19",47546,47280,94826
"5904",1903,"20",48393,47713,96106
"5905",1903,"21",46073,45743,91816
"5906",1903,"22",45807,44302,90109
"5907",1903,"23",46726,45045,91771
"5908",1903,"24",44760,43531,88291
"5909",1903,"25",44488,42808,87296
"5910",1903,"26",44123,42101,86224
"5911",1903,"27",41864,39725,81589
"5912",1903,"28",41352,39165,80517
"5913",1903,"29",40501,38084,78585
"5914",1903,"30",39393,37042,76435
"5915",1903,"31",35758,33697,69455
"5916",1903,"32",36073,34322,70395
"5917",1903,"33",35281,33179,68460
"5918",1903,"34",34710,32691,67401
"5919",1903,"35",34219,33120,67339
"5920",1903,"36",33970,32774,66744
"5921",1903,"37",33157,31679,64836
"5922",1903,"38",32649,31335,63984
"5923",1903,"39",32738,31782,64520
"5924",1903,"40",29084,28559,57643
"5925",1903,"41",29054,28575,57629
"5926",1903,"42",26640,26218,52858
"5927",1903,"43",27456,26944,54400
"5928",1903,"44",24894,24355,49249
"5929",1903,"45",25497,24929,50426
"5930",1903,"46",24887,24422,49309
"5931",1903,"47",23180,23136,46316
"5932",1903,"48",23830,23128,46958
"5933",1903,"49",23185,22778,45963
"5934",1903,"50",24539,23629,48168
"5935",1903,"51",22887,22327,45214
"5936",1903,"52",23179,22795,45974
"5937",1903,"53",23624,22342,45966
"5938",1903,"54",19702,19017,38719
"5939",1903,"55",17893,16872,34765
"5940",1903,"56",18331,17203,35534
"5941",1903,"57",19897,18825,38722
"5942",1903,"58",20084,19042,39126
"5943",1903,"59",18668,17705,36373
"5944",1903,"60",18873,17532,36405
"5945",1903,"61",17518,16998,34516
"5946",1903,"62",18384,16778,35162
"5947",1903,"63",17629,16047,33676
"5948",1903,"64",16801,15395,32196
"5949",1903,"65",15173,13904,29077
"5950",1903,"66",15151,13707,28858
"5951",1903,"67",13959,12590,26549
"5952",1903,"68",13222,11621,24843
"5953",1903,"69",12630,11189,23819
"5954",1903,"70",10586,9271,19857
"5955",1903,"71",9746,8752,18498
"5956",1903,"72",10534,8721,19255
"5957",1903,"73",9344,8011,17355
"5958",1903,"74",8141,6993,15134
"5959",1903,"75",7271,6072,13343
"5960",1903,"76",7051,5660,12711
"5961",1903,"77",6490,5300,11790
"5962",1903,"78",6024,4929,10953
"5963",1903,"79",5183,4136,9319
"5964",1903,"80",4415.54,3593,8008.54
"5965",1903,"81",3740,2912,6652
"5966",1903,"82",2920,2237,5157
"5967",1903,"83",2468,1858,4326
"5968",1903,"84",1926,1511,3437
"5969",1903,"85",1544,1138,2682
"5970",1903,"86",1193,903,2096
"5971",1903,"87",1064,651,1715
"5972",1903,"88",690,458,1148
"5973",1903,"89",501,368,869
"5974",1903,"90",387,238,625
"5975",1903,"91",281,156,437
"5976",1903,"92",165,107,272
"5977",1903,"93",107,59,166
"5978",1903,"94",70,28,98
"5979",1903,"95",40,19,59
"5980",1903,"96",34,20,54
"5981",1903,"97",27,9,36
"5982",1903,"98",7,5,12
"5983",1903,"99",8,3,11
"5984",1903,"100",1,3,4
"5985",1903,"101",0,1,1
"5986",1903,"102",0,1,1
"5987",1903,"103",0.79,0,0.79
"5988",1903,"104",0.21,0,0.21
"5989",1903,"105",0,0,0
"5990",1903,"106",0,0,0
"5991",1903,"107",0,0,0
"5992",1903,"108",0,0,0
"5993",1903,"109",0,0,0
"5994",1903,"110+",0,0,0
"5995",1904,"0",75760,78337,154097
"5996",1904,"1",70871,73186,144057
"5997",1904,"2",67832,69045,136877
"5998",1904,"3",63807,65052,128859
"5999",1904,"4",63944,64823,128767
"6000",1904,"5",62594,63813,126407
"6001",1904,"6",63123,63679,126802
"6002",1904,"7",62207,63454,125661
"6003",1904,"8",59831,60710,120541
"6004",1904,"9",59033,59830,118863
"6005",1904,"10",58952,59631,118583
"6006",1904,"11",55128,55644,110772
"6007",1904,"12",55811,56240,112051
"6008",1904,"13",53389,53580,106969
"6009",1904,"14",53125,53293,106418
"6010",1904,"15",53025,53408,106433
"6011",1904,"16",51955,52474,104429
"6012",1904,"17",51796,51205,103001
"6013",1904,"18",50698,50495,101193
"6014",1904,"19",49213,49042,98255
"6015",1904,"20",47215,46688,93903
"6016",1904,"21",48040,47119,95159
"6017",1904,"22",45771,45174,90945
"6018",1904,"23",45482,43786,89268
"6019",1904,"24",46375,44574,90949
"6020",1904,"25",44435,43112,87547
"6021",1904,"26",44156,42415,86571
"6022",1904,"27",43786,41730,85516
"6023",1904,"28",41590,39466,81056
"6024",1904,"29",41054,38903,79957
"6025",1904,"30",40238,37852,78090
"6026",1904,"31",39104,36811,75915
"6027",1904,"32",35572,33545,69117
"6028",1904,"33",35845,34150,69995
"6029",1904,"34",35004,32994,67998
"6030",1904,"35",34438,32507,66945
"6031",1904,"36",33969,32923,66892
"6032",1904,"37",33734,32553,66287
"6033",1904,"38",32940,31488,64428
"6034",1904,"39",32428,31141,63569
"6035",1904,"40",32456,31541,63997
"6036",1904,"41",28859,28319,57178
"6037",1904,"42",28826,28374,57200
"6038",1904,"43",26429,25993,52422
"6039",1904,"44",27241,26722,53963
"6040",1904,"45",24722,24140,48862
"6041",1904,"46",25302,24689,49991
"6042",1904,"47",24675,24149,48824
"6043",1904,"48",22964,22829,45793
"6044",1904,"49",23616,22848,46464
"6045",1904,"50",22944,22537,45481
"6046",1904,"51",24248,23325,47573
"6047",1904,"52",22671,22024,44695
"6048",1904,"53",22888,22490,45378
"6049",1904,"54",23298,21958,45256
"6050",1904,"55",19451,18696,38147
"6051",1904,"56",17628,16584,34212
"6052",1904,"57",18031,16892,34923
"6053",1904,"58",19587,18440,38027
"6054",1904,"59",19707,18646,38353
"6055",1904,"60",18324,17333,35657
"6056",1904,"61",18445,17094,35539
"6057",1904,"62",17140,16590,33730
"6058",1904,"63",17910,16262,34172
"6059",1904,"64",17140,15563,32703
"6060",1904,"65",16314,14871,31185
"6061",1904,"66",14677,13373,28050
"6062",1904,"67",14635,13115,27750
"6063",1904,"68",13410,12034,25444
"6064",1904,"69",12637,11030,23667
"6065",1904,"70",12024,10568,22592
"6066",1904,"71",10018,8716,18734
"6067",1904,"72",9254,8205,17459
"6068",1904,"73",9884,8132,18016
"6069",1904,"74",8730,7428,16158
"6070",1904,"75",7574,6402,13976
"6071",1904,"76",6665,5510,12175
"6072",1904,"77",6435,5108,11543
"6073",1904,"78",5892,4742,10634
"6074",1904,"79",5385,4388,9773
"6075",1904,"80",4546.46,3579,8125.46
"6076",1904,"81",3886.54,3144,7030.54
"6077",1904,"82",3259,2494,5753
"6078",1904,"83",2498,1879,4377
"6079",1904,"84",2090,1528,3618
"6080",1904,"85",1581,1224,2805
"6081",1904,"86",1275,888,2163
"6082",1904,"87",955,707,1662
"6083",1904,"88",830,503,1333
"6084",1904,"89",531,330,861
"6085",1904,"90",381,268,649
"6086",1904,"91",291,181,472
"6087",1904,"92",212,113,325
"6088",1904,"93",115,78,193
"6089",1904,"94",72,38,110
"6090",1904,"95",41,13,54
"6091",1904,"96",31,12,43
"6092",1904,"97",21,10,31
"6093",1904,"98",16,7,23
"6094",1904,"99",3,3,6
"6095",1904,"100",6,2,8
"6096",1904,"101",0,2,2
"6097",1904,"102",0,1,1
"6098",1904,"103",0,0,0
"6099",1904,"104",0.79,0,0.79
"6100",1904,"105",0.21,0,0.21
"6101",1904,"106",0,0,0
"6102",1904,"107",0,0,0
"6103",1904,"108",0,0,0
"6104",1904,"109",0,0,0
"6105",1904,"110+",0,0,0
"6106",1905,"0",76442,79003,155445
"6107",1905,"1",70507,72287,142794
"6108",1905,"2",69121,71205,140326
"6109",1905,"3",67009,68140,135149
"6110",1905,"4",63349,64520,127869
"6111",1905,"5",63563,64403,127966
"6112",1905,"6",62231,63498,125729
"6113",1905,"7",62852,63409,126261
"6114",1905,"8",62008,63228,125236
"6115",1905,"9",59656,60564,120220
"6116",1905,"10",58841,59664,118505
"6117",1905,"11",58798,59487,118285
"6118",1905,"12",54950,55491,110441
"6119",1905,"13",55633,56035,111668
"6120",1905,"14",53177,53331,106508
"6121",1905,"15",52849,52904,105753
"6122",1905,"16",52722,52973,105695
"6123",1905,"17",51579,51961,103540
"6124",1905,"18",51458,50624,102082
"6125",1905,"19",50352,49922,100274
"6126",1905,"20",48859,48411,97270
"6127",1905,"21",46904,46126,93030
"6128",1905,"22",47700,46561,94261
"6129",1905,"23",45470,44629,90099
"6130",1905,"24",45162,43305,88467
"6131",1905,"25",46043,44101,90144
"6132",1905,"26",44089,42714,86803
"6133",1905,"27",43829,42045,85874
"6134",1905,"28",43484,41380,84864
"6135",1905,"29",41346,39217,80563
"6136",1905,"30",40746,38645,79391
"6137",1905,"31",40001,37667,77668
"6138",1905,"32",38796,36589,75385
"6139",1905,"33",35385,33397,68782
"6140",1905,"34",35640,33947,69587
"6141",1905,"35",34724,32808,67532
"6142",1905,"36",34197,32314,66511
"6143",1905,"37",33681,32710,66391
"6144",1905,"38",33524,32328,65852
"6145",1905,"39",32681,31299,63980
"6146",1905,"40",32176,30943,63119
"6147",1905,"41",32152,31310,63462
"6148",1905,"42",28641,28082,56723
"6149",1905,"43",28603,28129,56732
"6150",1905,"44",26232,25771,52003
"6151",1905,"45",27017,26493,53510
"6152",1905,"46",24514,23887,48401
"6153",1905,"47",25067,24435,49502
"6154",1905,"48",24435,23888,48323
"6155",1905,"49",22795,22572,45367
"6156",1905,"50",23355,22551,45906
"6157",1905,"51",22709,22258,44967
"6158",1905,"52",23962,22980,46942
"6159",1905,"53",22405,21736,44141
"6160",1905,"54",22592,22128,44720
"6161",1905,"55",22942,21592,44534
"6162",1905,"56",19200,18372,37572
"6163",1905,"57",17337,16268,33605
"6164",1905,"58",17714,16546,34260
"6165",1905,"59",19262,18040,37302
"6166",1905,"60",19347,18210,37557
"6167",1905,"61",17925,16914,34839
"6168",1905,"62",18016,16582,34598
"6169",1905,"63",16764,16156,32920
"6170",1905,"64",17419,15760,33179
"6171",1905,"65",16622,15034,31656
"6172",1905,"66",15772,14323,30095
"6173",1905,"67",14133,12800,26933
"6174",1905,"68",13985,12553,26538
"6175",1905,"69",12813,11454,24267
"6176",1905,"70",12011,10422,22433
"6177",1905,"71",11404,9969,21373
"6178",1905,"72",9433,8192,17625
"6179",1905,"73",8657,7660,16317
"6180",1905,"74",9226,7527,16753
"6181",1905,"75",8043,6819,14862
"6182",1905,"76",6945,5831,12776
"6183",1905,"77",6059,4961,11020
"6184",1905,"78",5786,4550,10336
"6185",1905,"79",5282,4191,9473
"6186",1905,"80",4763,3806,8569
"6187",1905,"81",3974.46,3070,7044.46
"6188",1905,"82",3359.54,2677,6036.54
"6189",1905,"83",2771,2096,4867
"6190",1905,"84",2113,1549,3662
"6191",1905,"85",1736,1239,2975
"6192",1905,"86",1274,989,2263
"6193",1905,"87",1020,698,1718
"6194",1905,"88",750,539,1289
"6195",1905,"89",658,386,1044
"6196",1905,"90",405,262,667
"6197",1905,"91",287,192,479
"6198",1905,"92",201,128,329
"6199",1905,"93",137,71,208
"6200",1905,"94",75,50,125
"6201",1905,"95",52,22,74
"6202",1905,"96",29,8,37
"6203",1905,"97",21,8,29
"6204",1905,"98",11,6,17
"6205",1905,"99",11,4,15
"6206",1905,"100",2,3,5
"6207",1905,"101",5,1,6
"6208",1905,"102",0,2,2
"6209",1905,"103",0,1,1
"6210",1905,"104",0,0,0
"6211",1905,"105",0.79,0,0.79
"6212",1905,"106",0.21,0,0.21
"6213",1905,"107",0,0,0
"6214",1905,"108",0,0,0
"6215",1905,"109",0,0,0
"6216",1905,"110+",0,0,0
"6217",1906,"0",76607,78921,155528
"6218",1906,"1",71798,73511,145309
"6219",1906,"2",69045,70679,139724
"6220",1906,"3",68366,70411,138777
"6221",1906,"4",66539,67596,134135
"6222",1906,"5",63037,64215,127252
"6223",1906,"6",63261,64128,127389
"6224",1906,"7",61962,63203,125165
"6225",1906,"8",62632,63196,125828
"6226",1906,"9",61815,63052,124867
"6227",1906,"10",59502,60426,119928
"6228",1906,"11",58656,59531,118187
"6229",1906,"12",58646,59358,118004
"6230",1906,"13",54755,55327,110082
"6231",1906,"14",55449,55834,111283
"6232",1906,"15",52977,53084,106061
"6233",1906,"16",52559,52519,105078
"6234",1906,"17",52417,52521,104938
"6235",1906,"18",51222,51412,102634
"6236",1906,"19",51130,50027,101157
"6237",1906,"20",50014,49333,99347
"6238",1906,"21",48470,47758,96228
"6239",1906,"22",46552,45524,92076
"6240",1906,"23",47394,45987,93381
"6241",1906,"24",45174,44089,89263
"6242",1906,"25",44842,42825,87667
"6243",1906,"26",45714,43661,89375
"6244",1906,"27",43736,42302,86038
"6245",1906,"28",43543,41711,85254
"6246",1906,"29",43146,41035,84181
"6247",1906,"30",41084,38972,80056
"6248",1906,"31",40425,38405,78830
"6249",1906,"32",39731,37484,77215
"6250",1906,"33",38490,36366,74856
"6251",1906,"34",35176,33232,68408
"6252",1906,"35",35410,33767,69177
"6253",1906,"36",34466,32611,67077
"6254",1906,"37",33952,32109,66061
"6255",1906,"38",33462,32504,65966
"6256",1906,"39",33304,32119,65423
"6257",1906,"40",32466,31106,63572
"6258",1906,"41",31908,30736,62644
"6259",1906,"42",31904,31071,62975
"6260",1906,"43",28423,27870,56293
"6261",1906,"44",28391,27898,56289
"6262",1906,"45",26028,25535,51563
"6263",1906,"46",26792,26240,53032
"6264",1906,"47",24304,23657,47961
"6265",1906,"48",24861,24176,49037
"6266",1906,"49",24167,23626,47793
"6267",1906,"50",22582,22319,44901
"6268",1906,"51",23094,22274,45368
"6269",1906,"52",22491,21993,44484
"6270",1906,"53",23638,22678,46316
"6271",1906,"54",22139,21413,43552
"6272",1906,"55",22269,21798,44067
"6273",1906,"56",22591,21217,43808
"6274",1906,"57",18915,17999,36914
"6275",1906,"58",16996,15928,32924
"6276",1906,"59",17397,16176,33573
"6277",1906,"60",18881,17613,36494
"6278",1906,"61",18943,17741,36684
"6279",1906,"62",17497,16431,33928
"6280",1906,"63",17511,16100,33611
"6281",1906,"64",16318,15635,31953
"6282",1906,"65",16865,15216,32081
"6283",1906,"66",16023,14451,30474
"6284",1906,"67",15222,13756,28978
"6285",1906,"68",13581,12211,25792
"6286",1906,"69",13360,11947,25307
"6287",1906,"70",12147,10870,23017
"6288",1906,"71",11355,9786,21141
"6289",1906,"72",10762,9351,20113
"6290",1906,"73",8836,7630,16466
"6291",1906,"74",8083,6980,15063
"6292",1906,"75",8512,6922,15434
"6293",1906,"76",7379,6183,13562
"6294",1906,"77",6361,5218,11579
"6295",1906,"78",5463,4421,9884
"6296",1906,"79",5136,3987,9123
"6297",1906,"80",4627,3685,8312
"6298",1906,"81",4095,3255,7350
"6299",1906,"82",3409.46,2586,5995.46
"6300",1906,"83",2817.54,2230,5047.54
"6301",1906,"84",2338,1733,4071
"6302",1906,"85",1704,1252,2956
"6303",1906,"86",1384,978,2362
"6304",1906,"87",1020,776,1796
"6305",1906,"88",813,534,1347
"6306",1906,"89",578,395,973
"6307",1906,"90",495,284,779
"6308",1906,"91",296,179,475
"6309",1906,"92",205,142,347
"6310",1906,"93",143,85,228
"6311",1906,"94",94,45,139
"6312",1906,"95",51,34,85
"6313",1906,"96",35,13,48
"6314",1906,"97",21,3,24
"6315",1906,"98",15,2,17
"6316",1906,"99",5,4,9
"6317",1906,"100",7,2,9
"6318",1906,"101",2,3,5
"6319",1906,"102",4,1,5
"6320",1906,"103",0,0,0
"6321",1906,"104",0,1,1
"6322",1906,"105",0,0,0
"6323",1906,"106",0,0,0
"6324",1906,"107",0,0,0
"6325",1906,"108",0,0,0
"6326",1906,"109",0,0,0
"6327",1906,"110+",0,0,0
"6328",1907,"0",76938,78691,155629
"6329",1907,"1",72054,73734,145788
"6330",1907,"2",70348,71993,142341
"6331",1907,"3",68409,69986,138395
"6332",1907,"4",67892,69926,137818
"6333",1907,"5",66194,67210,133404
"6334",1907,"6",62771,63962,126733
"6335",1907,"7",63053,63919,126972
"6336",1907,"8",61718,62960,124678
"6337",1907,"9",62433,62999,125432
"6338",1907,"10",61658,62911,124569
"6339",1907,"11",59355,60330,119685
"6340",1907,"12",58487,59380,117867
"6341",1907,"13",58496,59236,117732
"6342",1907,"14",54542,55163,109705
"6343",1907,"15",55255,55627,110882
"6344",1907,"16",52763,52797,105560
"6345",1907,"17",52250,52091,104341
"6346",1907,"18",52079,52022,104101
"6347",1907,"19",50838,50865,101703
"6348",1907,"20",50813,49409,100222
"6349",1907,"21",49668,48744,98412
"6350",1907,"22",48107,47145,95252
"6351",1907,"23",46197,44961,91158
"6352",1907,"24",47051,45446,92497
"6353",1907,"25",44877,43586,88463
"6354",1907,"26",44525,42401,86926
"6355",1907,"27",45365,43216,88581
"6356",1907,"28",43388,41886,85274
"6357",1907,"29",43243,41381,84624
"6358",1907,"30",42822,40699,83521
"6359",1907,"31",40834,38742,79576
"6360",1907,"32",40080,38155,78235
"6361",1907,"33",39473,37296,76769
"6362",1907,"34",38159,36155,74314
"6363",1907,"35",34948,33091,68039
"6364",1907,"36",35174,33557,68731
"6365",1907,"37",34196,32414,66610
"6366",1907,"38",33687,31922,65609
"6367",1907,"39",33188,32293,65481
"6368",1907,"40",33046,31928,64974
"6369",1907,"41",32220,30902,63122
"6370",1907,"42",31662,30529,62191
"6371",1907,"43",31620,30798,62418
"6372",1907,"44",28188,27643,55831
"6373",1907,"45",28203,27667,55870
"6374",1907,"46",25828,25314,51142
"6375",1907,"47",26558,25991,52549
"6376",1907,"48",24103,23412,47515
"6377",1907,"49",24614,23923,48537
"6378",1907,"50",23920,23368,47288
"6379",1907,"51",22367,22059,44426
"6380",1907,"52",22820,21958,44778
"6381",1907,"53",22244,21709,43953
"6382",1907,"54",23338,22344,45682
"6383",1907,"55",21892,21098,42990
"6384",1907,"56",21989,21412,43401
"6385",1907,"57",22222,20820,43042
"6386",1907,"58",18602,17620,36222
"6387",1907,"59",16706,15573,32279
"6388",1907,"60",17068,15817,32885
"6389",1907,"61",18444,17218,35662
"6390",1907,"62",18519,17272,35791
"6391",1907,"63",17052,15935,32987
"6392",1907,"64",17058,15543,32601
"6393",1907,"65",15855,15087,30942
"6394",1907,"66",16342,14641,30983
"6395",1907,"67",15476,13882,29358
"6396",1907,"68",14639,13133,27772
"6397",1907,"69",12971,11678,24649
"6398",1907,"70",12725,11313,24038
"6399",1907,"71",11524,10282,21806
"6400",1907,"72",10692,9203,19895
"6401",1907,"73",10124,8746,18870
"6402",1907,"74",8214,7057,15271
"6403",1907,"75",7467,6416,13883
"6404",1907,"76",7873,6323,14196
"6405",1907,"77",6737,5564,12301
"6406",1907,"78",5719,4651,10370
"6407",1907,"79",4917,3944,8861
"6408",1907,"80",4567,3488,8055
"6409",1907,"81",4053,3178,7231
"6410",1907,"82",3527,2789,6316
"6411",1907,"83",2902.46,2195,5097.46
"6412",1907,"84",2349.54,1858,4207.54
"6413",1907,"85",1938,1422,3360
"6414",1907,"86",1395,987,2382
"6415",1907,"87",1108,779,1887
"6416",1907,"88",817,613,1430
"6417",1907,"89",652,404,1056
"6418",1907,"90",427,290,717
"6419",1907,"91",364,191,555
"6420",1907,"92",212,127,339
"6421",1907,"93",139,90,229
"6422",1907,"94",97,65,162
"6423",1907,"95",60,29,89
"6424",1907,"96",34,20,54
"6425",1907,"97",23,10,33
"6426",1907,"98",12,3,15
"6427",1907,"99",11,0,11
"6428",1907,"100",4,3,7
"6429",1907,"101",4,2,6
"6430",1907,"102",2,1,3
"6431",1907,"103",1,0,1
"6432",1907,"104",0,0,0
"6433",1907,"105",0,0,0
"6434",1907,"106",0,0,0
"6435",1907,"107",0,0,0
"6436",1907,"108",0,0,0
"6437",1907,"109",0,0,0
"6438",1907,"110+",0,0,0
"6439",1908,"0",78172,80451,158623
"6440",1908,"1",72611,73692,146303
"6441",1908,"2",70692,72186,142878
"6442",1908,"3",69661,71167,140828
"6443",1908,"4",67923,69477,137400
"6444",1908,"5",67562,69528,137090
"6445",1908,"6",65884,66862,132746
"6446",1908,"7",62582,63778,126360
"6447",1908,"8",62844,63734,126578
"6448",1908,"9",61500,62765,124265
"6449",1908,"10",62254,62815,125069
"6450",1908,"11",61532,62779,124311
"6451",1908,"12",59223,60220,119443
"6452",1908,"13",58307,59238,117545
"6453",1908,"14",58323,59114,117437
"6454",1908,"15",54325,55004,109329
"6455",1908,"16",55029,55410,110439
"6456",1908,"17",52562,52516,105078
"6457",1908,"18",51934,51667,103601
"6458",1908,"19",51760,51551,103311
"6459",1908,"20",50474,50294,100768
"6460",1908,"21",50482,48827,99309
"6461",1908,"22",49326,48152,97478
"6462",1908,"23",47758,46559,94317
"6463",1908,"24",45869,44392,90261
"6464",1908,"25",46724,44920,91644
"6465",1908,"26",44584,43085,87669
"6466",1908,"27",44202,41975,86177
"6467",1908,"28",45035,42810,87845
"6468",1908,"29",43052,41488,84540
"6469",1908,"30",42941,41039,83980
"6470",1908,"31",42484,40396,82880
"6471",1908,"32",40563,38528,79091
"6472",1908,"33",39762,37902,77664
"6473",1908,"34",39216,37104,76320
"6474",1908,"35",37879,35934,73813
"6475",1908,"36",34741,32946,67687
"6476",1908,"37",34937,33354,68291
"6477",1908,"38",33885,32223,66108
"6478",1908,"39",33476,31680,65156
"6479",1908,"40",32912,32089,65001
"6480",1908,"41",32831,31718,64549
"6481",1908,"42",31990,30695,62685
"6482",1908,"43",31414,30324,61738
"6483",1908,"44",31339,30553,61892
"6484",1908,"45",27963,27392,55355
"6485",1908,"46",27982,27411,55393
"6486",1908,"47",25611,25109,50720
"6487",1908,"48",26315,25720,52035
"6488",1908,"49",23898,23135,47033
"6489",1908,"50",24380,23622,48002
"6490",1908,"51",23659,23087,46746
"6491",1908,"52",22147,21785,43932
"6492",1908,"53",22545,21651,44196
"6493",1908,"54",21959,21374,43333
"6494",1908,"55",23014,21978,44992
"6495",1908,"56",21574,20755,42329
"6496",1908,"57",21593,21031,42624
"6497",1908,"58",21804,20373,42177
"6498",1908,"59",18264,17218,35482
"6499",1908,"60",16326,15193,31519
"6500",1908,"61",16655,15406,32061
"6501",1908,"62",17989,16736,34725
"6502",1908,"63",18040,16734,34774
"6503",1908,"64",16542,15419,31961
"6504",1908,"65",16521,14989,31510
"6505",1908,"66",15356,14493,29849
"6506",1908,"67",15755,14010,29765
"6507",1908,"68",14825,13231,28056
"6508",1908,"69",13973,12476,26449
"6509",1908,"70",12359,10999,23358
"6510",1908,"71",12004,10686,22690
"6511",1908,"72",10843,9594,20437
"6512",1908,"73",9968,8567,18535
"6513",1908,"74",9393,8060,17453
"6514",1908,"75",7582,6505,14087
"6515",1908,"76",6852,5820,12672
"6516",1908,"77",7056,5701,12757
"6517",1908,"78",6065,4934,10999
"6518",1908,"79",5074,4069,9143
"6519",1908,"80",4278,3368,7646
"6520",1908,"81",3961,2942,6903
"6521",1908,"82",3483,2667,6150
"6522",1908,"83",2979,2280,5259
"6523",1908,"84",2395.46,1790,4185.46
"6524",1908,"85",1893.54,1491,3384.54
"6525",1908,"86",1538,1095,2633
"6526",1908,"87",1101,765,1866
"6527",1908,"88",829,608,1437
"6528",1908,"89",626,447,1073
"6529",1908,"90",478,282,760
"6530",1908,"91",310,200,510
"6531",1908,"92",251,143,394
"6532",1908,"93",148,77,225
"6533",1908,"94",96,57,153
"6534",1908,"95",60,44,104
"6535",1908,"96",41,14,55
"6536",1908,"97",26,12,38
"6537",1908,"98",10,5,15
"6538",1908,"99",7,1,8
"6539",1908,"100",5,0,5
"6540",1908,"101",1,0,1
"6541",1908,"102",1,2,3
"6542",1908,"103",2,1,3
"6543",1908,"104",0,0,0
"6544",1908,"105",0,0,0
"6545",1908,"106",0,0,0
"6546",1908,"107",0,0,0
"6547",1908,"108",0,0,0
"6548",1908,"109",0,0,0
"6549",1908,"110+",0,0,0
"6550",1909,"0",77564,80219,157783
"6551",1909,"1",73416,74939,148355
"6552",1909,"2",70959,72018,142977
"6553",1909,"3",69962,71418,141380
"6554",1909,"4",69168,70575,139743
"6555",1909,"5",67514,69048,136562
"6556",1909,"6",67264,69210,136474
"6557",1909,"7",65623,66563,132186
"6558",1909,"8",62397,63606,126003
"6559",1909,"9",62660,63581,126241
"6560",1909,"10",61306,62572,123878
"6561",1909,"11",62078,62642,124720
"6562",1909,"12",61383,62641,124024
"6563",1909,"13",59097,60148,119245
"6564",1909,"14",58134,59096,117230
"6565",1909,"15",58140,58967,117107
"6566",1909,"16",54077,54811,108888
"6567",1909,"17",54835,55186,110021
"6568",1909,"18",52371,52211,104582
"6569",1909,"19",51642,51199,102841
"6570",1909,"20",51459,51040,102499
"6571",1909,"21",50095,49714,99809
"6572",1909,"22",50139,48232,98371
"6573",1909,"23",48978,47576,96554
"6574",1909,"24",47413,45963,93376
"6575",1909,"25",45531,43823,89354
"6576",1909,"26",46398,44380,90778
"6577",1909,"27",44267,42591,86858
"6578",1909,"28",43900,41562,85462
"6579",1909,"29",44722,42417,87139
"6580",1909,"30",42723,41097,83820
"6581",1909,"31",42644,40681,83325
"6582",1909,"32",42155,40101,82256
"6583",1909,"33",40298,38297,78595
"6584",1909,"34",39455,37655,77110
"6585",1909,"35",38957,36906,75863
"6586",1909,"36",37604,35709,73313
"6587",1909,"37",34511,32797,67308
"6588",1909,"38",34699,33162,67861
"6589",1909,"39",33595,32036,65631
"6590",1909,"40",33228,31483,64711
"6591",1909,"41",32655,31852,64507
"6592",1909,"42",32602,31512,64114
"6593",1909,"43",31759,30538,62297
"6594",1909,"44",31178,30080,61258
"6595",1909,"45",31043,30320,61363
"6596",1909,"46",27738,27159,54897
"6597",1909,"47",27774,27177,54951
"6598",1909,"48",25390,24880,50270
"6599",1909,"49",26081,25433,51514
"6600",1909,"50",23675,22886,46561
"6601",1909,"51",24108,23342,47450
"6602",1909,"52",23372,22803,46175
"6603",1909,"53",21886,21469,43355
"6604",1909,"54",22246,21313,43559
"6605",1909,"55",21693,21043,42736
"6606",1909,"56",22677,21618,44295
"6607",1909,"57",21263,20406,41669
"6608",1909,"58",21236,20620,41856
"6609",1909,"59",21365,19914,41279
"6610",1909,"60",17867,16810,34677
"6611",1909,"61",15949,14781,30730
"6612",1909,"62",16266,15011,31277
"6613",1909,"63",17482,16269,33751
"6614",1909,"64",17517,16162,33679
"6615",1909,"65",16037,14855,30892
"6616",1909,"66",15964,14412,30376
"6617",1909,"67",14774,13863,28637
"6618",1909,"68",15104,13370,28474
"6619",1909,"69",14163,12567,26730
"6620",1909,"70",13293,11805,25098
"6621",1909,"71",11753,10336,22089
"6622",1909,"72",11234,9936,21170
"6623",1909,"73",10108,8891,18999
"6624",1909,"74",9188,7909,17097
"6625",1909,"75",8655,7368,16023
"6626",1909,"76",6939,5911,12850
"6627",1909,"77",6124,5176,11300
"6628",1909,"78",6294,5063,11357
"6629",1909,"79",5281,4311,9592
"6630",1909,"80",4452.25,3581,8033.25
"6631",1909,"81",3699,2870,6569
"6632",1909,"82",3375,2483,5858
"6633",1909,"83",2921,2193,5114
"6634",1909,"84",2428,1852,4280
"6635",1909,"85",1921.46,1424,3345.46
"6636",1909,"86",1493.54,1168,2661.54
"6637",1909,"87",1196,835,2031
"6638",1909,"88",830,583,1413
"6639",1909,"89",627,437,1064
"6640",1909,"90",474,334,808
"6641",1909,"91",326,189,515
"6642",1909,"92",212,140,352
"6643",1909,"93",173,104,277
"6644",1909,"94",91,39,130
"6645",1909,"95",60,40,100
"6646",1909,"96",34,19,53
"6647",1909,"97",21,7,28
"6648",1909,"98",16,9,25
"6649",1909,"99",2,3,5
"6650",1909,"100",1,1,2
"6651",1909,"101",2,0,2
"6652",1909,"102",1,0,1
"6653",1909,"103",1,0,1
"6654",1909,"104",0,0,0
"6655",1909,"105",0,0,0
"6656",1909,"106",0,0,0
"6657",1909,"107",0,0,0
"6658",1909,"108",0,0,0
"6659",1909,"109",0,0,0
"6660",1909,"110+",0,0,0
"6661",1910,"0",78785,81110,159895
"6662",1910,"1",73929,75768,149697
"6663",1910,"2",72194,73587,145781
"6664",1910,"3",70409,71449,141858
"6665",1910,"4",69621,71023,140644
"6666",1910,"5",68890,70258,139148
"6667",1910,"6",67299,68821,136120
"6668",1910,"7",67102,69002,136104
"6669",1910,"8",65489,66399,131888
"6670",1910,"9",62328,63475,125803
"6671",1910,"10",62535,63389,125924
"6672",1910,"11",61195,62401,123596
"6673",1910,"12",61947,62453,124400
"6674",1910,"13",61253,62443,123696
"6675",1910,"14",58972,59963,118935
"6676",1910,"15",57975,58878,116853
"6677",1910,"16",57960,58696,116656
"6678",1910,"17",53870,54519,108389
"6679",1910,"18",54647,54897,109544
"6680",1910,"19",52213,51871,104084
"6681",1910,"20",51403,50766,102169
"6682",1910,"21",51199,50616,101815
"6683",1910,"22",49829,49288,99117
"6684",1910,"23",49871,47841,97712
"6685",1910,"24",48719,47215,95934
"6686",1910,"25",47161,45585,92746
"6687",1910,"26",45273,43475,88748
"6688",1910,"27",46160,44031,90191
"6689",1910,"28",44039,42264,86303
"6690",1910,"29",43662,41294,84956
"6691",1910,"30",44462,42164,86626
"6692",1910,"31",42498,40849,83347
"6693",1910,"32",42388,40475,82863
"6694",1910,"33",41899,39888,81787
"6695",1910,"34",40103,38124,78227
"6696",1910,"35",39203,37446,76649
"6697",1910,"36",38741,36752,75493
"6698",1910,"37",37338,35516,72854
"6699",1910,"38",34303,32654,66957
"6700",1910,"39",34491,33000,67491
"6701",1910,"40",33337,31815,65152
"6702",1910,"41",33023,31273,64296
"6703",1910,"42",32405,31649,64054
"6704",1910,"43",32416,31329,63745
"6705",1910,"44",31509,30327,61836
"6706",1910,"45",30981,29827,60808
"6707",1910,"46",30777,30021,60798
"6708",1910,"47",27513,26923,54436
"6709",1910,"48",27551,26957,54508
"6710",1910,"49",25177,24627,49804
"6711",1910,"50",25821,25138,50959
"6712",1910,"51",23433,22612,46045
"6713",1910,"52",23836,23053,46889
"6714",1910,"53",23068,22260,45328
"6715",1910,"54",21634,21161,42795
"6716",1910,"55",21953,20992,42945
"6717",1910,"56",21385,20699,42084
"6718",1910,"57",22334,21173,43507
"6719",1910,"58",20938,20038,40976
"6720",1910,"59",20901,20165,41066
"6721",1910,"60",20927,19426,40353
"6722",1910,"61",17473,16378,33851
"6723",1910,"62",15611,14348,29959
"6724",1910,"63",15849,14566,30415
"6725",1910,"64",16985,15775,32760
"6726",1910,"65",16965,15602,32567
"6727",1910,"66",15477,14303,29780
"6728",1910,"67",15345,13804,29149
"6729",1910,"68",14187,13204,27391
"6730",1910,"69",14450,12716,27166
"6731",1910,"70",13471,11860,25331
"6732",1910,"71",12585,11117,23702
"6733",1910,"72",11086,9691,20777
"6734",1910,"73",10490,9213,19703
"6735",1910,"74",9362,8191,17553
"6736",1910,"75",8462,7216,15678
"6737",1910,"76",7909,6675,14584
"6738",1910,"77",6318,5338,11656
"6739",1910,"78",5477,4617,10094
"6740",1910,"79",5631,4471,10102
"6741",1910,"80",4711.75,3726,8437.75
"6742",1910,"81",3834.25,3037,6871.25
"6743",1910,"82",3167,2455,5622
"6744",1910,"83",2832,2098,4930
"6745",1910,"84",2460,1801,4261
"6746",1910,"85",2003,1495,3498
"6747",1910,"86",1538.46,1117,2655.46
"6748",1910,"87",1187.54,911,2098.54
"6749",1910,"88",926,637,1563
"6750",1910,"89",607,433,1040
"6751",1910,"90",469,308,777
"6752",1910,"91",336,233,569
"6753",1910,"92",246,131,377
"6754",1910,"93",145,98,243
"6755",1910,"94",113,66,179
"6756",1910,"95",57,20,77
"6757",1910,"96",43,27,70
"6758",1910,"97",23,11,34
"6759",1910,"98",13,6,19
"6760",1910,"99",10,2,12
"6761",1910,"100",1,3,4
"6762",1910,"101",1,1,2
"6763",1910,"102",0,0,0
"6764",1910,"103",1,0,1
"6765",1910,"104",1,0,1
"6766",1910,"105",0,0,0
"6767",1910,"106",0,0,0
"6768",1910,"107",0,0,0
"6769",1910,"108",0,0,0
"6770",1910,"109",0,0,0
"6771",1910,"110+",0,0,0
"6772",1911,"0",77033,80145,157178
"6773",1911,"1",74791,76535,151326
"6774",1911,"2",72777,74530,147307
"6775",1911,"3",71715,73115,144830
"6776",1911,"4",70179,71197,141376
"6777",1911,"5",69490,70830,140320
"6778",1911,"6",68784,70143,138927
"6779",1911,"7",67221,68721,135942
"6780",1911,"8",67042,68922,135964
"6781",1911,"9",65463,66315,131778
"6782",1911,"10",62327,63387,125714
"6783",1911,"11",62462,63214,125676
"6784",1911,"12",61164,62227,123391
"6785",1911,"13",61860,62223,124083
"6786",1911,"14",61155,62150,123305
"6787",1911,"15",58840,59660,118500
"6788",1911,"16",57823,58556,116379
"6789",1911,"17",57804,58337,116141
"6790",1911,"18",53729,54111,107840
"6791",1911,"19",54459,54513,108972
"6792",1911,"20",52052,51511,103563
"6793",1911,"21",51209,50429,101638
"6794",1911,"22",51006,50309,101315
"6795",1911,"23",49663,49048,98711
"6796",1911,"24",49678,47632,97310
"6797",1911,"25",48558,47019,95577
"6798",1911,"26",47025,45436,92461
"6799",1911,"27",45137,43324,88461
"6800",1911,"28",45996,43900,89896
"6801",1911,"29",43880,42162,86042
"6802",1911,"30",43512,41154,84666
"6803",1911,"31",44271,42054,86325
"6804",1911,"32",42379,40748,83127
"6805",1911,"33",42199,40362,82561
"6806",1911,"34",41717,39773,81490
"6807",1911,"35",39918,38017,77935
"6808",1911,"36",39034,37327,76361
"6809",1911,"37",38584,36631,75215
"6810",1911,"38",37164,35365,72529
"6811",1911,"39",34122,32525,66647
"6812",1911,"40",34326,32863,67189
"6813",1911,"41",33105,31645,64750
"6814",1911,"42",32845,31110,63955
"6815",1911,"43",32204,31459,63663
"6816",1911,"44",32213,31130,63343
"6817",1911,"45",31313,30124,61437
"6818",1911,"46",30765,29614,60379
"6819",1911,"47",30531,29794,60325
"6820",1911,"48",27319,26709,54028
"6821",1911,"49",27344,26742,54086
"6822",1911,"50",24969,24398,49367
"6823",1911,"51",25573,24873,50446
"6824",1911,"52",23192,22356,45548
"6825",1911,"53",23593,22746,46339
"6826",1911,"54",22824,21953,44777
"6827",1911,"55",21395,20879,42274
"6828",1911,"56",21676,20702,42378
"6829",1911,"57",21081,20322,41403
"6830",1911,"58",21985,20782,42767
"6831",1911,"59",20639,19654,40293
"6832",1911,"60",20511,19694,40205
"6833",1911,"61",20502,18971,39473
"6834",1911,"62",17114,16010,33124
"6835",1911,"63",15251,13973,29224
"6836",1911,"64",15463,14077,29540
"6837",1911,"65",16529,15267,31796
"6838",1911,"66",16418,15025,31443
"6839",1911,"67",14967,13752,28719
"6840",1911,"68",14724,13236,27960
"6841",1911,"69",13559,12587,26146
"6842",1911,"70",13821,12036,25857
"6843",1911,"71",12733,11190,23923
"6844",1911,"72",11840,10393,22233
"6845",1911,"73",10394,9000,19394
"6846",1911,"74",9795,8572,18367
"6847",1911,"75",8672,7528,16200
"6848",1911,"76",7754,6586,14340
"6849",1911,"77",7205,6050,13255
"6850",1911,"78",5672,4780,10452
"6851",1911,"79",4853,4126,8979
"6852",1911,"80",4942,3862,8804
"6853",1911,"81",4094.75,3205,7299.75
"6854",1911,"82",3301.25,2561,5862.25
"6855",1911,"83",2680,2092,4772
"6856",1911,"84",2380,1736,4116
"6857",1911,"85",2017,1476,3493
"6858",1911,"86",1599,1193,2792
"6859",1911,"87",1219.46,866,2085.46
"6860",1911,"88",934.54,704,1638.54
"6861",1911,"89",701,472,1173
"6862",1911,"90",457,295,752
"6863",1911,"91",354,211,565
"6864",1911,"92",231,163,394
"6865",1911,"93",174,88,262
"6866",1911,"94",99,63,162
"6867",1911,"95",69,40,109
"6868",1911,"96",34,17,51
"6869",1911,"97",33,12,45
"6870",1911,"98",12,6,18
"6871",1911,"99",8,4,12
"6872",1911,"100",6,1,7
"6873",1911,"101",0,1,1
"6874",1911,"102",0,0,0
"6875",1911,"103",0,0,0
"6876",1911,"104",0,0,0
"6877",1911,"105",0,0,0
"6878",1911,"106",0,0,0
"6879",1911,"107",0,0,0
"6880",1911,"108",0,0,0
"6881",1911,"109",0,0,0
"6882",1911,"110+",0,0,0
"6883",1912,"0",74505,76600,151105
"6884",1912,"1",72572,75064,147636
"6885",1912,"2",73552,75299,148851
"6886",1912,"3",72302,74024,146326
"6887",1912,"4",71451,72847,144298
"6888",1912,"5",69998,71020,141018
"6889",1912,"6",69399,70689,140088
"6890",1912,"7",68726,70044,138770
"6891",1912,"8",67170,68627,135797
"6892",1912,"9",67024,68835,135859
"6893",1912,"10",65416,66215,131631
"6894",1912,"11",62332,63301,125633
"6895",1912,"12",62399,63034,125433
"6896",1912,"13",61125,62035,123160
"6897",1912,"14",61733,61970,123703
"6898",1912,"15",61035,61844,122879
"6899",1912,"16",58708,59337,118045
"6900",1912,"17",57650,58166,115816
"6901",1912,"18",57638,57941,115579
"6902",1912,"19",53548,53700,107248
"6903",1912,"20",54278,54115,108393
"6904",1912,"21",51894,51159,103053
"6905",1912,"22",51006,50075,101081
"6906",1912,"23",50859,50015,100874
"6907",1912,"24",49510,48801,98311
"6908",1912,"25",49514,47430,96944
"6909",1912,"26",48383,46820,95203
"6910",1912,"27",46871,45272,92143
"6911",1912,"28",44980,43183,88163
"6912",1912,"29",45815,43730,89545
"6913",1912,"30",43736,42056,85792
"6914",1912,"31",43352,41066,84418
"6915",1912,"32",44072,41911,85983
"6916",1912,"33",42245,40636,82881
"6917",1912,"34",41998,40259,82257
"6918",1912,"35",41537,39624,81161
"6919",1912,"36",39745,37916,77661
"6920",1912,"37",38816,37212,76028
"6921",1912,"38",38397,36497,74894
"6922",1912,"39",36971,35211,72182
"6923",1912,"40",33950,32386,66336
"6924",1912,"41",34133,32720,66853
"6925",1912,"42",32878,31494,64372
"6926",1912,"43",32647,30946,63593
"6927",1912,"44",32016,31290,63306
"6928",1912,"45",32011,30908,62919
"6929",1912,"46",31091,29917,61008
"6930",1912,"47",30553,29417,59970
"6931",1912,"48",30282,29539,59821
"6932",1912,"49",27079,26483,53562
"6933",1912,"50",27124,26482,53606
"6934",1912,"51",24758,24140,48898
"6935",1912,"52",25300,24555,49855
"6936",1912,"53",22947,22109,45056
"6937",1912,"54",23338,22425,45763
"6938",1912,"55",22532,21631,44163
"6939",1912,"56",21119,20563,41682
"6940",1912,"57",21367,20353,41720
"6941",1912,"58",20769,19943,40712
"6942",1912,"59",21595,20354,41949
"6943",1912,"60",20322,19242,39564
"6944",1912,"61",20125,19219,39344
"6945",1912,"62",20044,18452,38496
"6946",1912,"63",16720,15566,32286
"6947",1912,"64",14872,13542,28414
"6948",1912,"65",15020,13617,28637
"6949",1912,"66",15988,14722,30710
"6950",1912,"67",15778,14426,30204
"6951",1912,"68",14379,13116,27495
"6952",1912,"69",14034,12646,26680
"6953",1912,"70",12914,11945,24859
"6954",1912,"71",13114,11330,24444
"6955",1912,"72",11973,10471,22444
"6956",1912,"73",11174,9670,20844
"6957",1912,"74",9668,8275,17943
"6958",1912,"75",9045,7856,16901
"6959",1912,"76",7932,6836,14768
"6960",1912,"77",7019,5948,12967
"6961",1912,"78",6492,5365,11857
"6962",1912,"79",5092,4241,9333
"6963",1912,"80",4326,3643,7969
"6964",1912,"81",4294,3314,7608
"6965",1912,"82",3550.75,2736,6286.75
"6966",1912,"83",2790.25,2171,4961.25
"6967",1912,"84",2242,1719,3961
"6968",1912,"85",1926,1383,3309
"6969",1912,"86",1608,1153,2761
"6970",1912,"87",1263,907,2170
"6971",1912,"88",946.46,654,1600.46
"6972",1912,"89",699.54,502,1201.54
"6973",1912,"90",498,347,845
"6974",1912,"91",328,198,526
"6975",1912,"92",260,146,406
"6976",1912,"93",172,109,281
"6977",1912,"94",106,62,168
"6978",1912,"95",60,49,109
"6979",1912,"96",43,21,64
"6980",1912,"97",19,15,34
"6981",1912,"98",20,9,29
"6982",1912,"99",9,4,13
"6983",1912,"100",5,4,9
"6984",1912,"101",4,1,5
"6985",1912,"102",0,1,1
"6986",1912,"103",0,0,0
"6987",1912,"104",0,0,0
"6988",1912,"105",0,0,0
"6989",1912,"106",0,0,0
"6990",1912,"107",0,0,0
"6991",1912,"108",0,0,0
"6992",1912,"109",0,0,0
"6993",1912,"110+",0,0,0
"6994",1913,"0",79042,82208,161250
"6995",1913,"1",71367,73005,144372
"6996",1913,"2",71694,74072,145766
"6997",1913,"3",73112,74788,147900
"6998",1913,"4",72074,73755,145829
"6999",1913,"5",71268,72718,143986
"7000",1913,"6",69893,70908,140801
"7001",1913,"7",69328,70590,139918
"7002",1913,"8",68701,69994,138695
"7003",1913,"9",67148,68536,135684
"7004",1913,"10",67027,68782,135809
"7005",1913,"11",65390,66150,131540
"7006",1913,"12",62357,63211,125568
"7007",1913,"13",62331,62848,125179
"7008",1913,"14",61080,61846,122926
"7009",1913,"15",61591,61725,123316
"7010",1913,"16",60912,61513,122425
"7011",1913,"17",58566,58999,117565
"7012",1913,"18",57478,57757,115235
"7013",1913,"19",57466,57540,115006
"7014",1913,"20",53425,53299,106724
"7015",1913,"21",54126,53719,107845
"7016",1913,"22",51745,50832,102577
"7017",1913,"23",50798,49755,100553
"7018",1913,"24",50687,49749,100436
"7019",1913,"25",49362,48550,97912
"7020",1913,"26",49332,47241,96573
"7021",1913,"27",48213,46658,94871
"7022",1913,"28",46725,45165,91890
"7023",1913,"29",44829,43049,87878
"7024",1913,"30",45652,43610,89262
"7025",1913,"31",43590,41972,85562
"7026",1913,"32",43212,40982,84194
"7027",1913,"33",43872,41804,85676
"7028",1913,"34",42110,40535,82645
"7029",1913,"35",41823,40138,81961
"7030",1913,"36",41374,39509,80883
"7031",1913,"37",39558,37826,77384
"7032",1913,"38",38657,37071,75728
"7033",1913,"39",38222,36372,74594
"7034",1913,"40",36789,35069,71858
"7035",1913,"41",33770,32244,66014
"7036",1913,"42",33954,32594,66548
"7037",1913,"43",32665,31338,64003
"7038",1913,"44",32467,30795,63262
"7039",1913,"45",31799,31102,62901
"7040",1913,"46",31775,30700,62475
"7041",1913,"47",30904,29716,60620
"7042",1913,"48",30335,29208,59543
"7043",1913,"49",30024,29312,59336
"7044",1913,"50",26865,26241,53106
"7045",1913,"51",26878,26241,53119
"7046",1913,"52",24485,23856,48341
"7047",1913,"53",25050,24238,49288
"7048",1913,"54",22678,21851,44529
"7049",1913,"55",23064,22098,45162
"7050",1913,"56",22229,21309,43538
"7051",1913,"57",20882,20252,41134
"7052",1913,"58",21037,20000,41037
"7053",1913,"59",20406,19557,39963
"7054",1913,"60",21182,19945,41127
"7055",1913,"61",19951,18806,38757
"7056",1913,"62",19680,18774,38454
"7057",1913,"63",19558,17959,37517
"7058",1913,"64",16293,15114,31407
"7059",1913,"65",14486,13059,27545
"7060",1913,"66",14527,13155,27682
"7061",1913,"67",15478,14168,29646
"7062",1913,"68",15183,13811,28994
"7063",1913,"69",13730,12500,26230
"7064",1913,"70",13443,12005,25448
"7065",1913,"71",12315,11293,23608
"7066",1913,"72",12421,10628,23049
"7067",1913,"73",11291,9785,21076
"7068",1913,"74",10486,9005,19491
"7069",1913,"75",8972,7664,16636
"7070",1913,"76",8354,7201,15555
"7071",1913,"77",7225,6197,13422
"7072",1913,"78",6392,5326,11718
"7073",1913,"79",5881,4783,10664
"7074",1913,"80",4602,3680,8282
"7075",1913,"81",3830,3177,7007
"7076",1913,"82",3700,2833,6533
"7077",1913,"83",3036.75,2311,5347.75
"7078",1913,"84",2391.25,1818,4209.25
"7079",1913,"85",1875,1424,3299
"7080",1913,"86",1578,1072,2650
"7081",1913,"87",1274,887,2161
"7082",1913,"88",1011,687,1698
"7083",1913,"89",730.46,493,1223.46
"7084",1913,"90",543.54,364,907.54
"7085",1913,"91",364,240,604
"7086",1913,"92",244,141,385
"7087",1913,"93",177,100,277
"7088",1913,"94",118,74,192
"7089",1913,"95",71,36,107
"7090",1913,"96",37,27,64
"7091",1913,"97",26,17,43
"7092",1913,"98",12,10,22
"7093",1913,"99",17,9,26
"7094",1913,"100",4,3,7
"7095",1913,"101",3,2,5
"7096",1913,"102",3,0,3
"7097",1913,"103",0,0,0
"7098",1913,"104",0,0,0
"7099",1913,"105",0,0,0
"7100",1913,"106",0,0,0
"7101",1913,"107",0,0,0
"7102",1913,"108",0,0,0
"7103",1913,"109",0,0,0
"7104",1913,"110+",0,0,0
"7105",1914,"0",80425,82978,163403
"7106",1914,"1",75955,78470,154425
"7107",1914,"2",70513,72006,142519
"7108",1914,"3",71374,73671,145045
"7109",1914,"4",72877,74533,147410
"7110",1914,"5",71938,73611,145549
"7111",1914,"6",71164,72617,143781
"7112",1914,"7",69863,70848,140711
"7113",1914,"8",69312,70547,139859
"7114",1914,"9",68708,70004,138712
"7115",1914,"10",67147,68517,135664
"7116",1914,"11",67015,68743,135758
"7117",1914,"12",65362,66125,131487
"7118",1914,"13",62393,63138,125531
"7119",1914,"14",62250,62684,124934
"7120",1914,"15",61017,61639,122656
"7121",1914,"16",61448,61430,122878
"7122",1914,"17",60791,61172,121963
"7123",1914,"18",58419,58670,117089
"7124",1914,"19",57321,57348,114669
"7125",1914,"20",57309,57147,114456
"7126",1914,"21",53277,52907,106184
"7127",1914,"22",53949,53347,107296
"7128",1914,"23",51600,50495,102095
"7129",1914,"24",50637,49429,100066
"7130",1914,"25",50530,49486,100016
"7131",1914,"26",49204,48310,97514
"7132",1914,"27",49168,47031,96199
"7133",1914,"28",48050,46483,94533
"7134",1914,"29",46593,45040,91633
"7135",1914,"30",44682,42922,87604
"7136",1914,"31",45469,43470,88939
"7137",1914,"32",43443,41875,85318
"7138",1914,"33",43091,40877,83968
"7139",1914,"34",43683,41684,85367
"7140",1914,"35",41970,40428,82398
"7141",1914,"36",41656,40031,81687
"7142",1914,"37",41226,39430,80656
"7143",1914,"38",39365,37702,77067
"7144",1914,"39",38460,36962,75422
"7145",1914,"40",38074,36229,74303
"7146",1914,"41",36613,34920,71533
"7147",1914,"42",33605,32202,65807
"7148",1914,"43",33803,32443,66246
"7149",1914,"44",32443,31148,63591
"7150",1914,"45",32292,30622,62914
"7151",1914,"46",31578,30908,62486
"7152",1914,"47",31543,30481,62024
"7153",1914,"48",30677,29481,60158
"7154",1914,"49",30114,28964,59078
"7155",1914,"50",29780,29063,58843
"7156",1914,"51",26626,25992,52618
"7157",1914,"52",26628,25994,52622
"7158",1914,"53",24253,23571,47824
"7159",1914,"54",24787,23933,48720
"7160",1914,"55",22419,21542,43961
"7161",1914,"56",22780,21783,44563
"7162",1914,"57",21935,21027,42962
"7163",1914,"58",20588,19910,40498
"7164",1914,"59",20740,19610,40350
"7165",1914,"60",20037,19138,39175
"7166",1914,"61",20779,19504,40283
"7167",1914,"62",19564,18356,37920
"7168",1914,"63",19233,18280,37513
"7169",1914,"64",19062,17484,36546
"7170",1914,"65",15834,14688,30522
"7171",1914,"66",14024,12634,26658
"7172",1914,"67",14046,12675,26721
"7173",1914,"68",14865,13558,28423
"7174",1914,"69",14561,13204,27765
"7175",1914,"70",13208,11869,25077
"7176",1914,"71",12733,11348,24081
"7177",1914,"72",11675,10641,22316
"7178",1914,"73",11707,9949,21656
"7179",1914,"74",10515,9108,19623
"7180",1914,"75",9735,8277,18012
"7181",1914,"76",8272,6991,15263
"7182",1914,"77",7654,6556,14210
"7183",1914,"78",6548,5579,12127
"7184",1914,"79",5733,4778,10511
"7185",1914,"80",5158,4156,9314
"7186",1914,"81",4043,3250,7293
"7187",1914,"82",3318,2723,6041
"7188",1914,"83",3153,2389,5542
"7189",1914,"84",2585.75,1920,4505.75
"7190",1914,"85",1961.25,1494,3455.25
"7191",1914,"86",1529,1128,2657
"7192",1914,"87",1275,848,2123
"7193",1914,"88",999,687,1686
"7194",1914,"89",774,518,1292
"7195",1914,"90",560.46,358,918.46
"7196",1914,"91",400.54,258,658.54
"7197",1914,"92",274,169,443
"7198",1914,"93",161,100,261
"7199",1914,"94",125,69,194
"7200",1914,"95",72,44,116
"7201",1914,"96",42,23,65
"7202",1914,"97",25,18,43
"7203",1914,"98",14,13,27
"7204",1914,"99",9,8,17
"7205",1914,"100",11,4,15
"7206",1914,"101",2,0,2
"7207",1914,"102",3,1,4
"7208",1914,"103",1,0,1
"7209",1914,"104",0,0,0
"7210",1914,"105",0,0,0
"7211",1914,"106",0,0,0
"7212",1914,"107",0,0,0
"7213",1914,"108",0,0,0
"7214",1914,"109",0,0,0
"7215",1914,"110+",0,0,0
"7216",1915,"0",81838,84630,166468
"7217",1915,"1",77139,79210,156349
"7218",1915,"2",75092,77476,152568
"7219",1915,"3",70197,71615,141812
"7220",1915,"4",71236,73461,144697
"7221",1915,"5",72730,74365,147095
"7222",1915,"6",71880,73499,145379
"7223",1915,"7",71103,72573,143676
"7224",1915,"8",69851,70837,140688
"7225",1915,"9",69304,70527,139831
"7226",1915,"10",68721,70008,138729
"7227",1915,"11",67160,68481,135641
"7228",1915,"12",67008,68697,135705
"7229",1915,"13",65344,66069,131413
"7230",1915,"14",62396,63059,125455
"7231",1915,"15",62129,62478,124607
"7232",1915,"16",60943,61441,122384
"7233",1915,"17",61347,61150,122497
"7234",1915,"18",60638,60776,121414
"7235",1915,"19",58267,58287,116554
"7236",1915,"20",57165,56925,114090
"7237",1915,"21",57134,56731,113865
"7238",1915,"22",53118,52488,105606
"7239",1915,"23",53780,52960,106740
"7240",1915,"24",51466,50175,101641
"7241",1915,"25",50441,49137,99578
"7242",1915,"26",50370,49221,99591
"7243",1915,"27",49018,48082,97100
"7244",1915,"28",49987,46815,96802
"7245",1915,"29",47891,46301,94192
"7246",1915,"30",44450,44910,89360
"7247",1915,"31",44529,42785,87314
"7248",1915,"32",45304,43324,88628
"7249",1915,"33",43290,41766,85056
"7250",1915,"34",42963,40791,83754
"7251",1915,"35",43506,41550,85056
"7252",1915,"36",41833,40303,82136
"7253",1915,"37",41469,39919,81388
"7254",1915,"38",41067,39338,80405
"7255",1915,"39",39184,37600,76784
"7256",1915,"40",38282,36833,75115
"7257",1915,"41",37843,36101,73944
"7258",1915,"42",36444,34760,71204
"7259",1915,"43",33419,32067,65486
"7260",1915,"44",33634,32279,65913
"7261",1915,"45",32218,30951,63169
"7262",1915,"46",32076,30457,62533
"7263",1915,"47",31375,30699,62074
"7264",1915,"48",31327,30246,61573
"7265",1915,"49",30442,29272,59714
"7266",1915,"50",29889,28688,58577
"7267",1915,"51",29527,28818,58345
"7268",1915,"52",26341,25746,52087
"7269",1915,"53",26374,25735,52109
"7270",1915,"54",25982,23281,49263
"7271",1915,"55",24486,23583,48069
"7272",1915,"56",22173,21285,43458
"7273",1915,"57",22473,21510,43983
"7274",1915,"58",21607,20691,42298
"7275",1915,"59",20304,19511,39815
"7276",1915,"60",20338,19205,39543
"7277",1915,"61",19691,18719,38410
"7278",1915,"62",20342,19077,39419
"7279",1915,"63",19183,17856,37039
"7280",1915,"64",18774,17760,36534
"7281",1915,"65",18543,16959,35502
"7282",1915,"66",15340,14197,29537
"7283",1915,"67",13551,12143,25694
"7284",1915,"68",13556,12148,25704
"7285",1915,"69",14241,12960,27201
"7286",1915,"70",13927,12570,26497
"7287",1915,"71",12563,11231,23794
"7288",1915,"72",12069,10691,22760
"7289",1915,"73",10990,9981,20971
"7290",1915,"74",10937,9252,20189
"7291",1915,"75",9746,8411,18157
"7292",1915,"76",8950,7597,16547
"7293",1915,"77",7592,6353,13945
"7294",1915,"78",6931,5866,12797
"7295",1915,"79",5891,4958,10849
"7296",1915,"80",5136,4260,9396
"7297",1915,"81",4523,3616,8139
"7298",1915,"82",3535,2781,6316
"7299",1915,"83",2806,2286,5092
"7300",1915,"84",2665,1977,4642
"7301",1915,"85",2133.75,1575,3708.75
"7302",1915,"86",1605.25,1208,2813.25
"7303",1915,"87",1224,887,2111
"7304",1915,"88",979,668,1647
"7305",1915,"89",782,512,1294
"7306",1915,"90",572,388,960
"7307",1915,"91",394.46,257,651.46
"7308",1915,"92",289.54,170,459.54
"7309",1915,"93",190,116,306
"7310",1915,"94",109,66,175
"7311",1915,"95",88,41,129
"7312",1915,"96",43,29,72
"7313",1915,"97",25,11,36
"7314",1915,"98",13,12,25
"7315",1915,"99",7,6,13
"7316",1915,"100",8,3,11
"7317",1915,"101",6,4,10
"7318",1915,"102",1,0,1
"7319",1915,"103",1,1,2
"7320",1915,"104",0,0,0
"7321",1915,"105",0,0,0
"7322",1915,"106",0,0,0
"7323",1915,"107",0,0,0
"7324",1915,"108",0,0,0
"7325",1915,"109",0,0,0
"7326",1915,"110+",0,0,0
"7327",1916,"0",77594,81110,158704
"7328",1916,"1",78568,80874,159442
"7329",1916,"2",76163,78156,154319
"7330",1916,"3",74741,77089,151830
"7331",1916,"4",70006,71376,141382
"7332",1916,"5",71156,73312,144468
"7333",1916,"6",72627,74237,146864
"7334",1916,"7",71832,73431,145263
"7335",1916,"8",71065,72531,143596
"7336",1916,"9",69835,70821,140656
"7337",1916,"10",69300,70512,139812
"7338",1916,"11",68736,70002,138738
"7339",1916,"12",67143,68457,135600
"7340",1916,"13",66989,68672,135661
"7341",1916,"14",65300,66017,131317
"7342",1916,"15",62385,62954,125339
"7343",1916,"16",61998,62257,124255
"7344",1916,"17",60887,61204,122091
"7345",1916,"18",61202,60843,122045
"7346",1916,"19",60467,60377,120844
"7347",1916,"20",58102,57861,115963
"7348",1916,"21",57008,56486,113494
"7349",1916,"22",56965,56301,113266
"7350",1916,"23",52952,52061,105013
"7351",1916,"24",53609,52577,106186
"7352",1916,"25",51300,49829,101129
"7353",1916,"26",50253,48848,99101
"7354",1916,"27",50183,48946,99129
"7355",1916,"28",48828,47866,96694
"7356",1916,"29",48797,46633,95430
"7357",1916,"30",47712,46126,93838
"7358",1916,"31",46298,44794,91092
"7359",1916,"32",44380,42663,87043
"7360",1916,"33",45115,43187,88302
"7361",1916,"34",43139,41665,84804
"7362",1916,"35",42790,40680,83470
"7363",1916,"36",43281,41425,84706
"7364",1916,"37",41680,40171,81851
"7365",1916,"38",41260,39792,81052
"7366",1916,"39",40886,39203,80089
"7367",1916,"40",38980,37486,76466
"7368",1916,"41",38069,36681,74750
"7369",1916,"42",37630,35956,73586
"7370",1916,"43",36247,34584,70831
"7371",1916,"44",33229,31899,65128
"7372",1916,"45",33449,32094,65543
"7373",1916,"46",31970,30746,62716
"7374",1916,"47",31864,30262,62126
"7375",1916,"48",31133,30489,61622
"7376",1916,"49",31083,30014,61097
"7377",1916,"50",30185,29008,59193
"7378",1916,"51",29655,28425,58080
"7379",1916,"52",29256,28494,57750
"7380",1916,"53",26045,25453,51498
"7381",1916,"54",26125,25413,51538
"7382",1916,"55",25707,22974,48681
"7383",1916,"56",24152,23208,47360
"7384",1916,"57",21882,20949,42831
"7385",1916,"58",22129,21024,43153
"7386",1916,"59",21245,20335,41580
"7387",1916,"60",19963,19137,39100
"7388",1916,"61",19886,18745,38631
"7389",1916,"62",19271,18227,37498
"7390",1916,"63",19861,18546,38407
"7391",1916,"64",18714,17344,36058
"7392",1916,"65",18289,17109,35398
"7393",1916,"66",17984,16355,34339
"7394",1916,"67",14832,13668,28500
"7395",1916,"68",13060,11581,24641
"7396",1916,"69",12969,11579,24548
"7397",1916,"70",13605,12280,25885
"7398",1916,"71",13234,11877,25111
"7399",1916,"72",11897,10511,22408
"7400",1916,"73",11262,9962,21224
"7401",1916,"74",10230,9224,19454
"7402",1916,"75",10094,8541,18635
"7403",1916,"76",8920,7654,16574
"7404",1916,"77",8136,6848,14984
"7405",1916,"78",6806,5701,12507
"7406",1916,"79",6175,5171,11346
"7407",1916,"80",5258,4329,9587
"7408",1916,"81",4460,3676,8136
"7409",1916,"82",3887,3116,7003
"7410",1916,"83",2974,2342,5316
"7411",1916,"84",2336,1879,4215
"7412",1916,"85",2163,1606,3769
"7413",1916,"86",1716.75,1249,2965.75
"7414",1916,"87",1278.25,923,2201.25
"7415",1916,"88",962,673,1635
"7416",1916,"89",742,512,1254
"7417",1916,"90",564,373,937
"7418",1916,"91",418,279,697
"7419",1916,"92",295.46,178,473.46
"7420",1916,"93",193.54,116,309.54
"7421",1916,"94",132,76,208
"7422",1916,"95",70,40,110
"7423",1916,"96",51,22,73
"7424",1916,"97",27,13,40
"7425",1916,"98",14,8,22
"7426",1916,"99",7,5,12
"7427",1916,"100",4,3,7
"7428",1916,"101",1,3,4
"7429",1916,"102",1,2,3
"7430",1916,"103",1,0,1
"7431",1916,"104",0,0,0
"7432",1916,"105",0,0,0
"7433",1916,"106",0,0,0
"7434",1916,"107",0,0,0
"7435",1916,"108",0,0,0
"7436",1916,"109",0,0,0
"7437",1916,"110+",0,0,0
"7438",1917,"0",80102,83233,163335
"7439",1917,"1",74440,77199,151639
"7440",1917,"2",77407,79647,157054
"7441",1917,"3",75812,77762,153574
"7442",1917,"4",74601,76901,151502
"7443",1917,"5",69898,71232,141130
"7444",1917,"6",71106,73191,144297
"7445",1917,"7",72535,74141,146676
"7446",1917,"8",71782,73398,145180
"7447",1917,"9",71004,72506,143510
"7448",1917,"10",69795,70815,140610
"7449",1917,"11",69281,70493,139774
"7450",1917,"12",68731,70021,138752
"7451",1917,"13",67106,68413,135519
"7452",1917,"14",66938,68619,135557
"7453",1917,"15",65195,65916,131111
"7454",1917,"16",62300,62805,125105
"7455",1917,"17",61797,61987,123784
"7456",1917,"18",60739,60870,121609
"7457",1917,"19",60984,60480,121464
"7458",1917,"20",60252,59890,120142
"7459",1917,"21",57909,57419,115328
"7460",1917,"22",56809,56018,112827
"7461",1917,"23",56757,55848,112605
"7462",1917,"24",52764,51609,104373
"7463",1917,"25",53377,52166,105543
"7464",1917,"26",51103,49484,100587
"7465",1917,"27",50003,48527,98530
"7466",1917,"28",49993,48660,98653
"7467",1917,"29",48624,47625,96249
"7468",1917,"30",48595,46410,95005
"7469",1917,"31",47476,45951,93427
"7470",1917,"32",46110,44655,90765
"7471",1917,"33",44192,42523,86715
"7472",1917,"34",44910,43039,87949
"7473",1917,"35",42937,41526,84463
"7474",1917,"36",42605,40566,83171
"7475",1917,"37",43055,41289,84344
"7476",1917,"38",41521,40067,81588
"7477",1917,"39",41035,39659,80694
"7478",1917,"40",40678,39051,79729
"7479",1917,"41",38749,37358,76107
"7480",1917,"42",37858,36532,74390
"7481",1917,"43",37420,35797,73217
"7482",1917,"44",36044,34401,70445
"7483",1917,"45",33029,31719,64748
"7484",1917,"46",33247,31912,65159
"7485",1917,"47",31734,30527,62261
"7486",1917,"48",31648,30040,61688
"7487",1917,"49",30872,30240,61112
"7488",1917,"50",30808,29736,60544
"7489",1917,"51",29905,28725,58630
"7490",1917,"52",29378,28136,57514
"7491",1917,"53",28950,28167,57117
"7492",1917,"54",25746,25114,50860
"7493",1917,"55",25844,25057,50901
"7494",1917,"56",25433,22625,48058
"7495",1917,"57",23807,22812,46619
"7496",1917,"58",21544,20581,42125
"7497",1917,"59",21777,20626,42403
"7498",1917,"60",20847,19908,40755
"7499",1917,"61",19625,18696,38321
"7500",1917,"62",19462,18266,37728
"7501",1917,"63",18820,17711,36531
"7502",1917,"64",19303,17934,37237
"7503",1917,"65",18178,16798,34976
"7504",1917,"66",17693,16477,34170
"7505",1917,"67",17310,15698,33008
"7506",1917,"68",14264,13071,27335
"7507",1917,"69",12496,11012,23508
"7508",1917,"70",12387,10976,23363
"7509",1917,"71",12886,11560,24446
"7510",1917,"72",12413,11127,23540
"7511",1917,"73",11092,9778,20870
"7512",1917,"74",10492,9202,19694
"7513",1917,"75",9436,8414,17850
"7514",1917,"76",9264,7773,17037
"7515",1917,"77",8101,6855,14956
"7516",1917,"78",7328,6069,13397
"7517",1917,"79",6050,5020,11070
"7518",1917,"80",5364,4445,9809
"7519",1917,"81",4576,3700,8276
"7520",1917,"82",3781,3108,6889
"7521",1917,"83",3226,2612,5838
"7522",1917,"84",2492,1932,4424
"7523",1917,"85",1926,1492,3418
"7524",1917,"86",1737,1267,3004
"7525",1917,"87",1341.75,971,2312.75
"7526",1917,"88",974.25,691,1665.25
"7527",1917,"89",706,476,1182
"7528",1917,"90",565,362,927
"7529",1917,"91",403,257,660
"7530",1917,"92",284,195,479
"7531",1917,"93",194.46,121,315.46
"7532",1917,"94",130.54,77,207.54
"7533",1917,"95",78,47,125
"7534",1917,"96",37,27,64
"7535",1917,"97",25,13,38
"7536",1917,"98",14,8,22
"7537",1917,"99",5,5,10
"7538",1917,"100",3,2,5
"7539",1917,"101",0,0,0
"7540",1917,"102",0,1,1
"7541",1917,"103",1,0,1
"7542",1917,"104",0,0,0
"7543",1917,"105",0,0,0
"7544",1917,"106",0,0,0
"7545",1917,"107",0,0,0
"7546",1917,"108",0,0,0
"7547",1917,"109",0,0,0
"7548",1917,"110+",0,0,0
"7549",1918,"0",79987,83143,163130
"7550",1918,"1",76852,79366,156218
"7551",1918,"2",73382,76008,149390
"7552",1918,"3",76997,79202,156199
"7553",1918,"4",75613,77523,153136
"7554",1918,"5",74506,76763,151269
"7555",1918,"6",69816,71113,140929
"7556",1918,"7",71061,73129,144190
"7557",1918,"8",72435,74044,146479
"7558",1918,"9",71743,73348,145091
"7559",1918,"10",70945,72506,143451
"7560",1918,"11",69770,70809,140579
"7561",1918,"12",69219,70436,139655
"7562",1918,"13",68671,70035,138706
"7563",1918,"14",67011,68353,135364
"7564",1918,"15",66835,68499,135334
"7565",1918,"16",65034,65783,130817
"7566",1918,"17",62193,62619,124812
"7567",1918,"18",61594,61751,123345
"7568",1918,"19",60578,60490,121068
"7569",1918,"20",60758,60002,120760
"7570",1918,"21",60044,59516,119560
"7571",1918,"22",57694,56934,114628
"7572",1918,"23",56604,55543,112147
"7573",1918,"24",56521,55421,111942
"7574",1918,"25",52567,51146,103713
"7575",1918,"26",53149,51766,104915
"7576",1918,"27",50934,49105,100039
"7577",1918,"28",49748,48187,97935
"7578",1918,"29",49748,48387,98135
"7579",1918,"30",48416,47384,95800
"7580",1918,"31",48385,46203,94588
"7581",1918,"32",47250,45764,93014
"7582",1918,"33",45940,44490,90430
"7583",1918,"34",44004,42359,86363
"7584",1918,"35",44683,42843,87526
"7585",1918,"36",42733,41406,84139
"7586",1918,"37",42416,40414,82830
"7587",1918,"38",42813,41134,83947
"7588",1918,"39",41339,39914,81253
"7589",1918,"40",40812,39506,80318
"7590",1918,"41",40475,38899,79374
"7591",1918,"42",38528,37217,75745
"7592",1918,"43",37639,36378,74017
"7593",1918,"44",37216,35588,72804
"7594",1918,"45",35807,34205,70012
"7595",1918,"46",32804,31535,64339
"7596",1918,"47",33032,31692,64724
"7597",1918,"48",31476,30242,61718
"7598",1918,"49",31425,29784,61209
"7599",1918,"50",30600,29997,60597
"7600",1918,"51",30531,29420,59951
"7601",1918,"52",29599,28407,58006
"7602",1918,"53",29103,27803,56906
"7603",1918,"54",28609,27805,56414
"7604",1918,"55",25415,24790,50205
"7605",1918,"56",25502,24675,50177
"7606",1918,"57",25062,22234,47296
"7607",1918,"58",23413,22347,45760
"7608",1918,"59",21176,20175,41351
"7609",1918,"60",21337,20156,41493
"7610",1918,"61",20426,19441,39867
"7611",1918,"62",19191,18225,37416
"7612",1918,"63",18998,17715,36713
"7613",1918,"64",18326,17180,35506
"7614",1918,"65",18738,17298,36036
"7615",1918,"66",17599,16164,33763
"7616",1918,"67",17088,15759,32847
"7617",1918,"68",16615,14981,31596
"7618",1918,"69",13631,12460,26091
"7619",1918,"70",11905,10430,22335
"7620",1918,"71",11743,10347,22090
"7621",1918,"72",12102,10811,22913
"7622",1918,"73",11560,10369,21929
"7623",1918,"74",10300,8957,19257
"7624",1918,"75",9661,8430,18091
"7625",1918,"76",8600,7607,16207
"7626",1918,"77",8392,6991,15383
"7627",1918,"78",7245,6079,13324
"7628",1918,"79",6525,5334,11859
"7629",1918,"80",5341,4341,9682
"7630",1918,"81",4637,3785,8422
"7631",1918,"82",3903,3078,6981
"7632",1918,"83",3136,2576,5712
"7633",1918,"84",2660,2130,4790
"7634",1918,"85",2010,1533,3543
"7635",1918,"86",1537,1180,2717
"7636",1918,"87",1331,954,2285
"7637",1918,"88",992.75,701,1693.75
"7638",1918,"89",723.25,477,1200.25
"7639",1918,"90",492,330,822
"7640",1918,"91",379,250,629
"7641",1918,"92",273,161,434
"7642",1918,"93",197,123,320
"7643",1918,"94",136.46,69,205.46
"7644",1918,"95",80.54,44,124.54
"7645",1918,"96",48,30,78
"7646",1918,"97",19,10,29
"7647",1918,"98",12,9,21
"7648",1918,"99",5,3,8
"7649",1918,"100",0,3,3
"7650",1918,"101",1,1,2
"7651",1918,"102",0,0,0
"7652",1918,"103",0,0,0
"7653",1918,"104",1,0,1
"7654",1918,"105",0,0,0
"7655",1918,"106",0,0,0
"7656",1918,"107",0,0,0
"7657",1918,"108",0,0,0
"7658",1918,"109",0,0,0
"7659",1918,"110+",0,0,0
"7660",1919,"0",76466,80049,156515
"7661",1919,"1",75432,77903,153335
"7662",1919,"2",74817,77208,152025
"7663",1919,"3",72435,74987,147422
"7664",1919,"4",76386,78574,154960
"7665",1919,"5",75257,77134,152391
"7666",1919,"6",74253,76509,150762
"7667",1919,"7",69594,70897,140491
"7668",1919,"8",70876,72990,143866
"7669",1919,"9",72205,73912,146117
"7670",1919,"10",71563,73199,144762
"7671",1919,"11",70753,72343,143096
"7672",1919,"12",69597,70698,140295
"7673",1919,"13",68985,70280,139265
"7674",1919,"14",68415,69890,138305
"7675",1919,"15",66708,68113,134821
"7676",1919,"16",66497,68174,134671
"7677",1919,"17",64644,65397,130041
"7678",1919,"18",61839,62167,124006
"7679",1919,"19",61128,61091,122219
"7680",1919,"20",60181,59892,120073
"7681",1919,"21",60246,59268,119514
"7682",1919,"22",59512,58761,118273
"7683",1919,"23",57174,56201,113375
"7684",1919,"24",56056,54701,110757
"7685",1919,"25",55938,54565,110503
"7686",1919,"26",52052,50356,102408
"7687",1919,"27",52554,50965,103519
"7688",1919,"28",50339,48364,98703
"7689",1919,"29",49157,47465,96622
"7690",1919,"30",49156,47731,96887
"7691",1919,"31",47940,46729,94669
"7692",1919,"32",47869,45652,93521
"7693",1919,"33",46800,45230,92030
"7694",1919,"34",45491,43918,89409
"7695",1919,"35",43543,41945,85488
"7696",1919,"36",44241,42402,86643
"7697",1919,"37",42315,41021,83336
"7698",1919,"38",42051,40099,82150
"7699",1919,"39",42357,40736,83093
"7700",1919,"40",40980,39578,80558
"7701",1919,"41",40395,39170,79565
"7702",1919,"42",40166,38578,78744
"7703",1919,"43",38199,36908,75107
"7704",1919,"44",37287,36031,73318
"7705",1919,"45",36918,35207,72125
"7706",1919,"46",35503,33842,69345
"7707",1919,"47",32479,31212,63691
"7708",1919,"48",32755,31380,64135
"7709",1919,"49",31111,29882,60993
"7710",1919,"50",31120,29477,60597
"7711",1919,"51",30289,29642,59931
"7712",1919,"52",30130,29035,59165
"7713",1919,"53",29214,27996,57210
"7714",1919,"54",28717,27342,56059
"7715",1919,"55",28157,27363,55520
"7716",1919,"56",25034,24348,49382
"7717",1919,"57",25116,24245,49361
"7718",1919,"58",24664,21724,46388
"7719",1919,"59",22970,21811,44781
"7720",1919,"60",20734,19756,40490
"7721",1919,"61",20874,19616,40490
"7722",1919,"62",19943,18893,38836
"7723",1919,"63",18698,17648,36346
"7724",1919,"64",18411,17110,35521
"7725",1919,"65",17744,16557,34301
"7726",1919,"66",18096,16606,34702
"7727",1919,"67",16977,15513,32490
"7728",1919,"68",16420,15027,31447
"7729",1919,"69",15851,14155,30006
"7730",1919,"70",12963,11727,24690
"7731",1919,"71",11262,9818,21080
"7732",1919,"72",11092,9689,20781
"7733",1919,"73",11273,10037,21310
"7734",1919,"74",10740,9528,20268
"7735",1919,"75",9540,8167,17707
"7736",1919,"76",8842,7625,16467
"7737",1919,"77",7816,6854,14670
"7738",1919,"78",7577,6256,13833
"7739",1919,"79",6392,5324,11716
"7740",1919,"80",5781,4663,10444
"7741",1919,"81",4657,3756,8413
"7742",1919,"82",4005,3220,7225
"7743",1919,"83",3287,2561,5848
"7744",1919,"84",2631,2100,4731
"7745",1919,"85",2174,1725,3899
"7746",1919,"86",1624,1228,2852
"7747",1919,"87",1208,930,2138
"7748",1919,"88",1036,715,1751
"7749",1919,"89",761.75,513,1274.75
"7750",1919,"90",535.25,340,875.25
"7751",1919,"91",363,231,594
"7752",1919,"92",276,187,463
"7753",1919,"93",192,100,292
"7754",1919,"94",136,84,220
"7755",1919,"95",85.46,40,125.46
"7756",1919,"96",55.54,25,80.54
"7757",1919,"97",31,22,53
"7758",1919,"98",13,5,18
"7759",1919,"99",5,4,9
"7760",1919,"100",1,1,2
"7761",1919,"101",0,2,2
"7762",1919,"102",1,1,2
"7763",1919,"103",0,0,0
"7764",1919,"104",0,0,0
"7765",1919,"105",0,0,0
"7766",1919,"106",0,0,0
"7767",1919,"107",0,0,0
"7768",1919,"108",0,0,0
"7769",1919,"109",0,0,0
"7770",1919,"110+",0,0,0
"7771",1920,"0",75973,80155,156128
"7772",1920,"1",72569,75357,147926
"7773",1920,"2",73672,75905,149577
"7774",1920,"3",74099,76403,150502
"7775",1920,"4",72083,74633,146716
"7776",1920,"5",76150,78412,154562
"7777",1920,"6",75204,77001,152205
"7778",1920,"7",74216,76472,150688
"7779",1920,"8",69561,70816,140377
"7780",1920,"9",70858,72959,143817
"7781",1920,"10",72144,73891,146035
"7782",1920,"11",71530,73194,144724
"7783",1920,"12",70711,72331,143042
"7784",1920,"13",69519,70702,140221
"7785",1920,"14",68903,70255,139158
"7786",1920,"15",68323,69845,138168
"7787",1920,"16",66581,67978,134559
"7788",1920,"17",66362,68014,134376
"7789",1920,"18",64461,65178,129639
"7790",1920,"19",61703,61922,123625
"7791",1920,"20",60906,60728,121634
"7792",1920,"21",60021,59531,119552
"7793",1920,"22",60000,58852,118852
"7794",1920,"23",59251,58330,117581
"7795",1920,"24",56949,55745,112694
"7796",1920,"25",55815,54212,110027
"7797",1920,"26",55692,54114,109806
"7798",1920,"27",51835,49933,101768
"7799",1920,"28",52316,50564,102880
"7800",1920,"29",50100,48016,98116
"7801",1920,"30",48868,47104,95972
"7802",1920,"31",48897,47415,96312
"7803",1920,"32",47706,46457,94163
"7804",1920,"33",47654,45426,93080
"7805",1920,"34",46563,45043,91606
"7806",1920,"35",45255,43760,89015
"7807",1920,"36",43339,41756,85095
"7808",1920,"37",43985,42208,86193
"7809",1920,"38",42090,40867,82957
"7810",1920,"39",41842,39954,81796
"7811",1920,"40",42096,40543,82639
"7812",1920,"41",40798,39397,80195
"7813",1920,"42",40160,38980,79140
"7814",1920,"43",39947,38387,78334
"7815",1920,"44",37966,36727,74693
"7816",1920,"45",37035,35828,72863
"7817",1920,"46",36652,34979,71631
"7818",1920,"47",35265,33615,68880
"7819",1920,"48",32220,31003,63223
"7820",1920,"49",32504,31121,63625
"7821",1920,"50",30816,29622,60438
"7822",1920,"51",30873,29231,60104
"7823",1920,"52",29987,29346,59333
"7824",1920,"53",29807,28717,58524
"7825",1920,"54",28895,27631,56526
"7826",1920,"55",28381,26962,55343
"7827",1920,"56",27803,26900,54703
"7828",1920,"57",24670,23968,48638
"7829",1920,"58",24724,23812,48536
"7830",1920,"59",24255,21315,45570
"7831",1920,"60",22454,21322,43776
"7832",1920,"61",20290,19312,39602
"7833",1920,"62",20400,19116,39516
"7834",1920,"63",19418,18399,37817
"7835",1920,"64",18279,17113,35392
"7836",1920,"65",17884,16571,34455
"7837",1920,"66",17180,15972,33152
"7838",1920,"67",17468,15969,33437
"7839",1920,"68",16363,14839,31202
"7840",1920,"69",15721,14333,30054
"7841",1920,"70",15050,13393,28443
"7842",1920,"71",12273,11101,23374
"7843",1920,"72",10606,9210,19816
"7844",1920,"73",10399,9011,19410
"7845",1920,"74",10480,9244,19724
"7846",1920,"75",9898,8694,18592
"7847",1920,"76",8720,7391,16111
"7848",1920,"77",7968,6904,14872
"7849",1920,"78",7016,6077,13093
"7850",1920,"79",6692,5504,12196
"7851",1920,"80",5604,4603,10207
"7852",1920,"81",4990,3972,8962
"7853",1920,"82",3946,3185,7131
"7854",1920,"83",3354,2662,6016
"7855",1920,"84",2702,2060,4762
"7856",1920,"85",2140,1704,3844
"7857",1920,"86",1715,1345,3060
"7858",1920,"87",1267,944,2211
"7859",1920,"88",935,723,1658
"7860",1920,"89",765,523,1288
"7861",1920,"90",549.75,346,895.75
"7862",1920,"91",382.25,236,618.25
"7863",1920,"92",264,160,424
"7864",1920,"93",192,119,311
"7865",1920,"94",124,60,184
"7866",1920,"95",78,52,130
"7867",1920,"96",48.46,23,71.46
"7868",1920,"97",35.54,15,50.54
"7869",1920,"98",21,10,31
"7870",1920,"99",9,2,11
"7871",1920,"100",2,4,6
"7872",1920,"101",0,0,0
"7873",1920,"102",0,0,0
"7874",1920,"103",0,0,0
"7875",1920,"104",0,0,0
"7876",1920,"105",0,0,0
"7877",1920,"106",0,0,0
"7878",1920,"107",0,0,0
"7879",1920,"108",0,0,0
"7880",1920,"109",0,0,0
"7881",1920,"110+",0,0,0
"7882",1921,"0",89645,93767,183412
"7883",1921,"1",73358,76649,150007
"7884",1921,"2",71503,74175,145678
"7885",1921,"3",73170,75320,148490
"7886",1921,"4",73836,76130,149966
"7887",1921,"5",71958,74480,146438
"7888",1921,"6",76089,78342,154431
"7889",1921,"7",75221,76967,152188
"7890",1921,"8",74301,76461,150762
"7891",1921,"9",69656,70786,140442
"7892",1921,"10",70918,72887,143805
"7893",1921,"11",72204,73798,146002
"7894",1921,"12",71586,73090,144676
"7895",1921,"13",70736,72199,142935
"7896",1921,"14",69521,70549,140070
"7897",1921,"15",68876,70073,138949
"7898",1921,"16",68253,69618,137871
"7899",1921,"17",66454,67724,134178
"7900",1921,"18",66256,67703,133959
"7901",1921,"19",64325,64825,129150
"7902",1921,"20",61567,61541,123108
"7903",1921,"21",60803,60348,121151
"7904",1921,"22",59864,59187,119051
"7905",1921,"23",59808,58485,118293
"7906",1921,"24",59053,57960,117013
"7907",1921,"25",56746,55377,112123
"7908",1921,"26",55619,53855,109474
"7909",1921,"27",55425,53759,109184
"7910",1921,"28",51596,49605,101201
"7911",1921,"29",52119,50264,102383
"7912",1921,"30",49854,47737,97591
"7913",1921,"31",48615,46859,95474
"7914",1921,"32",48661,47168,95829
"7915",1921,"33",47475,46218,93693
"7916",1921,"34",47392,45225,92617
"7917",1921,"35",46336,44826,91162
"7918",1921,"36",45034,43579,88613
"7919",1921,"37",43138,41569,84707
"7920",1921,"38",43764,42020,85784
"7921",1921,"39",41850,40689,82539
"7922",1921,"40",41626,39757,81383
"7923",1921,"41",41863,40355,82218
"7924",1921,"42",40573,39213,79786
"7925",1921,"43",39903,38786,78689
"7926",1921,"44",39680,38197,77877
"7927",1921,"45",37711,36530,74241
"7928",1921,"46",36800,35622,72422
"7929",1921,"47",36383,34756,71139
"7930",1921,"48",35011,33370,68381
"7931",1921,"49",31979,30673,62652
"7932",1921,"50",32214,30823,63037
"7933",1921,"51",30529,29330,59859
"7934",1921,"52",30581,28946,59527
"7935",1921,"53",29686,28985,58671
"7936",1921,"54",29481,28365,57846
"7937",1921,"55",28535,27267,55802
"7938",1921,"56",28020,26537,54557
"7939",1921,"57",27432,26489,53921
"7940",1921,"58",24286,23550,47836
"7941",1921,"59",24328,23364,47692
"7942",1921,"60",21850,20883,42733
"7943",1921,"61",21991,20837,42828
"7944",1921,"62",19847,18885,38732
"7945",1921,"63",19900,18608,38508
"7946",1921,"64",18896,17871,36767
"7947",1921,"65",17748,16576,34324
"7948",1921,"66",17307,16039,33346
"7949",1921,"67",16576,15319,31895
"7950",1921,"68",16802,15308,32110
"7951",1921,"69",15691,14162,29853
"7952",1921,"70",15000,13618,28618
"7953",1921,"71",14305,12652,26957
"7954",1921,"72",11543,10470,22013
"7955",1921,"73",9933,8565,18498
"7956",1921,"74",9609,8331,17940
"7957",1921,"75",9693,8532,18225
"7958",1921,"76",9139,7910,17049
"7959",1921,"77",7952,6691,14643
"7960",1921,"78",7170,6160,13330
"7961",1921,"79",6297,5389,11686
"7962",1921,"80",5773,4776,10549
"7963",1921,"81",4911,3986,8897
"7964",1921,"82",4280,3391,7671
"7965",1921,"83",3342,2671,6013
"7966",1921,"84",2827,2176,5003
"7967",1921,"85",2246,1673,3919
"7968",1921,"86",1718,1340,3058
"7969",1921,"87",1377,1025,2402
"7970",1921,"88",991,704,1695
"7971",1921,"89",692,552,1244
"7972",1921,"90",558,373,931
"7973",1921,"91",407.75,259,666.75
"7974",1921,"92",260.25,168,428.25
"7975",1921,"93",181,124,305
"7976",1921,"94",134,84,218
"7977",1921,"95",75,38,113
"7978",1921,"96",51,35,86
"7979",1921,"97",30.46,13,43.46
"7980",1921,"98",23.54,13,36.54
"7981",1921,"99",13,5,18
"7982",1921,"100",5,1,6
"7983",1921,"101",0,2,2
"7984",1921,"102",0,0,0
"7985",1921,"103",0,0,0
"7986",1921,"104",0,0,0
"7987",1921,"105",0,0,0
"7988",1921,"106",0,0,0
"7989",1921,"107",0,0,0
"7990",1921,"108",0,0,0
"7991",1921,"109",0,0,0
"7992",1921,"110+",0,0,0
"7993",1922,"0",87970,91718,179688
"7994",1922,"1",86941,90297,177238
"7995",1922,"2",72577,75742,148319
"7996",1922,"3",71163,73819,144982
"7997",1922,"4",72918,75046,147964
"7998",1922,"5",73664,75927,149591
"7999",1922,"6",71868,74344,146212
"8000",1922,"7",76064,78244,154308
"8001",1922,"8",75271,76901,152172
"8002",1922,"9",74421,76389,150810
"8003",1922,"10",69822,70743,140565
"8004",1922,"11",71072,72788,143860
"8005",1922,"12",72376,73671,146047
"8006",1922,"13",71715,72900,144615
"8007",1922,"14",70845,71928,142773
"8008",1922,"15",69599,70251,139850
"8009",1922,"16",68861,69742,138603
"8010",1922,"17",68212,69217,137429
"8011",1922,"18",66399,67342,133741
"8012",1922,"19",66172,67224,133396
"8013",1922,"20",64252,64413,128665
"8014",1922,"21",61431,61123,122554
"8015",1922,"22",60689,59976,120665
"8016",1922,"23",59739,58883,118622
"8017",1922,"24",59643,58160,117803
"8018",1922,"25",58901,57671,116572
"8019",1922,"26",56568,55111,111679
"8020",1922,"27",55457,53627,109084
"8021",1922,"28",55281,53565,108846
"8022",1922,"29",51383,49380,100763
"8023",1922,"30",51942,50106,102048
"8024",1922,"31",49628,47516,97144
"8025",1922,"32",48438,46687,95125
"8026",1922,"33",48454,46961,95415
"8027",1922,"34",47299,46018,93317
"8028",1922,"35",47160,45018,92178
"8029",1922,"36",46125,44666,90791
"8030",1922,"37",44797,43404,88201
"8031",1922,"38",42930,41391,84321
"8032",1922,"39",43507,41834,85341
"8033",1922,"40",41672,40492,82164
"8034",1922,"41",41377,39573,80950
"8035",1922,"42",41639,40158,81797
"8036",1922,"43",40355,39021,79376
"8037",1922,"44",39680,38565,78245
"8038",1922,"45",39429,37968,77397
"8039",1922,"46",37443,36279,73722
"8040",1922,"47",36559,35388,71947
"8041",1922,"48",36128,34512,70640
"8042",1922,"49",34687,33113,67800
"8043",1922,"50",31755,30473,62228
"8044",1922,"51",31886,30504,62390
"8045",1922,"52",30250,29055,59305
"8046",1922,"53",30257,28643,58900
"8047",1922,"54",29369,28635,58004
"8048",1922,"55",29168,27978,57146
"8049",1922,"56",28182,26895,55077
"8050",1922,"57",27639,26160,53799
"8051",1922,"58",27034,26055,53089
"8052",1922,"59",23875,23149,47024
"8053",1922,"60",23886,22920,46806
"8054",1922,"61",21399,20435,41834
"8055",1922,"62",21555,20366,41921
"8056",1922,"63",19362,18423,37785
"8057",1922,"64",19420,18095,37515
"8058",1922,"65",18335,17285,35620
"8059",1922,"66",17202,15996,33198
"8060",1922,"67",16728,15442,32170
"8061",1922,"68",16011,14688,30699
"8062",1922,"69",16107,14655,30762
"8063",1922,"70",14978,13541,28519
"8064",1922,"71",14259,12905,27164
"8065",1922,"72",13553,11916,25469
"8066",1922,"73",10845,9819,20664
"8067",1922,"74",9268,7954,17222
"8068",1922,"75",8960,7675,16635
"8069",1922,"76",8931,7818,16749
"8070",1922,"77",8394,7174,15568
"8071",1922,"78",7192,6035,13227
"8072",1922,"79",6384,5491,11875
"8073",1922,"80",5684,4771,10455
"8074",1922,"81",5070,4175,9245
"8075",1922,"82",4262,3410,7672
"8076",1922,"83",3687,2881,6568
"8077",1922,"84",2800,2197,4997
"8078",1922,"85",2324,1774,4098
"8079",1922,"86",1880,1352,3232
"8080",1922,"87",1376,1040,2416
"8081",1922,"88",1100,772,1872
"8082",1922,"89",760,511,1271
"8083",1922,"90",521,429,950
"8084",1922,"91",404,277,681
"8085",1922,"92",304.75,181,485.75
"8086",1922,"93",178.25,117,295.25
"8087",1922,"94",123,83,206
"8088",1922,"95",92,51,143
"8089",1922,"96",52,22,74
"8090",1922,"97",36,22,58
"8091",1922,"98",22.46,5,27.46
"8092",1922,"99",15.54,6,21.54
"8093",1922,"100",8,3,11
"8094",1922,"101",2,0,2
"8095",1922,"102",0,1,1
"8096",1922,"103",0,0,0
"8097",1922,"104",0,0,0
"8098",1922,"105",0,0,0
"8099",1922,"106",0,0,0
"8100",1922,"107",0,0,0
"8101",1922,"108",0,0,0
"8102",1922,"109",0,0,0
"8103",1922,"110+",0,0,0
"8104",1923,"0",85464,89603,175067
"8105",1923,"1",85089,87947,173036
"8106",1923,"2",86024,89150,175174
"8107",1923,"3",72209,75302,147511
"8108",1923,"4",70961,73553,144514
"8109",1923,"5",72766,74849,147615
"8110",1923,"6",73565,75793,149358
"8111",1923,"7",71839,74267,146106
"8112",1923,"8",76085,78198,154283
"8113",1923,"9",75338,76849,152187
"8114",1923,"10",74548,76335,150883
"8115",1923,"11",70008,70697,140705
"8116",1923,"12",71237,72687,143924
"8117",1923,"13",72550,73541,146091
"8118",1923,"14",71837,72692,144529
"8119",1923,"15",70920,71638,142558
"8120",1923,"16",69651,69927,139578
"8121",1923,"17",68862,69384,138246
"8122",1923,"18",68162,68798,136960
"8123",1923,"19",66370,66941,133311
"8124",1923,"20",66081,66734,132815
"8125",1923,"21",64170,63992,128162
"8126",1923,"22",61285,60703,121988
"8127",1923,"23",60598,59636,120234
"8128",1923,"24",59639,58584,118223
"8129",1923,"25",59471,57865,117336
"8130",1923,"26",58744,57439,116183
"8131",1923,"27",56405,54851,111256
"8132",1923,"28",55303,53398,108701
"8133",1923,"29",55124,53348,108472
"8134",1923,"30",51143,49172,100315
"8135",1923,"31",51787,49913,101700
"8136",1923,"32",49375,47327,96702
"8137",1923,"33",48261,46520,94781
"8138",1923,"34",48223,46801,95024
"8139",1923,"35",47104,45829,92933
"8140",1923,"36",46922,44805,91727
"8141",1923,"37",45867,44479,90346
"8142",1923,"38",44562,43178,87740
"8143",1923,"39",42696,41221,83917
"8144",1923,"40",43266,41627,84893
"8145",1923,"41",41447,40321,81768
"8146",1923,"42",41124,39358,80482
"8147",1923,"43",41403,39954,81357
"8148",1923,"44",40090,38809,78899
"8149",1923,"45",39447,38356,77803
"8150",1923,"46",39136,37709,76845
"8151",1923,"47",37159,36017,73176
"8152",1923,"48",36263,35154,71417
"8153",1923,"49",35850,34231,70081
"8154",1923,"50",34331,32815,67146
"8155",1923,"51",31485,30186,61671
"8156",1923,"52",31495,30151,61646
"8157",1923,"53",29962,28739,58701
"8158",1923,"54",29861,28276,58137
"8159",1923,"55",29034,28282,57316
"8160",1923,"56",28740,27607,56347
"8161",1923,"57",27782,26468,54250
"8162",1923,"58",27177,25713,52890
"8163",1923,"59",26551,25541,52092
"8164",1923,"60",23421,22651,46072
"8165",1923,"61",23436,22415,45851
"8166",1923,"62",20898,19951,40849
"8167",1923,"63",21045,19785,40830
"8168",1923,"64",18810,17853,36663
"8169",1923,"65",18815,17513,36328
"8170",1923,"66",17729,16689,34418
"8171",1923,"67",16597,15387,31984
"8172",1923,"68",16063,14743,30806
"8173",1923,"69",15302,13977,29279
"8174",1923,"70",15312,13891,29203
"8175",1923,"71",14151,12790,26941
"8176",1923,"72",13391,12065,25456
"8177",1923,"73",12612,11102,23714
"8178",1923,"74",10034,9038,19072
"8179",1923,"75",8511,7320,15831
"8180",1923,"76",8149,6993,15142
"8181",1923,"77",8010,6968,14978
"8182",1923,"78",7463,6311,13774
"8183",1923,"79",6418,5304,11722
"8184",1923,"80",5516,4712,10228
"8185",1923,"81",4867,4033,8900
"8186",1923,"82",4312,3495,7807
"8187",1923,"83",3581,2814,6395
"8188",1923,"84",3014,2342,5356
"8189",1923,"85",2261,1764,4025
"8190",1923,"86",1866,1401,3267
"8191",1923,"87",1465,1017,2482
"8192",1923,"88",1019,768,1787
"8193",1923,"89",842,557,1399
"8194",1923,"90",577,342,919
"8195",1923,"91",368,304,672
"8196",1923,"92",276,190,466
"8197",1923,"93",190.75,113,303.75
"8198",1923,"94",118.25,78,196.25
"8199",1923,"95",73,51,124
"8200",1923,"96",59,28,87
"8201",1923,"97",27,13,40
"8202",1923,"98",24,10,34
"8203",1923,"99",14.46,3,17.46
"8204",1923,"100",8.54,2,10.54
"8205",1923,"101",6,1,7
"8206",1923,"102",2,0,2
"8207",1923,"103",0,1,1
"8208",1923,"104",0,0,0
"8209",1923,"105",0,0,0
"8210",1923,"106",0,0,0
"8211",1923,"107",0,0,0
"8212",1923,"108",0,0,0
"8213",1923,"109",0,0,0
"8214",1923,"110+",0,0,0
"8215",1924,"0",87447,91698,179145
"8216",1924,"1",83081,86676,169757
"8217",1924,"2",84332,87133,171465
"8218",1924,"3",85700,88782,174482
"8219",1924,"4",72027,75062,147089
"8220",1924,"5",70815,73378,144193
"8221",1924,"6",72655,74718,147373
"8222",1924,"7",73485,75679,149164
"8223",1924,"8",71823,74219,146042
"8224",1924,"9",76115,78153,154268
"8225",1924,"10",75402,76825,152227
"8226",1924,"11",74695,76288,150983
"8227",1924,"12",70191,70686,140877
"8228",1924,"13",71383,72583,143966
"8229",1924,"14",72700,73429,146129
"8230",1924,"15",71960,72469,144429
"8231",1924,"16",71001,71363,142364
"8232",1924,"17",69703,69609,139312
"8233",1924,"18",68843,69017,137860
"8234",1924,"19",68128,68374,136502
"8235",1924,"20",66318,66518,132836
"8236",1924,"21",66012,66274,132286
"8237",1924,"22",64102,63552,127654
"8238",1924,"23",61172,60285,121457
"8239",1924,"24",60486,59311,119797
"8240",1924,"25",59510,58290,117800
"8241",1924,"26",59298,57584,116882
"8242",1924,"27",58594,57183,115777
"8243",1924,"28",56284,54598,110882
"8244",1924,"29",55171,53177,108348
"8245",1924,"30",54991,53138,108129
"8246",1924,"31",50974,48984,99958
"8247",1924,"32",51630,49759,101389
"8248",1924,"33",49150,47138,96288
"8249",1924,"34",48130,46396,94526
"8250",1924,"35",48032,46639,94671
"8251",1924,"36",46934,45654,92588
"8252",1924,"37",46712,44615,91327
"8253",1924,"38",45664,44294,89958
"8254",1924,"39",44371,42985,87356
"8255",1924,"40",42517,41045,83562
"8256",1924,"41",43052,41451,84503
"8257",1924,"42",41247,40161,81408
"8258",1924,"43",40914,39158,80072
"8259",1924,"44",41155,39762,80917
"8260",1924,"45",39838,38625,78463
"8261",1924,"46",39228,38144,77372
"8262",1924,"47",38876,37452,76328
"8263",1924,"48",36877,35756,72633
"8264",1924,"49",36007,34885,70892
"8265",1924,"50",35575,33973,69548
"8266",1924,"51",33999,32516,66515
"8267",1924,"52",31204,29932,61136
"8268",1924,"53",31195,29837,61032
"8269",1924,"54",29682,28444,58126
"8270",1924,"55",29499,27932,57431
"8271",1924,"56",28662,27891,56553
"8272",1924,"57",28386,27246,55632
"8273",1924,"58",27427,26057,53484
"8274",1924,"59",26743,25262,52005
"8275",1924,"60",26130,25055,51185
"8276",1924,"61",23016,22146,45162
"8277",1924,"62",22995,21913,44908
"8278",1924,"63",20374,19479,39853
"8279",1924,"64",20550,19229,39779
"8280",1924,"65",18332,17301,35633
"8281",1924,"66",18298,16936,35234
"8282",1924,"67",17175,16118,33293
"8283",1924,"68",15972,14834,30806
"8284",1924,"69",15425,14152,29577
"8285",1924,"70",14641,13366,28007
"8286",1924,"71",14603,13177,27780
"8287",1924,"72",13458,12115,25573
"8288",1924,"73",12585,11333,23918
"8289",1924,"74",11807,10381,22188
"8290",1924,"75",9347,8373,17720
"8291",1924,"76",7888,6723,14611
"8292",1924,"77",7502,6381,13883
"8293",1924,"78",7249,6291,13540
"8294",1924,"79",6723,5638,12361
"8295",1924,"80",5776,4705,10481
"8296",1924,"81",4850,4129,8979
"8297",1924,"82",4263,3473,7736
"8298",1924,"83",3693,2965,6658
"8299",1924,"84",3045,2378,5423
"8300",1924,"85",2555,1913,4468
"8301",1924,"86",1857,1454,3311
"8302",1924,"87",1511,1108,2619
"8303",1924,"88",1160,790,1950
"8304",1924,"89",791,572,1363
"8305",1924,"90",640,408,1048
"8306",1924,"91",432,249,681
"8307",1924,"92",284,213,497
"8308",1924,"93",183,126,309
"8309",1924,"94",120.75,82,202.75
"8310",1924,"95",82.25,52,134.25
"8311",1924,"96",40,28,68
"8312",1924,"97",39,19,58
"8313",1924,"98",14,8,22
"8314",1924,"99",12,6,18
"8315",1924,"100",7.46,1,8.46
"8316",1924,"101",6.54,1,7.54
"8317",1924,"102",3,1,4
"8318",1924,"103",0,0,0
"8319",1924,"104",0,1,1
"8320",1924,"105",0,0,0
"8321",1924,"106",0,0,0
"8322",1924,"107",0,0,0
"8323",1924,"108",0,0,0
"8324",1924,"109",0,0,0
"8325",1924,"110+",0,0,0
"8326",1925,"0",85564,89310,174874
"8327",1925,"1",85574,89286,174860
"8328",1925,"2",82512,85958,168470
"8329",1925,"3",84049,86726,170775
"8330",1925,"4",85538,88582,174120
"8331",1925,"5",71894,74895,146789
"8332",1925,"6",70701,73239,143940
"8333",1925,"7",72565,74616,147181
"8334",1925,"8",73427,75609,149036
"8335",1925,"9",71833,74169,146002
"8336",1925,"10",76136,78106,154242
"8337",1925,"11",75479,76796,152275
"8338",1925,"12",74846,76224,151070
"8339",1925,"13",70342,70658,141000
"8340",1925,"14",71509,72496,144005
"8341",1925,"15",72844,73288,146132
"8342",1925,"16",72041,72238,144279
"8343",1925,"17",71047,71077,142124
"8344",1925,"18",69752,69264,139016
"8345",1925,"19",68830,68642,137472
"8346",1925,"20",68064,67948,136012
"8347",1925,"21",66267,66099,132366
"8348",1925,"22",65928,65825,131753
"8349",1925,"23",64055,63136,127191
"8350",1925,"24",61039,59885,120924
"8351",1925,"25",60400,59006,119406
"8352",1925,"26",59378,57997,117375
"8353",1925,"27",59159,57303,116462
"8354",1925,"28",58460,56938,115398
"8355",1925,"29",56134,54346,110480
"8356",1925,"30",55022,52960,107982
"8357",1925,"31",54864,52921,107785
"8358",1925,"32",50772,48787,99559
"8359",1925,"33",51478,49609,101087
"8360",1925,"34",48913,46927,95840
"8361",1925,"35",47970,46261,94231
"8362",1925,"36",47833,46482,94315
"8363",1925,"37",46756,45478,92234
"8364",1925,"38",46524,44411,90935
"8365",1925,"39",45460,44089,89549
"8366",1925,"40",44173,42780,86953
"8367",1925,"41",42324,40874,83198
"8368",1925,"42",42797,41254,84051
"8369",1925,"43",41045,39958,81003
"8370",1925,"44",40661,38929,79590
"8371",1925,"45",40932,39542,80474
"8372",1925,"46",39588,38413,78001
"8373",1925,"47",39006,37912,76918
"8374",1925,"48",38620,37209,75829
"8375",1925,"49",36593,35484,72077
"8376",1925,"50",35713,34615,70328
"8377",1925,"51",35273,33718,68991
"8378",1925,"52",33638,32209,65847
"8379",1925,"53",30910,29669,60579
"8380",1925,"54",30804,29473,60277
"8381",1925,"55",29345,28139,57484
"8382",1925,"56",29107,27582,56689
"8383",1925,"57",28308,27503,55811
"8384",1925,"58",28002,26830,54832
"8385",1925,"59",27046,25595,52641
"8386",1925,"60",26298,24806,51104
"8387",1925,"61",25689,24608,50297
"8388",1925,"62",22573,21711,44284
"8389",1925,"63",22503,21402,43905
"8390",1925,"64",19878,18999,38877
"8391",1925,"65",20045,18632,38677
"8392",1925,"66",17815,16758,34573
"8393",1925,"67",17694,16372,34066
"8394",1925,"68",16579,15506,32085
"8395",1925,"69",15333,14253,29586
"8396",1925,"70",14791,13510,28301
"8397",1925,"71",13970,12696,26666
"8398",1925,"72",13850,12447,26297
"8399",1925,"73",12714,11378,24092
"8400",1925,"74",11802,10577,22379
"8401",1925,"75",10985,9656,20641
"8402",1925,"76",8610,7741,16351
"8403",1925,"77",7285,6158,13443
"8404",1925,"78",6785,5768,12553
"8405",1925,"79",6558,5672,12230
"8406",1925,"80",5936,4931,10867
"8407",1925,"81",5143,4107,9250
"8408",1925,"82",4228,3581,7809
"8409",1925,"83",3716,2990,6706
"8410",1925,"84",3127,2491,5618
"8411",1925,"85",2536,1961,4497
"8412",1925,"86",2125,1572,3697
"8413",1925,"87",1509,1131,2640
"8414",1925,"88",1180,864,2044
"8415",1925,"89",924,607,1531
"8416",1925,"90",588,432,1020
"8417",1925,"91",473,296,769
"8418",1925,"92",319,168,487
"8419",1925,"93",204,151,355
"8420",1925,"94",124,73,197
"8421",1925,"95",79.75,59,138.75
"8422",1925,"96",55.25,35,90.25
"8423",1925,"97",25,17,42
"8424",1925,"98",30,14,44
"8425",1925,"99",9,4,13
"8426",1925,"100",5,2,7
"8427",1925,"101",5.46,1,6.46
"8428",1925,"102",3.54,1,4.54
"8429",1925,"103",1,0,1
"8430",1925,"104",0,0,0
"8431",1925,"105",0,0,0
"8432",1925,"106",0,0,0
"8433",1925,"107",0,0,0
"8434",1925,"108",0,0,0
"8435",1925,"109",0,0,0
"8436",1925,"110+",0,0,0
"8437",1926,"0",83834,87534,171368
"8438",1926,"1",83714,86862,170576
"8439",1926,"2",84963,88529,173492
"8440",1926,"3",82260,85601,167861
"8441",1926,"4",83848,86453,170301
"8442",1926,"5",85375,88400,173775
"8443",1926,"6",71782,74749,146531
"8444",1926,"7",70601,73111,143712
"8445",1926,"8",72487,74505,146992
"8446",1926,"9",73393,75551,148944
"8447",1926,"10",71843,74135,145978
"8448",1926,"11",76167,78062,154229
"8449",1926,"12",75557,76758,152315
"8450",1926,"13",74968,76157,151125
"8451",1926,"14",70483,70628,141111
"8452",1926,"15",71657,72366,144023
"8453",1926,"16",72972,73100,146072
"8454",1926,"17",72122,71973,144095
"8455",1926,"18",71101,70746,141847
"8456",1926,"19",69788,68913,138701
"8457",1926,"20",68802,68256,137058
"8458",1926,"21",68029,67543,135572
"8459",1926,"22",66217,65690,131907
"8460",1926,"23",65837,65380,131217
"8461",1926,"24",64017,62719,126736
"8462",1926,"25",60926,59509,120435
"8463",1926,"26",60288,58707,118995
"8464",1926,"27",59246,57724,116970
"8465",1926,"28",59014,57061,116075
"8466",1926,"29",58330,56689,115019
"8467",1926,"30",55979,54122,110101
"8468",1926,"31",54867,52741,107608
"8469",1926,"32",54725,52714,107439
"8470",1926,"33",50566,48590,99156
"8471",1926,"34",51330,49453,100783
"8472",1926,"35",48678,46727,95405
"8473",1926,"36",47833,46117,93950
"8474",1926,"37",47650,46327,93977
"8475",1926,"38",46581,45299,91880
"8476",1926,"39",46298,44216,90514
"8477",1926,"40",45217,43923,89140
"8478",1926,"41",43978,42600,86578
"8479",1926,"42",42137,40686,82823
"8480",1926,"43",42541,41079,83620
"8481",1926,"44",40871,39752,80623
"8482",1926,"45",40405,38702,79107
"8483",1926,"46",40748,39321,80069
"8484",1926,"47",39301,38192,77493
"8485",1926,"48",38779,37676,76455
"8486",1926,"49",38353,36913,75266
"8487",1926,"50",36304,35191,71495
"8488",1926,"51",35433,34361,69794
"8489",1926,"52",34959,33396,68355
"8490",1926,"53",33300,31871,65171
"8491",1926,"54",30615,29361,59976
"8492",1926,"55",30411,29108,59519
"8493",1926,"56",28987,27798,56785
"8494",1926,"57",28733,27198,55931
"8495",1926,"58",27948,27090,55038
"8496",1926,"59",27600,26444,54044
"8497",1926,"60",26586,25142,51728
"8498",1926,"61",25769,24300,50069
"8499",1926,"62",25220,24112,49332
"8500",1926,"63",22044,21168,43212
"8501",1926,"64",22005,20877,42882
"8502",1926,"65",19368,18494,37862
"8503",1926,"66",19509,18038,37547
"8504",1926,"67",17233,16215,33448
"8505",1926,"68",17035,15767,32802
"8506",1926,"69",15964,14853,30817
"8507",1926,"70",14707,13574,28281
"8508",1926,"71",14115,12818,26933
"8509",1926,"72",13305,11998,25303
"8510",1926,"73",13003,11674,24677
"8511",1926,"74",11943,10671,22614
"8512",1926,"75",10975,9857,20832
"8513",1926,"76",10127,8905,19032
"8514",1926,"77",7881,7042,14923
"8515",1926,"78",6605,5508,12113
"8516",1926,"79",6148,5153,11301
"8517",1926,"80",5805,5030,10835
"8518",1926,"81",5204,4321,9525
"8519",1926,"82",4491,3569,8060
"8520",1926,"83",3684,3043,6727
"8521",1926,"84",3159,2482,5641
"8522",1926,"85",2609,2050,4659
"8523",1926,"86",2107,1579,3686
"8524",1926,"87",1711,1242,2953
"8525",1926,"88",1229,847,2076
"8526",1926,"89",923,658,1581
"8527",1926,"90",714,465,1179
"8528",1926,"91",431,305,736
"8529",1926,"92",320,209,529
"8530",1926,"93",221,115,336
"8531",1926,"94",137,106,243
"8532",1926,"95",78,49,127
"8533",1926,"96",42.75,38,80.75
"8534",1926,"97",33.25,18,51.25
"8535",1926,"98",13,7,20
"8536",1926,"99",15,8,23
"8537",1926,"100",6,3,9
"8538",1926,"101",2,1,3
"8539",1926,"102",2.46,1,3.46
"8540",1926,"103",2.54,0,2.54
"8541",1926,"104",0,0,0
"8542",1926,"105",0,0,0
"8543",1926,"106",0,0,0
"8544",1926,"107",0,0,0
"8545",1926,"108",0,0,0
"8546",1926,"109",0,0,0
"8547",1926,"110+",0,0,0
"8548",1927,"0",82958,87132,170090
"8549",1927,"1",81847,85063,166910
"8550",1927,"2",83074,86055,169129
"8551",1927,"3",84668,88135,172803
"8552",1927,"4",82076,85364,167440
"8553",1927,"5",83689,86242,169931
"8554",1927,"6",85264,88271,173535
"8555",1927,"7",71711,74637,146348
"8556",1927,"8",70517,73020,143537
"8557",1927,"9",72411,74409,146820
"8558",1927,"10",73347,75495,148842
"8559",1927,"11",71851,74090,145941
"8560",1927,"12",76202,78033,154235
"8561",1927,"13",75627,76721,152348
"8562",1927,"14",75085,76114,151199
"8563",1927,"15",70638,70583,141221
"8564",1927,"16",71782,72237,144019
"8565",1927,"17",73086,72919,146005
"8566",1927,"18",72209,71682,143891
"8567",1927,"19",71151,70414,141565
"8568",1927,"20",69829,68557,138386
"8569",1927,"21",68789,67880,136669
"8570",1927,"22",67983,67115,135098
"8571",1927,"23",66171,65291,131462
"8572",1927,"24",65762,64938,130700
"8573",1927,"25",63986,62328,126314
"8574",1927,"26",60810,59133,119943
"8575",1927,"27",60182,58410,118592
"8576",1927,"28",59143,57451,116594
"8577",1927,"29",58905,56782,115687
"8578",1927,"30",58195,56448,114643
"8579",1927,"31",55818,53890,109708
"8580",1927,"32",54720,52513,107233
"8581",1927,"33",54580,52526,107106
"8582",1927,"34",50372,48404,98776
"8583",1927,"35",51198,49304,100502
"8584",1927,"36",48457,46531,94988
"8585",1927,"37",47664,45959,93623
"8586",1927,"38",47427,46163,93590
"8587",1927,"39",46363,45138,91501
"8588",1927,"40",46105,44036,90141
"8589",1927,"41",44996,43752,88748
"8590",1927,"42",43794,42413,86207
"8591",1927,"43",41959,40515,82474
"8592",1927,"44",42276,40877,83153
"8593",1927,"45",40697,39562,80259
"8594",1927,"46",40155,38447,78602
"8595",1927,"47",40458,39084,79542
"8596",1927,"48",39063,37974,77037
"8597",1927,"49",38506,37426,75932
"8598",1927,"50",38063,36636,74699
"8599",1927,"51",35999,34868,70867
"8600",1927,"52",35112,34036,69148
"8601",1927,"53",34618,33081,67699
"8602",1927,"54",32913,31524,64437
"8603",1927,"55",30285,29038,59323
"8604",1927,"56",30012,28725,58737
"8605",1927,"57",28611,27425,56036
"8606",1927,"58",28322,26789,55111
"8607",1927,"59",27537,26699,54236
"8608",1927,"60",27163,25992,53155
"8609",1927,"61",26116,24620,50736
"8610",1927,"62",25289,23794,49083
"8611",1927,"63",24711,23583,48294
"8612",1927,"64",21507,20648,42155
"8613",1927,"65",21432,20264,41696
"8614",1927,"66",18777,17921,36698
"8615",1927,"67",18902,17417,36319
"8616",1927,"68",16598,15601,32199
"8617",1927,"69",16405,15167,31572
"8618",1927,"70",15290,14193,29483
"8619",1927,"71",13976,12865,26841
"8620",1927,"72",13438,12131,25569
"8621",1927,"73",12581,11302,23883
"8622",1927,"74",12187,10914,23101
"8623",1927,"75",11119,9898,21017
"8624",1927,"76",10105,9020,19125
"8625",1927,"77",9280,8152,17432
"8626",1927,"78",7162,6391,13553
"8627",1927,"79",5939,4941,10880
"8628",1927,"80",5485,4560,10045
"8629",1927,"81",5137,4384,9521
"8630",1927,"82",4544,3752,8296
"8631",1927,"83",3856,3043,6899
"8632",1927,"84",3101,2522,5623
"8633",1927,"85",2671,2024,4695
"8634",1927,"86",2164,1679,3843
"8635",1927,"87",1682,1255,2937
"8636",1927,"88",1356,962,2318
"8637",1927,"89",951,645,1596
"8638",1927,"90",720,492,1212
"8639",1927,"91",548,317,865
"8640",1927,"92",328,212,540
"8641",1927,"93",253,147,400
"8642",1927,"94",151,78,229
"8643",1927,"95",88,69,157
"8644",1927,"96",58,31,89
"8645",1927,"97",30.75,29,59.75
"8646",1927,"98",19.25,10,29.25
"8647",1927,"99",7,5,12
"8648",1927,"100",6,5,11
"8649",1927,"101",3,2,5
"8650",1927,"102",2,0,2
"8651",1927,"103",0.46,1,1.46
"8652",1927,"104",0.54,0,0.54
"8653",1927,"105",0,0,0
"8654",1927,"106",0,0,0
"8655",1927,"107",0,0,0
"8656",1927,"108",0,0,0
"8657",1927,"109",0,0,0
"8658",1927,"110+",0,0,0
"8659",1928,"0",82118,86103,168221
"8660",1928,"1",81110,84683,165793
"8661",1928,"2",81214,84283,165497
"8662",1928,"3",82784,85685,168469
"8663",1928,"4",84491,87895,172386
"8664",1928,"5",81924,85170,167094
"8665",1928,"6",83559,86072,169631
"8666",1928,"7",85201,88163,173364
"8667",1928,"8",71649,74529,146178
"8668",1928,"9",70457,72941,143398
"8669",1928,"10",72341,74323,146664
"8670",1928,"11",73289,75448,148737
"8671",1928,"12",71855,74064,145919
"8672",1928,"13",76222,77991,154213
"8673",1928,"14",75701,76694,152395
"8674",1928,"15",75197,76052,151249
"8675",1928,"16",70763,70527,141290
"8676",1928,"17",71888,72084,143972
"8677",1928,"18",73169,72706,145875
"8678",1928,"19",72265,71409,143674
"8679",1928,"20",71186,70093,141279
"8680",1928,"21",69853,68217,138070
"8681",1928,"22",68760,67507,136267
"8682",1928,"23",67949,66698,134647
"8683",1928,"24",66139,64870,131009
"8684",1928,"25",65672,64494,130166
"8685",1928,"26",63919,61921,125840
"8686",1928,"27",60703,58768,119471
"8687",1928,"28",60095,58109,118204
"8688",1928,"29",59020,57177,116197
"8689",1928,"30",58784,56519,115303
"8690",1928,"31",58065,56217,114282
"8691",1928,"32",55683,53631,109314
"8692",1928,"33",54598,52292,106890
"8693",1928,"34",54419,52288,106707
"8694",1928,"35",50160,48223,98383
"8695",1928,"36",51047,49118,100165
"8696",1928,"37",48213,46328,94541
"8697",1928,"38",47496,45803,93299
"8698",1928,"39",47212,45971,93183
"8699",1928,"40",46175,44953,91128
"8700",1928,"41",45863,43825,89688
"8701",1928,"42",44768,43534,88302
"8702",1928,"43",43560,42202,85762
"8703",1928,"44",41776,40303,82079
"8704",1928,"45",42009,40648,82657
"8705",1928,"46",40506,39330,79836
"8706",1928,"47",39873,38213,78086
"8707",1928,"48",40154,38845,78999
"8708",1928,"49",38776,37667,76443
"8709",1928,"50",38226,37154,75380
"8710",1928,"51",37750,36315,74065
"8711",1928,"52",35669,34522,70191
"8712",1928,"53",34789,33708,68497
"8713",1928,"54",34277,32725,67002
"8714",1928,"55",32514,31172,63686
"8715",1928,"56",29920,28668,58588
"8716",1928,"57",29583,28310,57893
"8717",1928,"58",28198,27011,55209
"8718",1928,"59",27854,26339,54193
"8719",1928,"60",27106,26208,53314
"8720",1928,"61",26672,25516,52188
"8721",1928,"62",25610,24111,49721
"8722",1928,"63",24702,23242,47944
"8723",1928,"64",24111,22926,47037
"8724",1928,"65",20894,20042,40936
"8725",1928,"66",20848,19634,40482
"8726",1928,"67",18080,17289,35369
"8727",1928,"68",18156,16713,34869
"8728",1928,"69",15868,14937,30805
"8729",1928,"70",15669,14465,30134
"8730",1928,"71",14500,13454,27954
"8731",1928,"72",13208,12104,25312
"8732",1928,"73",12594,11356,23950
"8733",1928,"74",11751,10529,22280
"8734",1928,"75",11315,9997,21312
"8735",1928,"76",10212,9003,19215
"8736",1928,"77",9166,8171,17337
"8737",1928,"78",8360,7320,15680
"8738",1928,"79",6330,5682,12012
"8739",1928,"80",5276,4321,9597
"8740",1928,"81",4761,3932,8693
"8741",1928,"82",4417,3700,8117
"8742",1928,"83",3824,3181,7005
"8743",1928,"84",3197,2493,5690
"8744",1928,"85",2561,1999,4560
"8745",1928,"86",2107,1590,3697
"8746",1928,"87",1717,1284,3001
"8747",1928,"88",1286,931,2217
"8748",1928,"89",1014,706,1720
"8749",1928,"90",685,474,1159
"8750",1928,"91",539,329,868
"8751",1928,"92",395,226,621
"8752",1928,"93",203,140,343
"8753",1928,"94",160,89,249
"8754",1928,"95",92,47,139
"8755",1928,"96",58,33,91
"8756",1928,"97",35,13,48
"8757",1928,"98",16.75,19,35.75
"8758",1928,"99",14.25,7,21.25
"8759",1928,"100",5,3,8
"8760",1928,"101",3,3,6
"8761",1928,"102",2,0,2
"8762",1928,"103",0,0,0
"8763",1928,"104",0.46,0,0.46
"8764",1928,"105",0.54,0,0.54
"8765",1928,"106",0,0,0
"8766",1928,"107",0,0,0
"8767",1928,"108",0,0,0
"8768",1928,"109",0,0,0
"8769",1928,"110+",0,0,0
"8770",1929,"0",84601,88111,172712
"8771",1929,"1",80645,84152,164797
"8772",1929,"2",80587,84025,164612
"8773",1929,"3",80993,83972,164965
"8774",1929,"4",82656,85464,168120
"8775",1929,"5",84404,87750,172154
"8776",1929,"6",81834,85057,166891
"8777",1929,"7",83459,85918,169377
"8778",1929,"8",85141,88066,173207
"8779",1929,"9",71594,74446,146040
"8780",1929,"10",70380,72869,143249
"8781",1929,"11",72287,74248,146535
"8782",1929,"12",73258,75391,148649
"8783",1929,"13",71863,74042,145905
"8784",1929,"14",76235,77926,154161
"8785",1929,"15",75749,76642,152391
"8786",1929,"16",75299,75952,151251
"8787",1929,"17",70881,70449,141330
"8788",1929,"18",71990,71900,143890
"8789",1929,"19",73283,72491,145774
"8790",1929,"20",72340,71123,143463
"8791",1929,"21",71226,69754,140980
"8792",1929,"22",69905,67846,137751
"8793",1929,"23",68739,67137,135876
"8794",1929,"24",67923,66298,134221
"8795",1929,"25",66099,64490,130589
"8796",1929,"26",65584,64080,129664
"8797",1929,"27",63878,61557,125435
"8798",1929,"28",60568,58412,118980
"8799",1929,"29",59973,57813,117786
"8800",1929,"30",58915,56922,115837
"8801",1929,"31",58626,56264,114890
"8802",1929,"32",57923,55942,113865
"8803",1929,"33",55537,53393,108930
"8804",1929,"34",54465,52093,106558
"8805",1929,"35",54273,52091,106364
"8806",1929,"36",49946,48024,97970
"8807",1929,"37",50882,48921,99803
"8808",1929,"38",47966,46122,94088
"8809",1929,"39",47332,45642,92974
"8810",1929,"40",46983,45797,92780
"8811",1929,"41",45980,44734,90714
"8812",1929,"42",45615,43615,89230
"8813",1929,"43",44550,43328,87878
"8814",1929,"44",43340,41977,85317
"8815",1929,"45",41584,40107,81691
"8816",1929,"46",41744,40408,82152
"8817",1929,"47",40288,39116,79404
"8818",1929,"48",39574,37957,77531
"8819",1929,"49",39895,38583,78478
"8820",1929,"50",38471,37363,75834
"8821",1929,"51",37927,36912,74839
"8822",1929,"52",37386,35982,73368
"8823",1929,"53",35295,34208,69503
"8824",1929,"54",34453,33350,67803
"8825",1929,"55",33942,32344,66286
"8826",1929,"56",32083,30764,62847
"8827",1929,"57",29552,28277,57829
"8828",1929,"58",29113,27811,56924
"8829",1929,"59",27820,26569,54389
"8830",1929,"60",27328,25868,53196
"8831",1929,"61",26598,25690,52288
"8832",1929,"62",26112,24956,51068
"8833",1929,"63",25024,23571,48595
"8834",1929,"64",24114,22627,46741
"8835",1929,"65",23491,22296,45787
"8836",1929,"66",20268,19384,39652
"8837",1929,"67",20231,18959,39190
"8838",1929,"68",17413,16569,33982
"8839",1929,"69",17440,16030,33470
"8840",1929,"70",15204,14246,29450
"8841",1929,"71",14932,13737,28669
"8842",1929,"72",13718,12698,26416
"8843",1929,"73",12417,11397,23814
"8844",1929,"74",11783,10581,22364
"8845",1929,"75",10947,9762,20709
"8846",1929,"76",10460,9195,19655
"8847",1929,"77",9362,8196,17558
"8848",1929,"78",8354,7401,15755
"8849",1929,"79",7525,6556,14081
"8850",1929,"80",5616,4945,10561
"8851",1929,"81",4644,3760,8404
"8852",1929,"82",4124,3404,7528
"8853",1929,"83",3790,3133,6923
"8854",1929,"84",3257,2678,5935
"8855",1929,"85",2612,2048,4660
"8856",1929,"86",2118,1607,3725
"8857",1929,"87",1705,1264,2969
"8858",1929,"88",1358,1016,2374
"8859",1929,"89",992,705,1697
"8860",1929,"90",772,523,1295
"8861",1929,"91",516,327,843
"8862",1929,"92",389,240,629
"8863",1929,"93",278,149,427
"8864",1929,"94",131,109,240
"8865",1929,"95",111,57,168
"8866",1929,"96",60,25,85
"8867",1929,"97",34,16,50
"8868",1929,"98",21,11,32
"8869",1929,"99",11.75,9,20.75
"8870",1929,"100",5.25,4,9.25
"8871",1929,"101",2,2,4
"8872",1929,"102",1,1,2
"8873",1929,"103",1,0,1
"8874",1929,"104",0,0,0
"8875",1929,"105",0,0,0
"8876",1929,"106",0,0,0
"8877",1929,"107",0,0,0
"8878",1929,"108",0,0,0
"8879",1929,"109",0,0,0
"8880",1929,"110+",0,0,0
"8881",1930,"0",83474,87411,170885
"8882",1930,"1",82754,85622,168376
"8883",1930,"2",80121,83454,163575
"8884",1930,"3",80346,83676,164022
"8885",1930,"4",80834,83777,164611
"8886",1930,"5",82537,85316,167853
"8887",1930,"6",84325,87624,171949
"8888",1930,"7",81759,84944,166703
"8889",1930,"8",83407,85801,169208
"8890",1930,"9",85096,87984,173080
"8891",1930,"10",71530,74371,145901
"8892",1930,"11",70316,72799,143115
"8893",1930,"12",72233,74186,146419
"8894",1930,"13",73225,75332,148557
"8895",1930,"14",71844,73994,145838
"8896",1930,"15",76239,77886,154125
"8897",1930,"16",75759,76576,152335
"8898",1930,"17",75368,75842,151210
"8899",1930,"18",70972,70339,141311
"8900",1930,"19",72073,71716,143789
"8901",1930,"20",73360,72274,145634
"8902",1930,"21",72380,70803,143183
"8903",1930,"22",71247,69399,140646
"8904",1930,"23",69925,67462,137387
"8905",1930,"24",68721,66767,135488
"8906",1930,"25",67862,65895,133757
"8907",1930,"26",66030,64083,130113
"8908",1930,"27",65495,63655,129150
"8909",1930,"28",63789,61169,124958
"8910",1930,"29",60412,58025,118437
"8911",1930,"30",59888,57523,117411
"8912",1930,"31",58764,56680,115444
"8913",1930,"32",58477,56002,114479
"8914",1930,"33",57772,55696,113468
"8915",1930,"34",55353,53151,108504
"8916",1930,"35",54293,51855,106148
"8917",1930,"36",54099,51857,105956
"8918",1930,"37",49726,47815,97541
"8919",1930,"38",50701,48728,99429
"8920",1930,"39",47689,45906,93595
"8921",1930,"40",47124,45455,92579
"8922",1930,"41",46753,45595,92348
"8923",1930,"42",45759,44517,90276
"8924",1930,"43",45354,43393,88747
"8925",1930,"44",44305,43116,87421
"8926",1930,"45",43100,41760,84860
"8927",1930,"46",41333,39854,81187
"8928",1930,"47",41461,40150,81611
"8929",1930,"48",40026,38859,78885
"8930",1930,"49",39239,37657,76896
"8931",1930,"50",39574,38283,77857
"8932",1930,"51",38090,37029,75119
"8933",1930,"52",37592,36590,74182
"8934",1930,"53",36995,35598,72593
"8935",1930,"54",34852,33790,68642
"8936",1930,"55",34064,32954,67018
"8937",1930,"56",33518,31915,65433
"8938",1930,"57",31630,30239,61869
"8939",1930,"58",29139,27835,56974
"8940",1930,"59",28562,27310,55872
"8941",1930,"60",27347,26090,53437
"8942",1930,"61",26803,25366,52169
"8943",1930,"62",26042,25084,51126
"8944",1930,"63",25492,24309,49801
"8945",1930,"64",24387,22869,47256
"8946",1930,"65",23383,21940,45323
"8947",1930,"66",22798,21523,44321
"8948",1930,"67",19534,18649,38183
"8949",1930,"68",19499,18182,37681
"8950",1930,"69",16675,15789,32464
"8951",1930,"70",16662,15130,31792
"8952",1930,"71",14351,13458,27809
"8953",1930,"72",14041,12875,26916
"8954",1930,"73",12828,11836,24664
"8955",1930,"74",11534,10503,22037
"8956",1930,"75",10806,9711,20517
"8957",1930,"76",9973,8822,18795
"8958",1930,"77",9447,8249,17696
"8959",1930,"78",8383,7283,15666
"8960",1930,"79",7365,6464,13829
"8961",1930,"80",6588,5688,12276
"8962",1930,"81",4880,4197,9077
"8963",1930,"82",3913,3153,7066
"8964",1930,"83",3419,2820,6239
"8965",1930,"84",3153,2497,5650
"8966",1930,"85",2632,2135,4767
"8967",1930,"86",2040,1593,3633
"8968",1930,"87",1645,1221,2866
"8969",1930,"88",1273,938,2211
"8970",1930,"89",971,742,1713
"8971",1930,"90",685,489,1174
"8972",1930,"91",524,374,898
"8973",1930,"92",344,203,547
"8974",1930,"93",254,146,400
"8975",1930,"94",170,104,274
"8976",1930,"95",88,70,158
"8977",1930,"96",67,35,102
"8978",1930,"97",31,15,46
"8979",1930,"98",23,9,32
"8980",1930,"99",10,7,17
"8981",1930,"100",7.75,2,9.75
"8982",1930,"101",2.25,2,4.25
"8983",1930,"102",1,1,2
"8984",1930,"103",1,0,1
"8985",1930,"104",1,0,1
"8986",1930,"105",0,0,0
"8987",1930,"106",0,0,0
"8988",1930,"107",0,0,0
"8989",1930,"108",0,0,0
"8990",1930,"109",0,0,0
"8991",1930,"110+",0,0,0
"8992",1931,"0",84830,89424,174254
"8993",1931,"1",82093,85585,167678
"8994",1931,"2",82312,85073,167385
"8995",1931,"3",79903,83150,163053
"8996",1931,"4",80189,83454,163643
"8997",1931,"5",80723,83602,164325
"8998",1931,"6",82434,85174,167608
"8999",1931,"7",84236,87484,171720
"9000",1931,"8",81701,84850,166551
"9001",1931,"9",83331,85700,169031
"9002",1931,"10",85027,87915,172942
"9003",1931,"11",71472,74303,145775
"9004",1931,"12",70239,72738,142977
"9005",1931,"13",72178,74118,146296
"9006",1931,"14",73161,75266,148427
"9007",1931,"15",71781,73914,145695
"9008",1931,"16",76167,77794,153961
"9009",1931,"17",75722,76467,152189
"9010",1931,"18",75352,75706,151058
"9011",1931,"19",70971,70218,141189
"9012",1931,"20",72039,71549,143588
"9013",1931,"21",73349,72063,145412
"9014",1931,"22",72322,70568,142890
"9015",1931,"23",71207,69140,140347
"9016",1931,"24",69858,67196,137054
"9017",1931,"25",68612,66522,135134
"9018",1931,"26",67777,65625,133402
"9019",1931,"27",65923,63804,129727
"9020",1931,"28",65381,63362,128743
"9021",1931,"29",63673,60921,124594
"9022",1931,"30",60267,57779,118046
"9023",1931,"31",59762,57304,117066
"9024",1931,"32",58623,56466,115089
"9025",1931,"33",58308,55814,114122
"9026",1931,"34",57619,55518,113137
"9027",1931,"35",55190,52963,108153
"9028",1931,"36",54124,51641,105765
"9029",1931,"37",53924,51657,105581
"9030",1931,"38",49542,47642,97184
"9031",1931,"39",50534,48567,99101
"9032",1931,"40",47479,45714,93193
"9033",1931,"41",46916,45292,92208
"9034",1931,"42",46550,45436,91986
"9035",1931,"43",45569,44320,89889
"9036",1931,"44",45126,43194,88320
"9037",1931,"45",44089,42898,86987
"9038",1931,"46",42877,41542,84419
"9039",1931,"47",41101,39647,80748
"9040",1931,"48",41200,39900,81100
"9041",1931,"49",39783,38609,78392
"9042",1931,"50",38927,37376,76303
"9043",1931,"51",39310,37997,77307
"9044",1931,"52",37790,36721,74511
"9045",1931,"53",37268,36250,73518
"9046",1931,"54",36607,35244,71851
"9047",1931,"55",34452,33407,67859
"9048",1931,"56",33691,32555,66246
"9049",1931,"57",33078,31514,64592
"9050",1931,"58",31174,29817,60991
"9051",1931,"59",28729,27384,56113
"9052",1931,"60",28064,26841,54905
"9053",1931,"61",26892,25567,52459
"9054",1931,"62",26296,24843,51139
"9055",1931,"63",25480,24535,50015
"9056",1931,"64",24934,23735,48669
"9057",1931,"65",23774,22255,46029
"9058",1931,"66",22693,21281,43974
"9059",1931,"67",22122,20821,42943
"9060",1931,"68",18893,17949,36842
"9061",1931,"69",18780,17450,36230
"9062",1931,"70",15992,15093,31085
"9063",1931,"71",15890,14649,30539
"9064",1931,"72",13611,12736,26347
"9065",1931,"73",13281,12127,25408
"9066",1931,"74",12099,11113,23212
"9067",1931,"75",10774,9742,20516
"9068",1931,"76",9993,8984,18977
"9069",1931,"77",9196,8096,17292
"9070",1931,"78",8607,7476,16083
"9071",1931,"79",7638,6587,14225
"9072",1931,"80",6591,5721,12312
"9073",1931,"81",5810,5040,10850
"9074",1931,"82",4336,3639,7975
"9075",1931,"83",3413,2730,6143
"9076",1931,"84",2904,2387,5291
"9077",1931,"85",2654,2072,4726
"9078",1931,"86",2193,1741,3934
"9079",1931,"87",1678,1283,2961
"9080",1931,"88",1323,989,2312
"9081",1931,"89",1001,749,1750
"9082",1931,"90",755,570,1325
"9083",1931,"91",524,345,869
"9084",1931,"92",370,254,624
"9085",1931,"93",238,140,378
"9086",1931,"94",177,108,285
"9087",1931,"95",111,68,179
"9088",1931,"96",57,46,103
"9089",1931,"97",39,22,61
"9090",1931,"98",22,7,29
"9091",1931,"99",12,6,18
"9092",1931,"100",5,3,8
"9093",1931,"101",5.75,2,7.75
"9094",1931,"102",1.25,0,1.25
"9095",1931,"103",1,0,1
"9096",1931,"104",0,0,0
"9097",1931,"105",0,0,0
"9098",1931,"106",0,0,0
"9099",1931,"107",0,0,0
"9100",1931,"108",0,0,0
"9101",1931,"109",0,0,0
"9102",1931,"110+",0,0,0
"9103",1932,"0",83352,87955,171307
"9104",1932,"1",83157,87475,170632
"9105",1932,"2",81556,84937,166493
"9106",1932,"3",82025,84724,166749
"9107",1932,"4",79729,82897,162626
"9108",1932,"5",80038,83262,163300
"9109",1932,"6",80600,83450,164050
"9110",1932,"7",82321,85017,167338
"9111",1932,"8",84112,87345,171457
"9112",1932,"9",81619,84746,166365
"9113",1932,"10",83266,85615,168881
"9114",1932,"11",84957,87817,172774
"9115",1932,"12",71397,74224,145621
"9116",1932,"13",70166,72649,142815
"9117",1932,"14",72094,74018,146112
"9118",1932,"15",73051,75181,148232
"9119",1932,"16",71654,73809,145463
"9120",1932,"17",76027,77662,153689
"9121",1932,"18",75578,76312,151890
"9122",1932,"19",75196,75541,150737
"9123",1932,"20",70824,70050,140874
"9124",1932,"21",71888,71379,143267
"9125",1932,"22",73200,71863,145063
"9126",1932,"23",72149,70396,142545
"9127",1932,"24",71078,68943,140021
"9128",1932,"25",69707,67034,136741
"9129",1932,"26",68458,66353,134811
"9130",1932,"27",67580,65476,133056
"9131",1932,"28",65751,63654,129405
"9132",1932,"29",65218,63220,128438
"9133",1932,"30",63503,60770,124273
"9134",1932,"31",60107,57632,117739
"9135",1932,"32",59586,57145,116731
"9136",1932,"33",58447,56298,114745
"9137",1932,"34",58119,55664,113783
"9138",1932,"35",57439,55372,112811
"9139",1932,"36",54996,52801,107797
"9140",1932,"37",53951,51463,105414
"9141",1932,"38",53717,51507,105224
"9142",1932,"39",49349,47508,96857
"9143",1932,"40",50329,48391,98720
"9144",1932,"41",47296,45571,92867
"9145",1932,"42",46713,45122,91835
"9146",1932,"43",46327,45231,91558
"9147",1932,"44",45353,44125,89478
"9148",1932,"45",44907,42973,87880
"9149",1932,"46",43843,42709,86552
"9150",1932,"47",42621,41298,83919
"9151",1932,"48",40848,39413,80261
"9152",1932,"49",40950,39647,80597
"9153",1932,"50",39489,38337,77826
"9154",1932,"51",38623,37112,75735
"9155",1932,"52",38972,37671,76643
"9156",1932,"53",37424,36360,73784
"9157",1932,"54",36863,35884,72747
"9158",1932,"55",36191,34873,71064
"9159",1932,"56",34040,33005,67045
"9160",1932,"57",33269,32138,65407
"9161",1932,"58",32638,31085,63723
"9162",1932,"59",30718,29362,60080
"9163",1932,"60",28298,26887,55185
"9164",1932,"61",27532,26289,53821
"9165",1932,"62",26316,24991,51307
"9166",1932,"63",25706,24249,49955
"9167",1932,"64",24840,23912,48752
"9168",1932,"65",24239,23049,47288
"9169",1932,"66",23065,21557,44622
"9170",1932,"67",21971,20506,42477
"9171",1932,"68",21361,20021,41382
"9172",1932,"69",18131,17159,35290
"9173",1932,"70",17924,16677,34601
"9174",1932,"71",15260,14346,29606
"9175",1932,"72",15017,13837,28854
"9176",1932,"73",12778,11965,24743
"9177",1932,"74",12323,11261,23584
"9178",1932,"75",11299,10246,21545
"9179",1932,"76",9900,8894,18794
"9180",1932,"77",9089,8161,17250
"9181",1932,"78",8313,7249,15562
"9182",1932,"79",7638,6600,14238
"9183",1932,"80",6703,5760,12463
"9184",1932,"81",5724,4935,10659
"9185",1932,"82",4992,4237,9229
"9186",1932,"83",3697,3038,6735
"9187",1932,"84",2813,2254,5067
"9188",1932,"85",2380,1936,4316
"9189",1932,"86",2133,1631,3764
"9190",1932,"87",1688,1347,3035
"9191",1932,"88",1282,981,2263
"9192",1932,"89",1003,712,1715
"9193",1932,"90",735,534,1269
"9194",1932,"91",539,405,944
"9195",1932,"92",358,222,580
"9196",1932,"93",256,171,427
"9197",1932,"94",151,80,231
"9198",1932,"95",106,67,173
"9199",1932,"96",70,45,115
"9200",1932,"97",31,26,57
"9201",1932,"98",19,10,29
"9202",1932,"99",13,2,15
"9203",1932,"100",6,3,9
"9204",1932,"101",3,2,5
"9205",1932,"102",3.75,0,3.75
"9206",1932,"103",0.25,0,0.25
"9207",1932,"104",1,0,1
"9208",1932,"105",0,0,0
"9209",1932,"106",0,0,0
"9210",1932,"107",0,0,0
"9211",1932,"108",0,0,0
"9212",1932,"109",0,0,0
"9213",1932,"110+",0,0,0
"9214",1933,"0",83933,88436,172369
"9215",1933,"1",82131,86270,168401
"9216",1933,"2",82684,86894,169578
"9217",1933,"3",81322,84610,165932
"9218",1933,"4",81857,84529,166386
"9219",1933,"5",79580,82716,162296
"9220",1933,"6",79916,83105,163021
"9221",1933,"7",80497,83298,163795
"9222",1933,"8",82227,84896,167123
"9223",1933,"9",84028,87238,171266
"9224",1933,"10",81529,84654,166183
"9225",1933,"11",83202,85518,168720
"9226",1933,"12",84881,87720,172601
"9227",1933,"13",71330,74156,145486
"9228",1933,"14",70103,72573,142676
"9229",1933,"15",72018,73927,145945
"9230",1933,"16",72957,75082,148039
"9231",1933,"17",71545,73683,145228
"9232",1933,"18",75894,77521,153415
"9233",1933,"19",75434,76131,151565
"9234",1933,"20",75051,75381,150432
"9235",1933,"21",70683,69891,140574
"9236",1933,"22",71738,71229,142967
"9237",1933,"23",73056,71711,144767
"9238",1933,"24",72005,70253,142258
"9239",1933,"25",70930,68796,139726
"9240",1933,"26",69568,66877,136445
"9241",1933,"27",68311,66202,134513
"9242",1933,"28",67438,65331,132769
"9243",1933,"29",65615,63525,129140
"9244",1933,"30",65040,63080,128120
"9245",1933,"31",63333,60635,123968
"9246",1933,"32",59952,57505,117457
"9247",1933,"33",59425,57023,116448
"9248",1933,"34",58285,56171,114456
"9249",1933,"35",57940,55520,113460
"9250",1933,"36",57244,55227,112471
"9251",1933,"37",54810,52674,107484
"9252",1933,"38",53775,51325,105100
"9253",1933,"39",53548,51350,104898
"9254",1933,"40",49125,47361,96486
"9255",1933,"41",50158,48240,98398
"9256",1933,"42",47106,45400,92506
"9257",1933,"43",46513,44962,91475
"9258",1933,"44",46101,45042,91143
"9259",1933,"45",45156,43928,89084
"9260",1933,"46",44663,42784,87447
"9261",1933,"47",43570,42474,86044
"9262",1933,"48",42379,41064,83443
"9263",1933,"49",40592,39156,79748
"9264",1933,"50",40649,39379,80028
"9265",1933,"51",39188,38068,77256
"9266",1933,"52",38309,36800,75109
"9267",1933,"53",38596,37340,75936
"9268",1933,"54",37044,36016,73060
"9269",1933,"55",36485,35515,72000
"9270",1933,"56",35800,34465,70265
"9271",1933,"57",33623,32560,66183
"9272",1933,"58",32811,31701,64512
"9273",1933,"59",32186,30590,62776
"9274",1933,"60",30223,28858,59081
"9275",1933,"61",27780,26376,54156
"9276",1933,"62",26989,25734,52723
"9277",1933,"63",25756,24463,50219
"9278",1933,"64",25102,23635,48737
"9279",1933,"65",24221,23266,47487
"9280",1933,"66",23554,22354,45908
"9281",1933,"67",22308,20863,43171
"9282",1933,"68",21197,19756,40953
"9283",1933,"69",20521,19232,39753
"9284",1933,"70",17357,16410,33767
"9285",1933,"71",17148,15833,32981
"9286",1933,"72",14516,13531,28047
"9287",1933,"73",14138,13048,27186
"9288",1933,"74",11975,11141,23116
"9289",1933,"75",11458,10401,21859
"9290",1933,"76",10408,9400,19808
"9291",1933,"77",9118,8107,17225
"9292",1933,"78",8265,7408,15673
"9293",1933,"79",7445,6546,13991
"9294",1933,"80",6786,5802,12588
"9295",1933,"81",5863,4981,10844
"9296",1933,"82",4966,4240,9206
"9297",1933,"83",4271,3572,7843
"9298",1933,"84",3111,2551,5662
"9299",1933,"85",2367,1873,4240
"9300",1933,"86",1967,1543,3510
"9301",1933,"87",1732,1268,3000
"9302",1933,"88",1345,1034,2379
"9303",1933,"89",964,757,1721
"9304",1933,"90",761,536,1297
"9305",1933,"91",564,373,937
"9306",1933,"92",384,315,699
"9307",1933,"93",257,145,402
"9308",1933,"94",190,102,292
"9309",1933,"95",104,53,157
"9310",1933,"96",70,40,110
"9311",1933,"97",52,30,82
"9312",1933,"98",17,16,33
"9313",1933,"99",14,7,21
"9314",1933,"100",7,0,7
"9315",1933,"101",4,1,5
"9316",1933,"102",1,1,2
"9317",1933,"103",1.75,0,1.75
"9318",1933,"104",0.25,0,0.25
"9319",1933,"105",0,0,0
"9320",1933,"106",0,0,0
"9321",1933,"107",0,0,0
"9322",1933,"108",0,0,0
"9323",1933,"109",0,0,0
"9324",1933,"110+",0,0,0
"9325",1934,"0",80779,84900,165679
"9326",1934,"1",82871,86944,169815
"9327",1934,"2",81751,85787,167538
"9328",1934,"3",82450,86622,169072
"9329",1934,"4",81148,84406,165554
"9330",1934,"5",81725,84362,166087
"9331",1934,"6",79498,82568,162066
"9332",1934,"7",79823,82991,162814
"9333",1934,"8",80422,83178,163600
"9334",1934,"9",82153,84806,166959
"9335",1934,"10",83950,87140,171090
"9336",1934,"11",81463,84573,166036
"9337",1934,"12",83119,85435,168554
"9338",1934,"13",84796,87650,172446
"9339",1934,"14",71259,74058,145317
"9340",1934,"15",70035,72483,142518
"9341",1934,"16",71928,73839,145767
"9342",1934,"17",72875,74941,147816
"9343",1934,"18",71450,73548,144998
"9344",1934,"19",75773,77374,153147
"9345",1934,"20",75308,75977,151285
"9346",1934,"21",74905,75242,150147
"9347",1934,"22",70554,69741,140295
"9348",1934,"23",71605,71059,142664
"9349",1934,"24",72910,71572,144482
"9350",1934,"25",71839,70088,141927
"9351",1934,"26",70789,68645,139434
"9352",1934,"27",69426,66738,136164
"9353",1934,"28",68152,66051,134203
"9354",1934,"29",67279,65192,132471
"9355",1934,"30",65475,63378,128853
"9356",1934,"31",64893,62927,127820
"9357",1934,"32",63170,60497,123667
"9358",1934,"33",59789,57341,117130
"9359",1934,"34",59243,56877,116120
"9360",1934,"35",58131,56030,114161
"9361",1934,"36",57757,55379,113136
"9362",1934,"37",57045,55074,112119
"9363",1934,"38",54617,52524,107141
"9364",1934,"39",53600,51149,104749
"9365",1934,"40",53367,51173,104540
"9366",1934,"41",48951,47202,96153
"9367",1934,"42",49960,48086,98046
"9368",1934,"43",46905,45244,92149
"9369",1934,"44",46314,44780,91094
"9370",1934,"45",45879,44854,90733
"9371",1934,"46",44925,43708,88633
"9372",1934,"47",44398,42558,86956
"9373",1934,"48",43305,42233,85538
"9374",1934,"49",42105,40831,82936
"9375",1934,"50",40303,38899,79202
"9376",1934,"51",40330,39128,79458
"9377",1934,"52",38881,37753,76634
"9378",1934,"53",37997,36499,74496
"9379",1934,"54",38214,37036,75250
"9380",1934,"55",36642,35645,72287
"9381",1934,"56",36056,35122,71178
"9382",1934,"57",35361,34003,69364
"9383",1934,"58",33194,32107,65301
"9384",1934,"59",32358,31231,63589
"9385",1934,"60",31683,30109,61792
"9386",1934,"61",29709,28330,58039
"9387",1934,"62",27273,25868,53141
"9388",1934,"63",26444,25144,51588
"9389",1934,"64",25119,23906,49025
"9390",1934,"65",24467,22987,47454
"9391",1934,"66",23553,22552,46105
"9392",1934,"67",22823,21617,44440
"9393",1934,"68",21544,20116,41660
"9394",1934,"69",20431,18949,39380
"9395",1934,"70",19678,18406,38084
"9396",1934,"71",16523,15611,32134
"9397",1934,"72",16301,15009,31310
"9398",1934,"73",13699,12765,26464
"9399",1934,"74",13255,12226,25481
"9400",1934,"75",11140,10319,21459
"9401",1934,"76",10576,9588,20164
"9402",1934,"77",9576,8565,18141
"9403",1934,"78",8278,7298,15576
"9404",1934,"79",7474,6646,14120
"9405",1934,"80",6664,5811,12475
"9406",1934,"81",6007,5099,11106
"9407",1934,"82",5113,4269,9382
"9408",1934,"83",4254,3622,7876
"9409",1934,"84",3615,3000,6615
"9410",1934,"85",2572,2097,4669
"9411",1934,"86",1917,1508,3425
"9412",1934,"87",1607,1215,2822
"9413",1934,"88",1338,988,2326
"9414",1934,"89",1029,779,1808
"9415",1934,"90",726,543,1269
"9416",1934,"91",561,396,957
"9417",1934,"92",386,257,643
"9418",1934,"93",274,219,493
"9419",1934,"94",183,99,282
"9420",1934,"95",121,68,189
"9421",1934,"96",71,37,108
"9422",1934,"97",37,24,61
"9423",1934,"98",28,18,46
"9424",1934,"99",10,8,18
"9425",1934,"100",3,5,8
"9426",1934,"101",3,0,3
"9427",1934,"102",2,0,2
"9428",1934,"103",0,1,1
"9429",1934,"104",0.75,0,0.75
"9430",1934,"105",0.25,0,0.25
"9431",1934,"106",0,0,0
"9432",1934,"107",0,0,0
"9433",1934,"108",0,0,0
"9434",1934,"109",0,0,0
"9435",1934,"110+",0,0,0
"9436",1935,"0",81157,85536,166693
"9437",1935,"1",79713,83506,163219
"9438",1935,"2",82491,86486,168977
"9439",1935,"3",81556,85503,167059
"9440",1935,"4",82296,86413,168709
"9441",1935,"5",81005,84254,165259
"9442",1935,"6",81608,84225,165833
"9443",1935,"7",79395,82449,161844
"9444",1935,"8",79739,82893,162632
"9445",1935,"9",80331,83068,163399
"9446",1935,"10",82077,84710,166787
"9447",1935,"11",83890,87043,170933
"9448",1935,"12",81397,84508,165905
"9449",1935,"13",83057,85353,168410
"9450",1935,"14",84722,87546,172268
"9451",1935,"15",71182,73982,145164
"9452",1935,"16",69931,72368,142299
"9453",1935,"17",71832,73717,145549
"9454",1935,"18",72778,74812,147590
"9455",1935,"19",71343,73417,144760
"9456",1935,"20",75638,77206,152844
"9457",1935,"21",75196,75841,151037
"9458",1935,"22",74774,75095,149869
"9459",1935,"23",70429,69593,140022
"9460",1935,"24",71475,70912,142387
"9461",1935,"25",72786,71434,144220
"9462",1935,"26",71716,69945,141661
"9463",1935,"27",70633,68514,139147
"9464",1935,"28",69268,66599,135867
"9465",1935,"29",67998,65907,133905
"9466",1935,"30",67122,65037,132159
"9467",1935,"31",65319,63257,128576
"9468",1935,"32",64749,62785,127534
"9469",1935,"33",63010,60382,123392
"9470",1935,"34",59635,57202,116837
"9471",1935,"35",59064,56755,115819
"9472",1935,"36",57979,55882,113861
"9473",1935,"37",57565,55188,112753
"9474",1935,"38",56881,54932,111813
"9475",1935,"39",54437,52370,106807
"9476",1935,"40",53411,50999,104410
"9477",1935,"41",53171,51002,104173
"9478",1935,"42",48779,47033,95812
"9479",1935,"43",49764,47903,97667
"9480",1935,"44",46713,45060,91773
"9481",1935,"45",46101,44583,90684
"9482",1935,"46",45677,44636,90313
"9483",1935,"47",44717,43486,88203
"9484",1935,"48",44198,42330,86528
"9485",1935,"49",43043,41983,85026
"9486",1935,"50",41814,40584,82398
"9487",1935,"51",40015,38626,78641
"9488",1935,"52",40010,38840,78850
"9489",1935,"53",38559,37439,75998
"9490",1935,"54",37674,36191,73865
"9491",1935,"55",37823,36662,74485
"9492",1935,"56",36252,35239,71491
"9493",1935,"57",35622,34708,70330
"9494",1935,"58",34947,33526,68473
"9495",1935,"59",32743,31634,64377
"9496",1935,"60",31855,30729,62584
"9497",1935,"61",31189,29554,60743
"9498",1935,"62",29151,27774,56925
"9499",1935,"63",26686,25376,52062
"9500",1935,"64",25851,24529,50380
"9501",1935,"65",24518,23291,47809
"9502",1935,"66",23842,22327,46169
"9503",1935,"67",22868,21782,44650
"9504",1935,"68",22131,20845,42976
"9505",1935,"69",20734,19369,40103
"9506",1935,"70",19606,18147,37753
"9507",1935,"71",18825,17544,36369
"9508",1935,"72",15731,14781,30512
"9509",1935,"73",15485,14158,29643
"9510",1935,"74",12843,11981,24824
"9511",1935,"75",12395,11379,23774
"9512",1935,"76",10372,9520,19892
"9513",1935,"77",9727,8805,18532
"9514",1935,"78",8760,7794,16554
"9515",1935,"79",7479,6577,14056
"9516",1935,"80",6708,5907,12615
"9517",1935,"81",5934,5114,11048
"9518",1935,"82",5315,4437,9752
"9519",1935,"83",4434,3717,8151
"9520",1935,"84",3648,3080,6728
"9521",1935,"85",3039,2482,5521
"9522",1935,"86",2144,1733,3877
"9523",1935,"87",1544,1221,2765
"9524",1935,"88",1299,968,2267
"9525",1935,"89",1071,762,1833
"9526",1935,"90",782,622,1404
"9527",1935,"91",554,397,951
"9528",1935,"92",396,293,689
"9529",1935,"93",286,183,469
"9530",1935,"94",192,155,347
"9531",1935,"95",131,61,192
"9532",1935,"96",87,46,133
"9533",1935,"97",43,20,63
"9534",1935,"98",22,16,38
"9535",1935,"99",14,11,25
"9536",1935,"100",7,5,12
"9537",1935,"101",3,3,6
"9538",1935,"102",1,0,1
"9539",1935,"103",1,0,1
"9540",1935,"104",0,0,0
"9541",1935,"105",0.75,0,0.75
"9542",1935,"106",0.25,0,0.25
"9543",1935,"107",0,0,0
"9544",1935,"108",0,0,0
"9545",1935,"109",0,0,0
"9546",1935,"110+",0,0,0
"9547",1936,"0",80363,84862,165225
"9548",1936,"1",80179,84302,164481
"9549",1936,"2",79356,83117,162473
"9550",1936,"3",82308,86237,168545
"9551",1936,"4",81407,85294,166701
"9552",1936,"5",82168,86254,168422
"9553",1936,"6",80911,84116,165027
"9554",1936,"7",81521,84103,165624
"9555",1936,"8",79328,82336,161664
"9556",1936,"9",79670,82792,162462
"9557",1936,"10",80266,82988,163254
"9558",1936,"11",82010,84628,166638
"9559",1936,"12",83818,86967,170785
"9560",1936,"13",81339,84438,165777
"9561",1936,"14",82989,85276,168265
"9562",1936,"15",84637,87431,172068
"9563",1936,"16",71088,73895,144983
"9564",1936,"17",69834,72259,142093
"9565",1936,"18",71721,73596,145317
"9566",1936,"19",72658,74672,147330
"9567",1936,"20",71238,73294,144532
"9568",1936,"21",75511,77070,152581
"9569",1936,"22",75066,75656,150722
"9570",1936,"23",74645,74957,149602
"9571",1936,"24",70291,69449,139740
"9572",1936,"25",71365,70744,142109
"9573",1936,"26",72650,71280,143930
"9574",1936,"27",71567,69795,141362
"9575",1936,"28",70490,68377,138867
"9576",1936,"29",69118,66459,135577
"9577",1936,"30",67854,65770,133624
"9578",1936,"31",66939,64906,131845
"9579",1936,"32",65155,63133,128288
"9580",1936,"33",64592,62648,127240
"9581",1936,"34",62855,60227,123082
"9582",1936,"35",59498,57043,116541
"9583",1936,"36",58867,56597,115464
"9584",1936,"37",57790,55715,113505
"9585",1936,"38",57357,55041,112398
"9586",1936,"39",56687,54746,111433
"9587",1936,"40",54229,52198,106427
"9588",1936,"41",53227,50814,104041
"9589",1936,"42",52962,50797,103759
"9590",1936,"43",48584,46877,95461
"9591",1936,"44",49569,47705,97274
"9592",1936,"45",46508,44852,91360
"9593",1936,"46",45895,44363,90258
"9594",1936,"47",45439,44398,89837
"9595",1936,"48",44463,43258,87721
"9596",1936,"49",43909,42055,85964
"9597",1936,"50",42739,41722,84461
"9598",1936,"51",41527,40316,81843
"9599",1936,"52",39694,38337,78031
"9600",1936,"53",39673,38496,78169
"9601",1936,"54",38210,37075,75285
"9602",1936,"55",37300,35802,73102
"9603",1936,"56",37424,36258,73682
"9604",1936,"57",35824,34810,70634
"9605",1936,"58",35122,34208,69330
"9606",1936,"59",34446,33002,67448
"9607",1936,"60",32248,31122,63370
"9608",1936,"61",31301,30136,61437
"9609",1936,"62",30587,28992,59579
"9610",1936,"63",28554,27177,55731
"9611",1936,"64",26047,24754,50801
"9612",1936,"65",25234,23870,49104
"9613",1936,"66",23869,22557,46426
"9614",1936,"67",23123,21664,44787
"9615",1936,"68",22147,21014,43161
"9616",1936,"69",21329,20021,41350
"9617",1936,"70",19917,18552,38469
"9618",1936,"71",18729,17232,35961
"9619",1936,"72",17864,16607,34471
"9620",1936,"73",14822,13905,28727
"9621",1936,"74",14527,13209,27736
"9622",1936,"75",11984,11118,23102
"9623",1936,"76",11468,10480,21948
"9624",1936,"77",9525,8675,18200
"9625",1936,"78",8858,7960,16818
"9626",1936,"79",7880,6970,14850
"9627",1936,"80",6615,5742,12357
"9628",1936,"81",5846,5185,11031
"9629",1936,"82",5178,4372,9550
"9630",1936,"83",4583,3793,8376
"9631",1936,"84",3760,3099,6859
"9632",1936,"85",3059,2533,5592
"9633",1936,"86",2483,1978,4461
"9634",1936,"87",1721,1357,3078
"9635",1936,"88",1213,936,2149
"9636",1936,"89",989,739,1728
"9637",1936,"90",808,582,1390
"9638",1936,"91",584,425,1009
"9639",1936,"92",395,267,662
"9640",1936,"93",274,200,474
"9641",1936,"94",204,109,313
"9642",1936,"95",127,102,229
"9643",1936,"96",89,39,128
"9644",1936,"97",50,27,77
"9645",1936,"98",27,12,39
"9646",1936,"99",12,12,24
"9647",1936,"100",6,7,13
"9648",1936,"101",5,1,6
"9649",1936,"102",2,0,2
"9650",1936,"103",1,0,1
"9651",1936,"104",0,0,0
"9652",1936,"105",0,0,0
"9653",1936,"106",0,0,0
"9654",1936,"107",0,0,0
"9655",1936,"108",0,0,0
"9656",1936,"109",0,0,0
"9657",1936,"110+",0,0,0
"9658",1937,"0",81083,85511,166594
"9659",1937,"1",79393,83675,163068
"9660",1937,"2",79836,83890,163726
"9661",1937,"3",79164,82844,162008
"9662",1937,"4",82145,86047,168192
"9663",1937,"5",81280,85158,166438
"9664",1937,"6",82063,86141,168204
"9665",1937,"7",80827,84004,164831
"9666",1937,"8",81440,84006,165446
"9667",1937,"9",79256,82250,161506
"9668",1937,"10",79606,82716,162322
"9669",1937,"11",80211,82904,163115
"9670",1937,"12",81931,84546,166477
"9671",1937,"13",83744,86883,170627
"9672",1937,"14",81269,84364,165633
"9673",1937,"15",82893,85169,168062
"9674",1937,"16",84530,87336,171866
"9675",1937,"17",70988,73795,144783
"9676",1937,"18",69748,72149,141897
"9677",1937,"19",71629,73462,145091
"9678",1937,"20",72559,74525,147084
"9679",1937,"21",71111,73140,144251
"9680",1937,"22",75393,76887,152280
"9681",1937,"23",74931,75507,150438
"9682",1937,"24",74519,74815,149334
"9683",1937,"25",70174,69299,139473
"9684",1937,"26",71253,70615,141868
"9685",1937,"27",72517,71125,143642
"9686",1937,"28",71427,69646,141073
"9687",1937,"29",70331,68259,138590
"9688",1937,"30",68942,66305,135247
"9689",1937,"31",67719,65640,133359
"9690",1937,"32",66768,64764,131532
"9691",1937,"33",64998,62987,127985
"9692",1937,"34",64445,62493,126938
"9693",1937,"35",62669,60071,122740
"9694",1937,"36",59334,56891,116225
"9695",1937,"37",58685,56445,115130
"9696",1937,"38",57620,55551,113171
"9697",1937,"39",57159,54875,112034
"9698",1937,"40",56500,54573,111073
"9699",1937,"41",54044,52025,106069
"9700",1937,"42",53016,50624,103640
"9701",1937,"43",52744,50616,103360
"9702",1937,"44",48384,46686,95070
"9703",1937,"45",49360,47472,96832
"9704",1937,"46",46280,44630,90910
"9705",1937,"47",45673,44163,89836
"9706",1937,"48",45199,44156,89355
"9707",1937,"49",44212,42992,87204
"9708",1937,"50",43635,41806,85441
"9709",1937,"51",42425,41419,83844
"9710",1937,"52",41208,40033,81241
"9711",1937,"53",39382,38008,77390
"9712",1937,"54",39281,38108,77389
"9713",1937,"55",37834,36698,74532
"9714",1937,"56",36899,35406,72305
"9715",1937,"57",37002,35801,72803
"9716",1937,"58",35335,34324,69659
"9717",1937,"59",34645,33691,68336
"9718",1937,"60",33909,32455,66364
"9719",1937,"61",31660,30572,62232
"9720",1937,"62",30728,29540,60268
"9721",1937,"63",29960,28326,58286
"9722",1937,"64",27898,26571,54469
"9723",1937,"65",25433,24070,49503
"9724",1937,"66",24536,23161,47697
"9725",1937,"67",23157,21813,44970
"9726",1937,"68",22443,20879,43322
"9727",1937,"69",21328,20197,41525
"9728",1937,"70",20475,19166,39641
"9729",1937,"71",18969,17663,36632
"9730",1937,"72",17772,16388,34160
"9731",1937,"73",16881,15635,32516
"9732",1937,"74",13922,12983,26905
"9733",1937,"75",13502,12219,25721
"9734",1937,"76",11075,10264,21339
"9735",1937,"77",10514,9596,20110
"9736",1937,"78",8681,7851,16532
"9737",1937,"79",7972,7094,15066
"9738",1937,"80",6918,6134,13052
"9739",1937,"81",5848,5016,10864
"9740",1937,"82",5062,4478,9540
"9741",1937,"83",4482,3714,8196
"9742",1937,"84",3887,3172,7059
"9743",1937,"85",3127,2562,5689
"9744",1937,"86",2524,2067,4591
"9745",1937,"87",1988,1589,3577
"9746",1937,"88",1383,1058,2441
"9747",1937,"89",945,724,1669
"9748",1937,"90",748,555,1303
"9749",1937,"91",589,429,1018
"9750",1937,"92",421,300,721
"9751",1937,"93",277,182,459
"9752",1937,"94",194,137,331
"9753",1937,"95",137,63,200
"9754",1937,"96",83,54,137
"9755",1937,"97",59,25,84
"9756",1937,"98",31,17,48
"9757",1937,"99",17,8,25
"9758",1937,"100",9,9,18
"9759",1937,"101",2,3,5
"9760",1937,"102",2,0,2
"9761",1937,"103",1,0,1
"9762",1937,"104",0,0,0
"9763",1937,"105",0,0,0
"9764",1937,"106",0,0,0
"9765",1937,"107",0,0,0
"9766",1937,"108",0,0,0
"9767",1937,"109",0,0,0
"9768",1937,"110+",0,0,0
"9769",1938,"0",80676,84673,165349
"9770",1938,"1",80167,84304,164471
"9771",1938,"2",79098,83293,162391
"9772",1938,"3",79692,83670,163362
"9773",1938,"4",79025,82682,161707
"9774",1938,"5",82032,85914,167946
"9775",1938,"6",81190,85019,166209
"9776",1938,"7",81987,86041,168028
"9777",1938,"8",80758,83904,164662
"9778",1938,"9",81385,83921,165306
"9779",1938,"10",79194,82179,161373
"9780",1938,"11",79553,82661,162214
"9781",1938,"12",80154,82831,162985
"9782",1938,"13",81868,84463,166331
"9783",1938,"14",83679,86795,170474
"9784",1938,"15",81189,84268,165457
"9785",1938,"16",82802,85063,167865
"9786",1938,"17",84433,87223,171656
"9787",1938,"18",70891,73683,144574
"9788",1938,"19",69652,72017,141669
"9789",1938,"20",71522,73329,144851
"9790",1938,"21",72456,74390,146846
"9791",1938,"22",71013,73004,144017
"9792",1938,"23",75270,76758,152028
"9793",1938,"24",74808,75362,150170
"9794",1938,"25",74411,74648,149059
"9795",1938,"26",70051,69170,139221
"9796",1938,"27",71115,70499,141614
"9797",1938,"28",72371,70989,143360
"9798",1938,"29",71290,69526,140816
"9799",1938,"30",70187,68121,138308
"9800",1938,"31",68811,66191,135002
"9801",1938,"32",67571,65497,133068
"9802",1938,"33",66630,64616,131246
"9803",1938,"34",64831,62835,127666
"9804",1938,"35",64293,62345,126638
"9805",1938,"36",62512,59920,122432
"9806",1938,"37",59165,56739,115904
"9807",1938,"38",58496,56305,114801
"9808",1938,"39",57444,55380,112824
"9809",1938,"40",56969,54676,111645
"9810",1938,"41",56333,54384,110717
"9811",1938,"42",53838,51844,105682
"9812",1938,"43",52818,50433,103251
"9813",1938,"44",52502,50406,102908
"9814",1938,"45",48200,46478,94678
"9815",1938,"46",49118,47261,96379
"9816",1938,"47",46029,44382,90411
"9817",1938,"48",45457,43901,89358
"9818",1938,"49",44951,43899,88850
"9819",1938,"50",43900,42702,86602
"9820",1938,"51",43346,41488,84834
"9821",1938,"52",42105,41110,83215
"9822",1938,"53",40885,39687,80572
"9823",1938,"54",39035,37636,76671
"9824",1938,"55",38862,37694,76556
"9825",1938,"56",37445,36315,73760
"9826",1938,"57",36470,34961,71431
"9827",1938,"58",36522,35320,71842
"9828",1938,"59",34799,33818,68617
"9829",1938,"60",34124,33159,67283
"9830",1938,"61",33298,31913,65211
"9831",1938,"62",31085,29964,61049
"9832",1938,"63",30100,28858,58958
"9833",1938,"64",29252,27655,56907
"9834",1938,"65",27172,25824,52996
"9835",1938,"66",24730,23341,48071
"9836",1938,"67",23835,22386,46221
"9837",1938,"68",22414,20995,43409
"9838",1938,"69",21609,20082,41691
"9839",1938,"70",20461,19264,39725
"9840",1938,"71",19521,18225,37746
"9841",1938,"72",17993,16749,34742
"9842",1938,"73",16761,15435,32196
"9843",1938,"74",15825,14641,30466
"9844",1938,"75",12919,12000,24919
"9845",1938,"76",12471,11271,23742
"9846",1938,"77",10120,9387,19507
"9847",1938,"78",9535,8645,18180
"9848",1938,"79",7810,7018,14828
"9849",1938,"80",7079,6263,13342
"9850",1938,"81",6084,5344,11428
"9851",1938,"82",5050,4294,9344
"9852",1938,"83",4332,3785,8117
"9853",1938,"84",3737,3081,6818
"9854",1938,"85",3180,2604,5784
"9855",1938,"86",2537,2020,4557
"9856",1938,"87",2007,1602,3609
"9857",1938,"88",1594,1242,2836
"9858",1938,"89",1029,826,1855
"9859",1938,"90",722,541,1263
"9860",1938,"91",554,404,958
"9861",1938,"92",394,286,680
"9862",1938,"93",271,186,457
"9863",1938,"94",189,115,304
"9864",1938,"95",120,83,203
"9865",1938,"96",75,39,114
"9866",1938,"97",53,34,87
"9867",1938,"98",39,16,55
"9868",1938,"99",14,10,24
"9869",1938,"100",8,3,11
"9870",1938,"101",3,6,9
"9871",1938,"102",1,0,1
"9872",1938,"103",0,0,0
"9873",1938,"104",0,0,0
"9874",1938,"105",0,0,0
"9875",1938,"106",0,0,0
"9876",1938,"107",0,0,0
"9877",1938,"108",0,0,0
"9878",1938,"109",0,0,0
"9879",1938,"110+",0,0,0
"9880",1939,"0",84442,88926,173368
"9881",1939,"1",79821,83546,163367
"9882",1939,"2",79850,83898,163748
"9883",1939,"3",78925,83060,161985
"9884",1939,"4",79546,83492,163038
"9885",1939,"5",78906,82553,161459
"9886",1939,"6",81939,85762,167701
"9887",1939,"7",81111,84903,166014
"9888",1939,"8",81914,85935,167849
"9889",1939,"9",80692,83806,164498
"9890",1939,"10",81330,83842,165172
"9891",1939,"11",79127,82114,161241
"9892",1939,"12",79510,82586,162096
"9893",1939,"13",80082,82766,162848
"9894",1939,"14",81800,84371,166171
"9895",1939,"15",83603,86691,170294
"9896",1939,"16",81106,84169,165275
"9897",1939,"17",82714,84946,167660
"9898",1939,"18",84322,87074,171396
"9899",1939,"19",70785,73569,144354
"9900",1939,"20",69568,71878,141446
"9901",1939,"21",71418,73207,144625
"9902",1939,"22",72367,74235,146602
"9903",1939,"23",70909,72883,143792
"9904",1939,"24",75153,76605,151758
"9905",1939,"25",74696,75227,149923
"9906",1939,"26",74295,74511,148806
"9907",1939,"27",69933,69046,138979
"9908",1939,"28",70994,70362,141356
"9909",1939,"29",72228,70837,143065
"9910",1939,"30",71176,69392,140568
"9911",1939,"31",70045,67968,138013
"9912",1939,"32",68664,66073,134737
"9913",1939,"33",67420,65344,132764
"9914",1939,"34",66460,64440,130900
"9915",1939,"35",64669,62696,127365
"9916",1939,"36",64108,62185,126293
"9917",1939,"37",62324,59744,122068
"9918",1939,"38",58995,56587,115582
"9919",1939,"39",58332,56134,114466
"9920",1939,"40",57255,55229,112484
"9921",1939,"41",56796,54504,111300
"9922",1939,"42",56141,54191,110332
"9923",1939,"43",53664,51661,105325
"9924",1939,"44",52607,50241,102848
"9925",1939,"45",52294,50199,102493
"9926",1939,"46",47966,46247,94213
"9927",1939,"47",48908,47044,95952
"9928",1939,"48",45775,44153,89928
"9929",1939,"49",45193,43651,88844
"9930",1939,"50",44643,43614,88257
"9931",1939,"51",43590,42399,85989
"9932",1939,"52",43002,41192,84194
"9933",1939,"53",41759,40762,82521
"9934",1939,"54",40524,39341,79865
"9935",1939,"55",38685,37236,75921
"9936",1939,"56",38425,37303,75728
"9937",1939,"57",37020,35901,72921
"9938",1939,"58",36083,34479,70562
"9939",1939,"59",36049,34792,70841
"9940",1939,"60",34288,33290,67578
"9941",1939,"61",33585,32588,66173
"9942",1939,"62",32711,31364,64075
"9943",1939,"63",30509,29314,59823
"9944",1939,"64",29473,28236,57709
"9945",1939,"65",28510,26907,55417
"9946",1939,"66",26445,25146,51591
"9947",1939,"67",23977,22622,46599
"9948",1939,"68",23021,21575,44596
"9949",1939,"69",21627,20158,41785
"9950",1939,"70",20747,19220,39967
"9951",1939,"71",19603,18360,37963
"9952",1939,"72",18576,17236,35812
"9953",1939,"73",17043,15793,32836
"9954",1939,"74",15768,14425,30193
"9955",1939,"75",14798,13582,28380
"9956",1939,"76",11968,11099,23067
"9957",1939,"77",11530,10326,21856
"9958",1939,"78",9256,8501,17757
"9959",1939,"79",8636,7772,16408
"9960",1939,"80",6930,6239,13169
"9961",1939,"81",6228,5515,11743
"9962",1939,"82",5326,4622,9948
"9963",1939,"83",4323,3619,7942
"9964",1939,"84",3695,3184,6879
"9965",1939,"85",3155,2572,5727
"9966",1939,"86",2641,2097,4738
"9967",1939,"87",2063,1598,3661
"9968",1939,"88",1588,1252,2840
"9969",1939,"89",1272,950,2222
"9970",1939,"90",792,624,1416
"9971",1939,"91",534,391,925
"9972",1939,"92",403,283,686
"9973",1939,"93",286,208,494
"9974",1939,"94",192,119,311
"9975",1939,"95",119,68,187
"9976",1939,"96",76,55,131
"9977",1939,"97",48,31,79
"9978",1939,"98",27,15,42
"9979",1939,"99",24,9,33
"9980",1939,"100",7,6,13
"9981",1939,"101",2,2,4
"9982",1939,"102",1,2,3
"9983",1939,"103",1,0,1
"9984",1939,"104",0,0,0
"9985",1939,"105",0,0,0
"9986",1939,"106",0,0,0
"9987",1939,"107",0,0,0
"9988",1939,"108",0,0,0
"9989",1939,"109",0,0,0
"9990",1939,"110+",0,0,0
"9991",1940,"0",86128,89895,176023
"9992",1940,"1",83667,87990,171657
"9993",1940,"2",79563,83285,162848
"9994",1940,"3",79704,83680,163384
"9995",1940,"4",78796,82920,161716
"9996",1940,"5",79444,83356,162800
"9997",1940,"6",78827,82456,161283
"9998",1940,"7",81870,85653,167523
"9999",1940,"8",80946,84829,165775
"10000",1940,"9",81941,85849,167790
"10001",1940,"10",80639,83722,164361
"10002",1940,"11",81282,83787,165069
"10003",1940,"12",79063,82045,161108
"10004",1940,"13",79470,82528,161998
"10005",1940,"14",80028,82694,162722
"10006",1940,"15",81727,84273,166000
"10007",1940,"16",83520,86587,170107
"10008",1940,"17",81014,84048,165062
"10009",1940,"18",82618,84826,167444
"10010",1940,"19",84225,86929,171154
"10011",1940,"20",70845,73109,143954
"10012",1940,"21",69628,71403,141031
"10013",1940,"22",71476,72740,144216
"10014",1940,"23",72414,73776,146190
"10015",1940,"24",70966,72398,143364
"10016",1940,"25",75136,75735,150871
"10017",1940,"26",74644,74359,149003
"10018",1940,"27",74272,73629,147901
"10019",1940,"28",69918,68174,138092
"10020",1940,"29",70965,69509,140474
"10021",1940,"30",72164,70300,142464
"10022",1940,"31",71088,68849,139937
"10023",1940,"32",69967,67427,137394
"10024",1940,"33",68558,65538,134096
"10025",1940,"34",67329,64771,132100
"10026",1940,"35",66352,64117,130469
"10027",1940,"36",64575,62336,126911
"10028",1940,"37",63977,61837,125814
"10029",1940,"38",62196,59385,121581
"10030",1940,"39",58859,56214,115073
"10031",1940,"40",58181,55892,114073
"10032",1940,"41",57101,54994,112095
"10033",1940,"42",56623,54259,110882
"10034",1940,"43",55921,53946,109867
"10035",1940,"44",53484,51391,104875
"10036",1940,"45",52413,49974,102387
"10037",1940,"46",52088,49900,101988
"10038",1940,"47",47764,45960,93724
"10039",1940,"48",48616,46759,95375
"10040",1940,"49",45535,43841,89376
"10041",1940,"50",44912,43346,88258
"10042",1940,"51",44364,43320,87684
"10043",1940,"52",43243,42085,85328
"10044",1940,"53",42668,40856,83524
"10045",1940,"54",41355,40388,81743
"10046",1940,"55",40144,38970,79114
"10047",1940,"56",38278,36845,75123
"10048",1940,"57",38032,36837,74869
"10049",1940,"58",36570,35417,71987
"10050",1940,"59",35623,33970,69593
"10051",1940,"60",35530,34246,69776
"10052",1940,"61",33667,32673,66340
"10053",1940,"62",33010,31994,65004
"10054",1940,"63",32070,30671,62741
"10055",1940,"64",29839,28594,58433
"10056",1940,"65",28740,27460,56200
"10057",1940,"66",27715,26128,53843
"10058",1940,"67",25652,24327,49979
"10059",1940,"68",23174,21785,44959
"10060",1940,"69",22154,20686,42840
"10061",1940,"70",20756,19300,40056
"10062",1940,"71",19804,18264,38068
"10063",1940,"72",18674,17372,36046
"10064",1940,"73",17583,16225,33808
"10065",1940,"74",16025,14728,30753
"10066",1940,"75",14747,13385,28132
"10067",1940,"76",13693,12522,26215
"10068",1940,"77",10956,10177,21133
"10069",1940,"78",10540,9251,19791
"10070",1940,"79",8352,7631,15983
"10071",1940,"80",7497,6818,14315
"10072",1940,"81",6036,5413,11449
"10073",1940,"82",5378,4746,10124
"10074",1940,"83",4608,3879,8487
"10075",1940,"84",3645,3035,6680
"10076",1940,"85",3078,2569,5647
"10077",1940,"86",2591,2032,4623
"10078",1940,"87",2112,1617,3729
"10079",1940,"88",1630,1231,2861
"10080",1940,"89",1256,950,2206
"10081",1940,"90",961,708,1669
"10082",1940,"91",582,447,1029
"10083",1940,"92",385,269,654
"10084",1940,"93",289,194,483
"10085",1940,"94",195,134,329
"10086",1940,"95",131,77,208
"10087",1940,"96",83,41,124
"10088",1940,"97",53,24,77
"10089",1940,"98",26,15,41
"10090",1940,"99",13,13,26
"10091",1940,"100",11,3,14
"10092",1940,"101",3,6,9
"10093",1940,"102",0,2,2
"10094",1940,"103",0,0,0
"10095",1940,"104",1,0,1
"10096",1940,"105",0,0,0
"10097",1940,"106",0,0,0
"10098",1940,"107",0,0,0
"10099",1940,"108",0,0,0
"10100",1940,"109",0,0,0
"10101",1940,"110+",0,0,0
"10102",1941,"0",87860,91661,179521
"10103",1941,"1",85043,88517,173560
"10104",1941,"2",83295,87543,170838
"10105",1941,"3",79388,82938,162326
"10106",1941,"4",79562,83503,163065
"10107",1941,"5",78682,82769,161451
"10108",1941,"6",79326,83226,162552
"10109",1941,"7",78728,82330,161058
"10110",1941,"8",81790,85536,167326
"10111",1941,"9",80889,84716,165605
"10112",1941,"10",81890,85770,167660
"10113",1941,"11",80567,83647,164214
"10114",1941,"12",81224,83712,164936
"10115",1941,"13",78992,81962,160954
"10116",1941,"14",79389,82437,161826
"10117",1941,"15",79936,82569,162505
"10118",1941,"16",81633,84144,165777
"10119",1941,"17",83437,86428,169865
"10120",1941,"18",80887,83899,164786
"10121",1941,"19",82494,84652,167146
"10122",1941,"20",83718,86123,169841
"10123",1941,"21",70284,72638,142922
"10124",1941,"22",69097,71040,140137
"10125",1941,"23",70869,72376,143245
"10126",1941,"24",71812,73417,145229
"10127",1941,"25",70514,71553,142067
"10128",1941,"26",74671,75236,149907
"10129",1941,"27",74184,73893,148077
"10130",1941,"28",73819,73122,146941
"10131",1941,"29",69553,67888,137441
"10132",1941,"30",70616,69484,140100
"10133",1941,"31",71835,69912,141747
"10134",1941,"32",70764,68497,139261
"10135",1941,"33",69648,67097,136745
"10136",1941,"34",68235,65238,133473
"10137",1941,"35",67037,64639,131676
"10138",1941,"36",66035,63790,129825
"10139",1941,"37",64248,62085,126333
"10140",1941,"38",63684,61606,125290
"10141",1941,"39",61905,59144,121049
"10142",1941,"40",58594,56117,114711
"10143",1941,"41",57921,55660,113581
"10144",1941,"42",56876,54730,111606
"10145",1941,"43",56377,53993,110370
"10146",1941,"44",55660,53645,109305
"10147",1941,"45",53216,51117,104333
"10148",1941,"46",52115,49656,101771
"10149",1941,"47",51779,49599,101378
"10150",1941,"48",47481,45641,93122
"10151",1941,"49",48288,46406,94694
"10152",1941,"50",45224,43584,88808
"10153",1941,"51",44587,43014,87601
"10154",1941,"52",44024,42933,86957
"10155",1941,"53",42877,41656,84533
"10156",1941,"54",42295,40420,82715
"10157",1941,"55",40935,39911,80846
"10158",1941,"56",39742,38463,78205
"10159",1941,"57",37831,36375,74206
"10160",1941,"58",37560,36299,73859
"10161",1941,"59",36055,34825,70880
"10162",1941,"60",35074,33368,68442
"10163",1941,"61",34932,33552,68484
"10164",1941,"62",33028,31883,64911
"10165",1941,"63",32290,31263,63553
"10166",1941,"64",31332,29910,61242
"10167",1941,"65",29134,27742,56876
"10168",1941,"66",27940,26639,54579
"10169",1941,"67",26848,25205,52053
"10170",1941,"68",24809,23412,48221
"10171",1941,"69",22267,20816,43083
"10172",1941,"70",21189,19695,40884
"10173",1941,"71",19765,18338,38103
"10174",1941,"72",18744,17129,35873
"10175",1941,"73",17534,16311,33845
"10176",1941,"74",16457,15102,31559
"10177",1941,"75",14873,13572,28445
"10178",1941,"76",13607,12240,25847
"10179",1941,"77",12509,11325,23834
"10180",1941,"78",9840,9115,18955
"10181",1941,"79",9388,8211,17599
"10182",1941,"80",7281,6578,13859
"10183",1941,"81",6507,5839,12346
"10184",1941,"82",5207,4637,9844
"10185",1941,"83",4553,3905,8458
"10186",1941,"84",3807,3115,6922
"10187",1941,"85",2988,2438,5426
"10188",1941,"86",2441,2036,4477
"10189",1941,"87",2033,1544,3577
"10190",1941,"88",1632,1199,2831
"10191",1941,"89",1196,916,2112
"10192",1941,"90",905,695,1600
"10193",1941,"91",678,466,1144
"10194",1941,"92",405,303,708
"10195",1941,"93",265,184,449
"10196",1941,"94",176,127,303
"10197",1941,"95",128,66,194
"10198",1941,"96",70,39,109
"10199",1941,"97",42,24,66
"10200",1941,"98",22,12,34
"10201",1941,"99",10,8,18
"10202",1941,"100",6,8,14
"10203",1941,"101",5,0,5
"10204",1941,"102",3,3,6
"10205",1941,"103",0,1,1
"10206",1941,"104",0,0,0
"10207",1941,"105",0,0,0
"10208",1941,"106",0,0,0
"10209",1941,"107",0,0,0
"10210",1941,"108",0,0,0
"10211",1941,"109",0,0,0
"10212",1941,"110+",0,0,0
"10213",1942,"0",85520,90618,176138
"10214",1942,"1",86666,90136,176802
"10215",1942,"2",84670,88014,172684
"10216",1942,"3",83070,87265,170335
"10217",1942,"4",79230,82742,161972
"10218",1942,"5",79419,83320,162739
"10219",1942,"6",78570,82621,161191
"10220",1942,"7",79246,83096,162342
"10221",1942,"8",78655,82216,160871
"10222",1942,"9",81706,85436,167142
"10223",1942,"10",80819,84611,165430
"10224",1942,"11",81826,85674,167500
"10225",1942,"12",80511,83542,164053
"10226",1942,"13",81139,83635,164774
"10227",1942,"14",78923,81870,160793
"10228",1942,"15",79293,82333,161626
"10229",1942,"16",79830,82433,162263
"10230",1942,"17",81521,83987,165508
"10231",1942,"18",83314,86239,169553
"10232",1942,"19",80748,83662,164410
"10233",1942,"20",81726,83677,165403
"10234",1942,"21",83311,85549,168860
"10235",1942,"22",69917,72319,142236
"10236",1942,"23",68706,70743,139449
"10237",1942,"24",70498,72094,142592
"10238",1942,"25",71637,72346,143983
"10239",1942,"26",70200,70997,141197
"10240",1942,"27",74388,74713,149101
"10241",1942,"28",73867,73340,147207
"10242",1942,"29",73528,72606,146134
"10243",1942,"30",69382,67765,137147
"10244",1942,"31",70368,69113,139481
"10245",1942,"32",71564,69516,141080
"10246",1942,"33",70503,68111,138614
"10247",1942,"34",69393,66674,136067
"10248",1942,"35",68011,65093,133104
"10249",1942,"36",66805,64339,131144
"10250",1942,"37",65779,63509,129288
"10251",1942,"38",64009,61786,125795
"10252",1942,"39",63443,61298,124741
"10253",1942,"40",61732,59011,120743
"10254",1942,"41",58376,55869,114245
"10255",1942,"42",57695,55383,113078
"10256",1942,"43",56612,54449,111061
"10257",1942,"44",56134,53760,109894
"10258",1942,"45",55406,53308,108714
"10259",1942,"46",52948,50781,103729
"10260",1942,"47",51814,49310,101124
"10261",1942,"48",51450,49259,100709
"10262",1942,"49",47189,45311,92500
"10263",1942,"50",48017,46138,94155
"10264",1942,"51",44926,43226,88152
"10265",1942,"52",44244,42647,86891
"10266",1942,"53",43665,42558,86223
"10267",1942,"54",42498,41209,83707
"10268",1942,"55",41883,39998,81881
"10269",1942,"56",40487,39430,79917
"10270",1942,"57",39281,37962,77243
"10271",1942,"58",37348,35815,73163
"10272",1942,"59",37099,35721,72820
"10273",1942,"60",35554,34168,69722
"10274",1942,"61",34442,32700,67142
"10275",1942,"62",34356,32833,67189
"10276",1942,"63",32345,31201,63546
"10277",1942,"64",31561,30462,62023
"10278",1942,"65",30545,29081,59626
"10279",1942,"66",28284,26840,55124
"10280",1942,"67",27061,25720,52781
"10281",1942,"68",25918,24316,50234
"10282",1942,"69",23859,22387,46246
"10283",1942,"70",21330,19826,41156
"10284",1942,"71",20082,18675,38757
"10285",1942,"72",18762,17251,36013
"10286",1942,"73",17641,16062,33703
"10287",1942,"74",16447,15095,31542
"10288",1942,"75",15195,13921,29116
"10289",1942,"76",13659,12391,26050
"10290",1942,"77",12370,11034,23404
"10291",1942,"78",11270,10118,21388
"10292",1942,"79",8737,7989,16726
"10293",1942,"80",8189,7160,15349
"10294",1942,"81",6231,5611,11842
"10295",1942,"82",5601,4890,10491
"10296",1942,"83",4322,3822,8144
"10297",1942,"84",3732,3131,6863
"10298",1942,"85",3066,2443,5509
"10299",1942,"86",2350,1888,4238
"10300",1942,"87",1830,1534,3364
"10301",1942,"88",1499,1169,2668
"10302",1942,"89",1205,822,2027
"10303",1942,"90",836,624,1460
"10304",1942,"91",621,455,1076
"10305",1942,"92",463,298,761
"10306",1942,"93",247,166,413
"10307",1942,"94",150,108,258
"10308",1942,"95",89,63,152
"10309",1942,"96",80,32,112
"10310",1942,"97",33,24,57
"10311",1942,"98",19,8,27
"10312",1942,"99",12,4,16
"10313",1942,"100",7,3,10
"10314",1942,"101",2,2,4
"10315",1942,"102",3,0,3
"10316",1942,"103",0,1,1
"10317",1942,"104",0,0,0
"10318",1942,"105",0,0,0
"10319",1942,"106",0,0,0
"10320",1942,"107",0,0,0
"10321",1942,"108",0,0,0
"10322",1942,"109",0,0,0
"10323",1942,"110+",0,0,0
"10324",1943,"0",88993,95013,184006
"10325",1943,"1",84422,89237,173659
"10326",1943,"2",86144,89575,175719
"10327",1943,"3",84282,87529,171811
"10328",1943,"4",82722,86843,169565
"10329",1943,"5",78926,82366,161292
"10330",1943,"6",79128,82983,162111
"10331",1943,"7",78288,82283,160571
"10332",1943,"8",79033,82794,161827
"10333",1943,"9",78406,81935,160341
"10334",1943,"10",81445,85143,166588
"10335",1943,"11",80563,84324,164887
"10336",1943,"12",81574,85401,166975
"10337",1943,"13",80278,83285,163563
"10338",1943,"14",80824,83279,164103
"10339",1943,"15",78576,81528,160104
"10340",1943,"16",78898,81859,160757
"10341",1943,"17",79340,81862,161202
"10342",1943,"18",81049,83313,164362
"10343",1943,"19",82821,85545,168366
"10344",1943,"20",80241,82884,163125
"10345",1943,"21",81225,82784,164009
"10346",1943,"22",82766,84770,167536
"10347",1943,"23",69524,71671,141195
"10348",1943,"24",68292,70019,138311
"10349",1943,"25",70119,71509,141628
"10350",1943,"26",71241,71740,142981
"10351",1943,"27",69842,70434,140276
"10352",1943,"28",73930,74171,148101
"10353",1943,"29",73411,72730,146141
"10354",1943,"30",73059,71995,145054
"10355",1943,"31",68896,67233,136129
"10356",1943,"32",69898,68518,138416
"10357",1943,"33",71146,68974,140120
"10358",1943,"34",69993,67524,137517
"10359",1943,"35",68929,66099,135028
"10360",1943,"36",67551,64530,132081
"10361",1943,"37",66332,63813,130145
"10362",1943,"38",65286,62961,128247
"10363",1943,"39",63526,61217,124743
"10364",1943,"40",62968,60777,123745
"10365",1943,"41",61218,58451,119669
"10366",1943,"42",57954,55329,113283
"10367",1943,"43",57223,54827,112050
"10368",1943,"44",56140,53825,109965
"10369",1943,"45",55626,53163,108789
"10370",1943,"46",54927,52722,107649
"10371",1943,"47",52474,50209,102683
"10372",1943,"48",51279,48737,100016
"10373",1943,"49",50926,48713,99639
"10374",1943,"50",46679,44694,91373
"10375",1943,"51",47442,45534,92976
"10376",1943,"52",44401,42608,87009
"10377",1943,"53",43719,42023,85742
"10378",1943,"54",43166,41921,85087
"10379",1943,"55",41893,40563,82456
"10380",1943,"56",41269,39255,80524
"10381",1943,"57",39852,38751,78603
"10382",1943,"58",38649,37213,75862
"10383",1943,"59",36683,35102,71785
"10384",1943,"60",36404,34960,71364
"10385",1943,"61",34818,33408,68226
"10386",1943,"62",33738,31910,65648
"10387",1943,"63",33573,32000,65573
"10388",1943,"64",31529,30337,61866
"10389",1943,"65",30699,29505,60204
"10390",1943,"66",29624,28131,57755
"10391",1943,"67",27386,25894,53280
"10392",1943,"68",26105,24692,50797
"10393",1943,"69",24961,23239,48200
"10394",1943,"70",22879,21342,44221
"10395",1943,"71",20330,18780,39110
"10396",1943,"72",19044,17653,36697
"10397",1943,"73",17746,16189,33935
"10398",1943,"74",16508,15011,31519
"10399",1943,"75",15314,13896,29210
"10400",1943,"76",14050,12677,26727
"10401",1943,"77",12538,11246,23784
"10402",1943,"78",11226,9845,21071
"10403",1943,"79",10194,8930,19124
"10404",1943,"80",7765,6889,14654
"10405",1943,"81",7227,6128,13355
"10406",1943,"82",5414,4789,10203
"10407",1943,"83",4759,4082,8841
"10408",1943,"84",3641,3136,6777
"10409",1943,"85",3077,2479,5556
"10410",1943,"86",2473,1920,4393
"10411",1943,"87",1842,1484,3326
"10412",1943,"88",1398,1146,2544
"10413",1943,"89",1125,820,1945
"10414",1943,"90",864,554,1418
"10415",1943,"91",576,403,979
"10416",1943,"92",429,296,725
"10417",1943,"93",305,183,488
"10418",1943,"94",148,98,246
"10419",1943,"95",101,52,153
"10420",1943,"96",55,39,94
"10421",1943,"97",44,22,66
"10422",1943,"98",14,10,24
"10423",1943,"99",9,4,13
"10424",1943,"100",4,0,4
"10425",1943,"101",2,1,3
"10426",1943,"102",0,1,1
"10427",1943,"103",0,0,0
"10428",1943,"104",0,0,0
"10429",1943,"105",0,0,0
"10430",1943,"106",0,0,0
"10431",1943,"107",0,0,0
"10432",1943,"108",0,0,0
"10433",1943,"109",0,0,0
"10434",1943,"110+",0,0,0
"10435",1944,"0",98239,104384,202623
"10436",1944,"1",87692,93361,181053
"10437",1944,"2",83766,88432,172198
"10438",1944,"3",85561,88933,174494
"10439",1944,"4",83751,86920,170671
"10440",1944,"5",82206,86253,168459
"10441",1944,"6",78505,81875,160380
"10442",1944,"7",78727,82484,161211
"10443",1944,"8",77926,81845,159771
"10444",1944,"9",78666,82389,161055
"10445",1944,"10",77995,81435,159430
"10446",1944,"11",80978,84669,165647
"10447",1944,"12",80116,83849,163965
"10448",1944,"13",81091,84917,166008
"10449",1944,"14",79760,82771,162531
"10450",1944,"15",80228,82751,162979
"10451",1944,"16",78011,80970,158981
"10452",1944,"17",78379,81234,159613
"10453",1944,"18",78795,81096,159891
"10454",1944,"19",80490,82241,162731
"10455",1944,"20",82204,84384,166588
"10456",1944,"21",79648,81782,161430
"10457",1944,"22",80584,81656,162240
"10458",1944,"23",82137,83631,165768
"10459",1944,"24",68933,70743,139676
"10460",1944,"25",67760,69148,136908
"10461",1944,"26",69560,70680,140240
"10462",1944,"27",70661,70976,141637
"10463",1944,"28",69308,69732,139040
"10464",1944,"29",73348,73385,146733
"10465",1944,"30",72817,71975,144792
"10466",1944,"31",72450,71185,143635
"10467",1944,"32",68293,66534,134827
"10468",1944,"33",69301,67754,137055
"10469",1944,"34",70453,68225,138678
"10470",1944,"35",69354,66727,136081
"10471",1944,"36",68226,65376,133602
"10472",1944,"37",66839,63746,130585
"10473",1944,"38",65686,63034,128720
"10474",1944,"39",64540,62257,126797
"10475",1944,"40",62842,60488,123330
"10476",1944,"41",62244,60008,122252
"10477",1944,"42",60472,57679,118151
"10478",1944,"43",57268,54555,111823
"10479",1944,"44",56500,54072,110572
"10480",1944,"45",55336,52999,108335
"10481",1944,"46",54877,52351,107228
"10482",1944,"47",54094,51861,105955
"10483",1944,"48",51740,49465,101205
"10484",1944,"49",50411,47911,98322
"10485",1944,"50",50068,47852,97920
"10486",1944,"51",45835,43884,89719
"10487",1944,"52",46584,44651,91235
"10488",1944,"53",43577,41792,85369
"10489",1944,"54",42805,41151,83956
"10490",1944,"55",42226,40946,83172
"10491",1944,"56",40954,39637,80591
"10492",1944,"57",40265,38334,78599
"10493",1944,"58",38847,37789,76636
"10494",1944,"59",37615,36214,73829
"10495",1944,"60",35721,34229,69950
"10496",1944,"61",35366,33938,69304
"10497",1944,"62",33773,32400,66173
"10498",1944,"63",32648,30902,63550
"10499",1944,"64",32398,30828,63226
"10500",1944,"65",30322,29142,59464
"10501",1944,"66",29533,28279,57812
"10502",1944,"67",28325,26948,55273
"10503",1944,"68",26134,24702,50836
"10504",1944,"69",24802,23461,48263
"10505",1944,"70",23580,22023,45603
"10506",1944,"71",21611,20117,41728
"10507",1944,"72",19119,17650,36769
"10508",1944,"73",17778,16453,34231
"10509",1944,"74",16401,15010,31411
"10510",1944,"75",15171,13715,28886
"10511",1944,"76",14028,12674,26702
"10512",1944,"77",12714,11408,24122
"10513",1944,"78",11184,10024,21208
"10514",1944,"79",9940,8743,18683
"10515",1944,"80",8866,7775,16641
"10516",1944,"81",6777,6029,12806
"10517",1944,"82",6279,5247,11526
"10518",1944,"83",4574,3999,8573
"10519",1944,"84",3966,3378,7344
"10520",1944,"85",2957,2554,5511
"10521",1944,"86",2452,1964,4416
"10522",1944,"87",1923,1466,3389
"10523",1944,"88",1430,1131,2561
"10524",1944,"89",1066,863,1929
"10525",1944,"90",822,579,1401
"10526",1944,"91",583,403,986
"10527",1944,"92",387,279,666
"10528",1944,"93",293,202,495
"10529",1944,"94",180,110,290
"10530",1944,"95",87,66,153
"10531",1944,"96",60,33,93
"10532",1944,"97",29,29,58
"10533",1944,"98",22,15,37
"10534",1944,"99",6,5,11
"10535",1944,"100",3,2,5
"10536",1944,"101",0,0,0
"10537",1944,"102",1,0,1
"10538",1944,"103",0,0,0
"10539",1944,"104",0,0,0
"10540",1944,"105",0,0,0
"10541",1944,"106",0,0,0
"10542",1944,"107",0,0,0
"10543",1944,"108",0,0,0
"10544",1944,"109",0,0,0
"10545",1944,"110+",0,0,0
"10546",1945,"0",102773,108989,211762
"10547",1945,"1",96992,102669,199661
"10548",1945,"2",87118,92602,179720
"10549",1945,"3",83308,87854,171162
"10550",1945,"4",85186,88479,173665
"10551",1945,"5",83425,86535,169960
"10552",1945,"6",81965,85932,167897
"10553",1945,"7",78293,81583,159876
"10554",1945,"8",78539,82255,160794
"10555",1945,"9",77735,81621,159356
"10556",1945,"10",78494,82162,160656
"10557",1945,"11",77830,81214,159044
"10558",1945,"12",80787,84455,165242
"10559",1945,"13",79951,83631,163582
"10560",1945,"14",80901,84672,165573
"10561",1945,"15",79541,82508,162049
"10562",1945,"16",80002,82435,162437
"10563",1945,"17",77766,80598,158364
"10564",1945,"18",78128,80825,158953
"10565",1945,"19",78528,80564,159092
"10566",1945,"20",79921,81272,161193
"10567",1945,"21",81615,83418,165033
"10568",1945,"22",79041,80872,159913
"10569",1945,"23",79978,80771,160749
"10570",1945,"24",81546,82841,164387
"10571",1945,"25",68438,70010,138448
"10572",1945,"26",67264,68467,135731
"10573",1945,"27",69041,69983,139024
"10574",1945,"28",70173,70334,140507
"10575",1945,"29",68755,69001,137756
"10576",1945,"30",72809,72659,145468
"10577",1945,"31",72283,71311,143594
"10578",1945,"32",71944,70576,142520
"10579",1945,"33",67766,65905,133671
"10580",1945,"34",68788,67109,135897
"10581",1945,"35",69917,67570,137487
"10582",1945,"36",68822,66107,134929
"10583",1945,"37",67691,64713,132404
"10584",1945,"38",66306,63118,129424
"10585",1945,"39",65140,62383,127523
"10586",1945,"40",64016,61639,125655
"10587",1945,"41",62313,59849,122162
"10588",1945,"42",61720,59375,121095
"10589",1945,"43",59955,57075,117030
"10590",1945,"44",56738,53924,110662
"10591",1945,"45",55982,53383,109365
"10592",1945,"46",54777,52341,107118
"10593",1945,"47",54354,51703,106057
"10594",1945,"48",53514,51207,104721
"10595",1945,"49",51174,48814,99988
"10596",1945,"50",49826,47251,97077
"10597",1945,"51",49508,47182,96690
"10598",1945,"52",45230,43218,88448
"10599",1945,"53",45979,43964,89943
"10600",1945,"54",42976,41107,84083
"10601",1945,"55",42190,40431,82621
"10602",1945,"56",41552,40179,81731
"10603",1945,"57",40328,38866,79194
"10604",1945,"58",39553,37555,77108
"10605",1945,"59",38145,36998,75143
"10606",1945,"60",37056,35510,72566
"10607",1945,"61",35079,33516,68595
"10608",1945,"62",34716,33173,67889
"10609",1945,"63",33025,31682,64707
"10610",1945,"64",31872,30041,61913
"10611",1945,"65",31605,29969,61574
"10612",1945,"66",29462,28294,57756
"10613",1945,"67",28635,27283,55918
"10614",1945,"68",27365,25915,53280
"10615",1945,"69",25152,23649,48801
"10616",1945,"70",23754,22371,46125
"10617",1945,"71",22508,20975,43483
"10618",1945,"72",20528,19055,39583
"10619",1945,"73",17990,16502,34492
"10620",1945,"74",16662,15287,31949
"10621",1945,"75",15214,13864,29078
"10622",1945,"76",13978,12595,26573
"10623",1945,"77",12746,11438,24184
"10624",1945,"78",11437,10246,21683
"10625",1945,"79",10011,8933,18944
"10626",1945,"80",8786,7788,16574
"10627",1945,"81",7695,6634,14329
"10628",1945,"82",5822,5083,10905
"10629",1945,"83",5254,4327,9581
"10630",1945,"84",3792,3292,7084
"10631",1945,"85",3137,2707,5844
"10632",1945,"86",2281,1958,4239
"10633",1945,"87",1866,1488,3354
"10634",1945,"88",1403,1080,2483
"10635",1945,"89",1027,785,1812
"10636",1945,"90",754,600,1354
"10637",1945,"91",576,400,976
"10638",1945,"92",389,249,638
"10639",1945,"93",241,190,431
"10640",1945,"94",162,131,293
"10641",1945,"95",107,66,173
"10642",1945,"96",54,33,87
"10643",1945,"97",20,15,35
"10644",1945,"98",16,21,37
"10645",1945,"99",6,7,13
"10646",1945,"100",0,3,3
"10647",1945,"101",3,1,4
"10648",1945,"102",0,0,0
"10649",1945,"103",1,0,1
"10650",1945,"104",0,0,0
"10651",1945,"105",0,0,0
"10652",1945,"106",0,0,0
"10653",1945,"107",0,0,0
"10654",1945,"108",0,0,0
"10655",1945,"109",0,0,0
"10656",1945,"110+",0,0,0
"10657",1946,"0",96040,101528,197568
"10658",1946,"1",100205,105721,205926
"10659",1946,"2",96147,101664,197811
"10660",1946,"3",86601,91916,178517
"10661",1946,"4",82905,87351,170256
"10662",1946,"5",84888,88076,172964
"10663",1946,"6",83163,86202,169365
"10664",1946,"7",81770,85638,167408
"10665",1946,"8",78129,81335,159464
"10666",1946,"9",78376,82036,160412
"10667",1946,"10",77603,81434,159037
"10668",1946,"11",78367,81931,160298
"10669",1946,"12",77695,81009,158704
"10670",1946,"13",80669,84270,164939
"10671",1946,"14",79823,83385,163208
"10672",1946,"15",80696,84402,165098
"10673",1946,"16",79362,82223,161585
"10674",1946,"17",79837,82053,161890
"10675",1946,"18",77534,80052,157586
"10676",1946,"19",77891,80108,157999
"10677",1946,"20",78575,79773,158348
"10678",1946,"21",79917,80182,160099
"10679",1946,"22",81648,82314,163962
"10680",1946,"23",79058,79883,158941
"10681",1946,"24",79966,79892,159858
"10682",1946,"25",81517,81987,163504
"10683",1946,"26",68443,69357,137800
"10684",1946,"27",67288,67809,135097
"10685",1946,"28",69073,69459,138532
"10686",1946,"29",70216,69839,140055
"10687",1946,"30",68789,68521,137310
"10688",1946,"31",72822,72136,144958
"10689",1946,"32",72307,70845,143152
"10690",1946,"33",71977,70100,142077
"10691",1946,"34",67794,65475,133269
"10692",1946,"35",68793,66686,135479
"10693",1946,"36",69908,67092,137000
"10694",1946,"37",68796,65659,134455
"10695",1946,"38",67659,64266,131925
"10696",1946,"39",66266,62696,128962
"10697",1946,"40",65096,61942,127038
"10698",1946,"41",63954,61162,125116
"10699",1946,"42",62218,59399,121617
"10700",1946,"43",61611,58894,120505
"10701",1946,"44",59860,56579,116439
"10702",1946,"45",56661,53413,110074
"10703",1946,"46",55872,52841,108713
"10704",1946,"47",54658,51816,106474
"10705",1946,"48",54199,51129,105328
"10706",1946,"49",53337,50645,103982
"10707",1946,"50",50973,48230,99203
"10708",1946,"51",49591,46709,96300
"10709",1946,"52",49231,46581,95812
"10710",1946,"53",44985,42642,87627
"10711",1946,"54",45659,43327,88986
"10712",1946,"55",42091,40434,82525
"10713",1946,"56",41792,39781,81573
"10714",1946,"57",41153,39415,80568
"10715",1946,"58",39908,38089,77997
"10716",1946,"59",39686,36716,76402
"10717",1946,"60",37444,36020,73464
"10718",1946,"61",36374,34489,70863
"10719",1946,"62",34330,32457,66787
"10720",1946,"63",33924,32060,65984
"10721",1946,"64",32234,30514,62748
"10722",1946,"65",31071,28864,59935
"10723",1946,"66",30674,28700,59374
"10724",1946,"67",28458,26947,55405
"10725",1946,"68",27519,25886,53405
"10726",1946,"69",26244,24469,50713
"10727",1946,"70",23920,22166,46086
"10728",1946,"71",22504,20871,43375
"10729",1946,"72",21207,19460,40667
"10730",1946,"73",19271,17510,36781
"10731",1946,"74",16781,14924,31705
"10732",1946,"75",15360,13801,29161
"10733",1946,"76",13913,12384,26297
"10734",1946,"77",12677,11069,23746
"10735",1946,"78",11368,9938,21306
"10736",1946,"79",10042,8795,18837
"10737",1946,"80",8716,7635,16351
"10738",1946,"81",7544,6513,14057
"10739",1946,"82",6497,5413,11910
"10740",1946,"83",4770,4124,8894
"10741",1946,"84",4299,3389,7688
"10742",1946,"85",3044,2529,5573
"10743",1946,"86",2428,2026,4454
"10744",1946,"87",1726,1397,3123
"10745",1946,"88",1364,1047,2411
"10746",1946,"89",1042,757,1799
"10747",1946,"90",707,517,1224
"10748",1946,"91",499,387,886
"10749",1946,"92",373,257,630
"10750",1946,"93",244,156,400
"10751",1946,"94",144,118,262
"10752",1946,"95",92,79,171
"10753",1946,"96",68,43,111
"10754",1946,"97",31,19,50
"10755",1946,"98",10,10,20
"10756",1946,"99",6,10,16
"10757",1946,"100",1,3,4
"10758",1946,"101",0,2,2
"10759",1946,"102",2,0,2
"10760",1946,"103",0,0,0
"10761",1946,"104",1,0,1
"10762",1946,"105",0,0,0
"10763",1946,"106",0,0,0
"10764",1946,"107",0,0,0
"10765",1946,"108",0,0,0
"10766",1946,"109",0,0,0
"10767",1946,"110+",0,0,0
"10768",1947,"0",133728,141815,275543
"10769",1947,"1",95124,100061,195185
"10770",1947,"2",100407,105810,206217
"10771",1947,"3",96140,101407,197547
"10772",1947,"4",87395,92520,179915
"10773",1947,"5",83471,87789,171260
"10774",1947,"6",85858,89147,175005
"10775",1947,"7",83723,86855,170578
"10776",1947,"8",82226,86039,168265
"10777",1947,"9",78576,81989,160565
"10778",1947,"10",78856,82534,161390
"10779",1947,"11",77755,81709,159464
"10780",1947,"12",78383,82018,160401
"10781",1947,"13",77721,81220,158941
"10782",1947,"14",81374,84614,165988
"10783",1947,"15",80353,83521,163874
"10784",1947,"16",82079,85758,167837
"10785",1947,"17",79600,82451,162051
"10786",1947,"18",80244,82616,162860
"10787",1947,"19",78301,80540,158841
"10788",1947,"20",78620,80232,158852
"10789",1947,"21",79041,79543,158584
"10790",1947,"22",80937,79873,160810
"10791",1947,"23",82546,81685,164231
"10792",1947,"24",79988,78829,158817
"10793",1947,"25",81086,79420,160506
"10794",1947,"26",82348,80980,163328
"10795",1947,"27",69056,68026,137082
"10796",1947,"28",67832,66381,134213
"10797",1947,"29",69828,68077,137905
"10798",1947,"30",70264,68620,138884
"10799",1947,"31",68688,67132,135820
"10800",1947,"32",72988,70756,143744
"10801",1947,"33",71849,69560,141409
"10802",1947,"34",71399,69078,140477
"10803",1947,"35",67102,64219,131321
"10804",1947,"36",67881,65413,133294
"10805",1947,"37",69115,66342,135457
"10806",1947,"38",68191,65193,133384
"10807",1947,"39",67137,64188,131325
"10808",1947,"40",65670,62290,127960
"10809",1947,"41",64803,61704,126507
"10810",1947,"42",63865,61241,125106
"10811",1947,"43",62202,59470,121672
"10812",1947,"44",61672,59072,120744
"10813",1947,"45",59724,56373,116097
"10814",1947,"46",56876,53527,110403
"10815",1947,"47",55936,52739,108675
"10816",1947,"48",55000,52020,107020
"10817",1947,"49",54310,51252,105562
"10818",1947,"50",53588,50911,104499
"10819",1947,"51",50964,48484,99448
"10820",1947,"52",49638,46957,96595
"10821",1947,"53",49264,47148,96412
"10822",1947,"54",45225,43116,88341
"10823",1947,"55",45532,43209,88741
"10824",1947,"56",42731,40503,83234
"10825",1947,"57",41546,39819,81365
"10826",1947,"58",40975,39513,80488
"10827",1947,"59",39780,38238,78018
"10828",1947,"60",39083,36863,75946
"10829",1947,"61",37290,35996,73286
"10830",1947,"62",35950,34373,70323
"10831",1947,"63",33849,31995,65844
"10832",1947,"64",33647,31786,65433
"10833",1947,"65",31564,30192,61756
"10834",1947,"66",30615,28482,59097
"10835",1947,"67",29760,28011,57771
"10836",1947,"68",27708,26270,53978
"10837",1947,"69",26738,25198,51936
"10838",1947,"70",25363,23798,49161
"10839",1947,"71",23140,21522,44662
"10840",1947,"72",21616,19989,41605
"10841",1947,"73",20349,18570,38919
"10842",1947,"74",18442,16711,35153
"10843",1947,"75",15923,14225,30148
"10844",1947,"76",14726,13139,27865
"10845",1947,"77",13008,11560,24568
"10846",1947,"78",11824,10189,22013
"10847",1947,"79",10415,9128,19543
"10848",1947,"80",9175,7922,17097
"10849",1947,"81",7836,6790,14626
"10850",1947,"82",6739,5722,12461
"10851",1947,"83",5681,4695,10376
"10852",1947,"84",4108,3505,7613
"10853",1947,"85",3727,2837,6564
"10854",1947,"86",2592,2135,4727
"10855",1947,"87",2001,1644,3645
"10856",1947,"88",1406,1132,2538
"10857",1947,"89",1093,821,1914
"10858",1947,"90",811,584,1395
"10859",1947,"91",550,380,930
"10860",1947,"92",382,276,658
"10861",1947,"93",278,187,465
"10862",1947,"94",189,107,296
"10863",1947,"95",101,80,181
"10864",1947,"96",71,54,125
"10865",1947,"97",50,33,83
"10866",1947,"98",18,12,30
"10867",1947,"99",4,7,11
"10868",1947,"100",4,3,7
"10869",1947,"101",1,1,2
"10870",1947,"102",0,2,2
"10871",1947,"103",1,0,1
"10872",1947,"104",0,0,0
"10873",1947,"105",1,0,1
"10874",1947,"106",0,0,0
"10875",1947,"107",0,0,0
"10876",1947,"108",0,0,0
"10877",1947,"109",0,0,0
"10878",1947,"110+",0,0,0
"10879",1948,"0",126829,133351,260180
"10880",1948,"1",132419,140235,272654
"10881",1948,"2",94798,99605,194403
"10882",1948,"3",100011,105367,205378
"10883",1948,"4",95748,101017,196765
"10884",1948,"5",87189,92212,179401
"10885",1948,"6",83281,87519,170800
"10886",1948,"7",85724,88914,174638
"10887",1948,"8",83598,86678,170276
"10888",1948,"9",82098,85882,167980
"10889",1948,"10",78494,81892,160386
"10890",1948,"11",78802,82414,161216
"10891",1948,"12",77730,81688,159418
"10892",1948,"13",78385,82003,160388
"10893",1948,"14",77723,81232,158955
"10894",1948,"15",81379,84553,165932
"10895",1948,"16",80326,83457,163783
"10896",1948,"17",82030,85739,167769
"10897",1948,"18",79557,82390,161947
"10898",1948,"19",80120,82571,162691
"10899",1948,"20",78086,80496,158582
"10900",1948,"21",78330,80194,158524
"10901",1948,"22",78703,79587,158290
"10902",1948,"23",80408,79797,160205
"10903",1948,"24",81991,81540,163531
"10904",1948,"25",79453,78010,157463
"10905",1948,"26",80450,78957,159407
"10906",1948,"27",81772,80503,162275
"10907",1948,"28",68534,67636,136170
"10908",1948,"29",67303,66620,133923
"10909",1948,"30",69373,67663,137036
"10910",1948,"31",69755,68161,137916
"10911",1948,"32",68225,66846,135071
"10912",1948,"33",72559,70389,142948
"10913",1948,"34",71382,69142,140524
"10914",1948,"35",71058,68605,139663
"10915",1948,"36",66709,63873,130582
"10916",1948,"37",67584,65007,132591
"10917",1948,"38",68714,65963,134677
"10918",1948,"39",67871,64819,132690
"10919",1948,"40",66779,63806,130585
"10920",1948,"41",65240,61873,127113
"10921",1948,"42",64520,61220,125740
"10922",1948,"43",63561,60755,124316
"10923",1948,"44",61899,58956,120855
"10924",1948,"45",61371,58606,119977
"10925",1948,"46",59451,55846,115297
"10926",1948,"47",56603,53025,109628
"10927",1948,"48",55637,52260,107897
"10928",1948,"49",54730,51606,106336
"10929",1948,"50",54020,50865,104885
"10930",1948,"51",53285,50463,103748
"10931",1948,"52",50673,48034,98707
"10932",1948,"53",49319,46525,95844
"10933",1948,"54",48943,46650,95593
"10934",1948,"55",44860,42697,87557
"10935",1948,"56",45127,42729,87856
"10936",1948,"57",42301,40036,82337
"10937",1948,"58",41119,39345,80464
"10938",1948,"59",40578,39005,79583
"10939",1948,"60",39262,37708,76970
"10940",1948,"61",38539,36314,74853
"10941",1948,"62",36784,35366,72150
"10942",1948,"63",35387,33732,69119
"10943",1948,"64",33226,31320,64546
"10944",1948,"65",32940,31078,64018
"10945",1948,"66",30857,29407,60264
"10946",1948,"67",29881,27709,57590
"10947",1948,"68",28958,27203,56161
"10948",1948,"69",26852,25330,52182
"10949",1948,"70",25785,24284,50069
"10950",1948,"71",24381,22824,47205
"10951",1948,"72",22180,20561,42741
"10952",1948,"73",20556,18985,39541
"10953",1948,"74",19307,17542,36849
"10954",1948,"75",17377,15675,33052
"10955",1948,"76",14903,13214,28117
"10956",1948,"77",13664,12163,25827
"10957",1948,"78",11997,10537,22534
"10958",1948,"79",10807,9280,20087
"10959",1948,"80",9499,8227,17726
"10960",1948,"81",8230,7051,15281
"10961",1948,"82",6897,5991,12888
"10962",1948,"83",5870,4948,10818
"10963",1948,"84",4885,3963,8848
"10964",1948,"85",3526,2957,6483
"10965",1948,"86",3131,2364,5495
"10966",1948,"87",2163,1739,3902
"10967",1948,"88",1650,1306,2956
"10968",1948,"89",1142,873,2015
"10969",1948,"90",862,631,1493
"10970",1948,"91",595,424,1019
"10971",1948,"92",425,279,704
"10972",1948,"93",287,199,486
"10973",1948,"94",208,122,330
"10974",1948,"95",139,74,213
"10975",1948,"96",63,51,114
"10976",1948,"97",53,39,92
"10977",1948,"98",33,18,51
"10978",1948,"99",9,7,16
"10979",1948,"100",2,3,5
"10980",1948,"101",2,2,4
"10981",1948,"102",0,1,1
"10982",1948,"103",0,0,0
"10983",1948,"104",1,0,1
"10984",1948,"105",0,0,0
"10985",1948,"106",1,0,1
"10986",1948,"107",0,0,0
"10987",1948,"108",0,0,0
"10988",1948,"109",0,0,0
"10989",1948,"110+",0,0,0
"10990",1949,"0",116985,124624,241609
"10991",1949,"1",125919,132533,258452
"10992",1949,"2",131495,138843,270338
"10993",1949,"3",94606,99400,194006
"10994",1949,"4",99755,105009,204764
"10995",1949,"5",95576,100820,196396
"10996",1949,"6",86920,91933,178853
"10997",1949,"7",82932,87255,170187
"10998",1949,"8",85409,88536,173945
"10999",1949,"9",83334,86324,169658
"11000",1949,"10",81814,85567,167381
"11001",1949,"11",78284,81664,159948
"11002",1949,"12",78569,82122,160691
"11003",1949,"13",77543,81463,159006
"11004",1949,"14",78265,81800,160065
"11005",1949,"15",77596,81049,158645
"11006",1949,"16",81244,84390,165634
"11007",1949,"17",80160,83308,163468
"11008",1949,"18",81976,85592,167568
"11009",1949,"19",79492,82103,161595
"11010",1949,"20",80133,82344,162477
"11011",1949,"21",78125,80459,158584
"11012",1949,"22",78302,79999,158301
"11013",1949,"23",78864,79532,158396
"11014",1949,"24",80503,79648,160151
"11015",1949,"25",82041,81548,163589
"11016",1949,"26",79413,78604,158017
"11017",1949,"27",80529,78988,159517
"11018",1949,"28",81812,80467,162279
"11019",1949,"29",68440,67595,136035
"11020",1949,"30",67227,65988,133215
"11021",1949,"31",69179,67617,136796
"11022",1949,"32",69533,68120,137653
"11023",1949,"33",68013,66722,134735
"11024",1949,"34",72338,70280,142618
"11025",1949,"35",71174,68954,140128
"11026",1949,"36",70720,68487,139207
"11027",1949,"37",66413,63685,130098
"11028",1949,"38",67271,64828,132099
"11029",1949,"39",68435,65809,134244
"11030",1949,"40",67540,64643,132183
"11031",1949,"41",66514,63637,130151
"11032",1949,"42",64979,61630,126609
"11033",1949,"43",64248,61035,125283
"11034",1949,"44",63253,60427,123680
"11035",1949,"45",61634,58778,120412
"11036",1949,"46",61148,58372,119520
"11037",1949,"47",59204,55651,114855
"11038",1949,"48",56353,52825,109178
"11039",1949,"49",55382,51973,107355
"11040",1949,"50",54420,51318,105738
"11041",1949,"51",53718,50501,104219
"11042",1949,"52",53004,50153,103157
"11043",1949,"53",50382,47697,98079
"11044",1949,"54",49010,46166,95176
"11045",1949,"55",48632,46292,94924
"11046",1949,"56",44564,42250,86814
"11047",1949,"57",44797,42294,87091
"11048",1949,"58",41984,39632,81616
"11049",1949,"59",40747,38839,79586
"11050",1949,"60",40160,38516,78676
"11051",1949,"61",38824,37170,75994
"11052",1949,"62",38056,35763,73819
"11053",1949,"63",36260,34759,71019
"11054",1949,"64",34800,33067,67867
"11055",1949,"65",32681,30690,63371
"11056",1949,"66",32204,30355,62559
"11057",1949,"67",30201,28594,58795
"11058",1949,"68",29122,26917,56039
"11059",1949,"69",28182,26395,54577
"11060",1949,"70",26004,24449,50453
"11061",1949,"71",24866,23308,48174
"11062",1949,"72",23420,21850,45270
"11063",1949,"73",21209,19582,40791
"11064",1949,"74",19601,17993,37594
"11065",1949,"75",18270,16529,34799
"11066",1949,"76",16435,14701,31136
"11067",1949,"77",13925,12316,26241
"11068",1949,"78",12656,11246,23902
"11069",1949,"79",11000,9657,20657
"11070",1949,"80",9885,8374,18259
"11071",1949,"81",8573,7373,15946
"11072",1949,"82",7396,6281,13677
"11073",1949,"83",6068,5248,11316
"11074",1949,"84",5111,4241,9352
"11075",1949,"85",4234,3362,7596
"11076",1949,"86",3007,2508,5515
"11077",1949,"87",2635,1955,4590
"11078",1949,"88",1767,1435,3202
"11079",1949,"89",1371,1039,2410
"11080",1949,"90",948,696,1644
"11081",1949,"91",659,497,1156
"11082",1949,"92",481,319,800
"11083",1949,"93",309,200,509
"11084",1949,"94",207,145,352
"11085",1949,"95",154,89,243
"11086",1949,"96",103,55,158
"11087",1949,"97",43,32,75
"11088",1949,"98",29,21,50
"11089",1949,"99",22,15,37
"11090",1949,"100",6,6,12
"11091",1949,"101",1,2,3
"11092",1949,"102",0,2,2
"11093",1949,"103",0,1,1
"11094",1949,"104",0,0,0
"11095",1949,"105",1,0,1
"11096",1949,"106",0,0,0
"11097",1949,"107",0,0,0
"11098",1949,"108",0,0,0
"11099",1949,"109",0,0,0
"11100",1949,"110+",0,0,0
"11101",1950,"0",112111,118626,230737
"11102",1950,"1",116136,123547,239683
"11103",1950,"2",125300,131904,257204
"11104",1950,"3",131051,138267,269318
"11105",1950,"4",94343,99086,193429
"11106",1950,"5",99557,104739,204296
"11107",1950,"6",95348,100543,195891
"11108",1950,"7",86673,91677,178350
"11109",1950,"8",82771,87045,169816
"11110",1950,"9",85290,88354,173644
"11111",1950,"10",83216,86135,169351
"11112",1950,"11",81705,85409,167114
"11113",1950,"12",78207,81548,159755
"11114",1950,"13",78503,82032,160535
"11115",1950,"14",77495,81352,158847
"11116",1950,"15",78186,81667,159853
"11117",1950,"16",77582,80900,158482
"11118",1950,"17",81190,84349,165539
"11119",1950,"18",80128,83188,163316
"11120",1950,"19",81906,85433,167339
"11121",1950,"20",79455,81951,161406
"11122",1950,"21",79947,82030,161977
"11123",1950,"22",77885,79930,157815
"11124",1950,"23",78039,79403,157442
"11125",1950,"24",78476,78885,157361
"11126",1950,"25",80213,79046,159259
"11127",1950,"26",81650,80991,162641
"11128",1950,"27",79059,77962,157021
"11129",1950,"28",80162,78448,158610
"11130",1950,"29",81468,80028,161496
"11131",1950,"30",68175,67146,135321
"11132",1950,"31",66894,65624,132518
"11133",1950,"32",68813,67245,136058
"11134",1950,"33",69236,67762,136998
"11135",1950,"34",67738,66326,134064
"11136",1950,"35",72039,69932,141971
"11137",1950,"36",70953,68606,139559
"11138",1950,"37",70518,68136,138654
"11139",1950,"38",66222,63389,129611
"11140",1950,"39",67039,64548,131587
"11141",1950,"40",68181,65528,133709
"11142",1950,"41",67309,64327,131636
"11143",1950,"42",66262,63397,129659
"11144",1950,"43",64844,61330,126174
"11145",1950,"44",64051,60813,124864
"11146",1950,"45",63058,60237,123295
"11147",1950,"46",61382,58499,119881
"11148",1950,"47",60923,58144,119067
"11149",1950,"48",58969,55401,114370
"11150",1950,"49",56120,52576,108696
"11151",1950,"50",55144,51696,106840
"11152",1950,"51",54210,51019,105229
"11153",1950,"52",53440,50160,103600
"11154",1950,"53",52706,49807,102513
"11155",1950,"54",50117,47320,97437
"11156",1950,"55",48660,45823,94483
"11157",1950,"56",48348,45859,94207
"11158",1950,"57",44237,41874,86111
"11159",1950,"58",44399,41831,86230
"11160",1950,"59",41594,39192,80786
"11161",1950,"60",40274,38313,78587
"11162",1950,"61",39681,37949,77630
"11163",1950,"62",38316,36580,74896
"11164",1950,"63",37510,35138,72648
"11165",1950,"64",35647,34116,69763
"11166",1950,"65",34125,32344,66469
"11167",1950,"66",31963,29949,61912
"11168",1950,"67",31416,29545,60961
"11169",1950,"68",29403,27764,57167
"11170",1950,"69",28221,26037,54258
"11171",1950,"70",27206,25405,52611
"11172",1950,"71",24948,23410,48358
"11173",1950,"72",23771,22227,45998
"11174",1950,"73",22269,20714,42983
"11175",1950,"74",19980,18458,38438
"11176",1950,"75",18382,16816,35198
"11177",1950,"76",16970,15330,32300
"11178",1950,"77",15188,13539,28727
"11179",1950,"78",12742,11265,24007
"11180",1950,"79",11468,10140,21608
"11181",1950,"80",10020,8673,18693
"11182",1950,"81",8783,7380,16163
"11183",1950,"82",7480,6357,13837
"11184",1950,"83",6381,5338,11719
"11185",1950,"84",5131,4469,9600
"11186",1950,"85",4267,3484,7751
"11187",1950,"86",3473,2735,6208
"11188",1950,"87",2430,2009,4439
"11189",1950,"88",2079,1521,3600
"11190",1950,"89",1357,1087,2444
"11191",1950,"90",1059,795,1854
"11192",1950,"91",725,517,1242
"11193",1950,"92",470,340,810
"11194",1950,"93",342,208,550
"11195",1950,"94",222,138,360
"11196",1950,"95",145,91,236
"11197",1950,"96",93,66,159
"11198",1950,"97",60,35,95
"11199",1950,"98",32,19,51
"11200",1950,"99",14,11,25
"11201",1950,"100",12,11,23
"11202",1950,"101",6,6,12
"11203",1950,"102",1,0,1
"11204",1950,"103",0,1,1
"11205",1950,"104",0,0,0
"11206",1950,"105",0,0,0
"11207",1950,"106",0,0,0
"11208",1950,"107",0,0,0
"11209",1950,"108",0,0,0
"11210",1950,"109",0,0,0
"11211",1950,"110+",0,0,0
"11212",1951,"0",109356,115825,225181
"11213",1951,"1",112173,118558,230731
"11214",1951,"2",116449,123918,240367
"11215",1951,"3",125306,131595,256901
"11216",1951,"4",131399,138892,270291
"11217",1951,"5",94120,98818,192938
"11218",1951,"6",99367,104509,203876
"11219",1951,"7",95188,100366,195554
"11220",1951,"8",86933,91895,178828
"11221",1951,"9",83112,87334,170446
"11222",1951,"10",85668,88745,174413
"11223",1951,"11",83527,86450,169977
"11224",1951,"12",82030,85672,167702
"11225",1951,"13",78465,81781,160246
"11226",1951,"14",78733,82272,161005
"11227",1951,"15",77756,81471,159227
"11228",1951,"16",78359,81805,160164
"11229",1951,"17",77760,80995,158755
"11230",1951,"18",81388,84288,165676
"11231",1951,"19",80314,83025,163339
"11232",1951,"20",82111,85202,167313
"11233",1951,"21",79559,81646,161205
"11234",1951,"22",80051,81658,161709
"11235",1951,"23",77938,79396,157334
"11236",1951,"24",78123,78732,156855
"11237",1951,"25",78541,78191,156732
"11238",1951,"26",80224,78516,158740
"11239",1951,"27",81663,80531,162194
"11240",1951,"28",79129,77576,156705
"11241",1951,"29",80320,78268,158588
"11242",1951,"30",81669,79886,161555
"11243",1951,"31",68396,67176,135572
"11244",1951,"32",67088,65666,132754
"11245",1951,"33",69008,67397,136405
"11246",1951,"34",69454,67890,137344
"11247",1951,"35",67914,66402,134316
"11248",1951,"36",72201,69952,142153
"11249",1951,"37",71092,68590,139682
"11250",1951,"38",70631,68165,138796
"11251",1951,"39",66373,63419,129792
"11252",1951,"40",67191,64553,131744
"11253",1951,"41",68276,65544,133820
"11254",1951,"42",67412,64338,131750
"11255",1951,"43",66364,63356,129720
"11256",1951,"44",64875,61304,126179
"11257",1951,"45",64044,60768,124812
"11258",1951,"46",63062,60167,123229
"11259",1951,"47",61357,58399,119756
"11260",1951,"48",60853,58051,118904
"11261",1951,"49",58935,55282,114217
"11262",1951,"50",56110,52485,108595
"11263",1951,"51",55075,51538,106613
"11264",1951,"52",54103,50838,104941
"11265",1951,"53",53269,49945,103214
"11266",1951,"54",52521,49488,102009
"11267",1951,"55",49897,47043,96940
"11268",1951,"56",48409,45527,93936
"11269",1951,"57",48051,45488,93539
"11270",1951,"58",43953,41500,85453
"11271",1951,"59",44052,41424,85476
"11272",1951,"60",41269,38735,80004
"11273",1951,"61",39899,37819,77718
"11274",1951,"62",39249,37416,76665
"11275",1951,"63",37787,35961,73748
"11276",1951,"64",36949,34497,71446
"11277",1951,"65",35001,33384,68385
"11278",1951,"66",33446,31598,65044
"11279",1951,"67",31298,29200,60498
"11280",1951,"68",30640,28713,59353
"11281",1951,"69",28547,26887,55434
"11282",1951,"70",27375,25109,52484
"11283",1951,"71",26229,24371,50600
"11284",1951,"72",23969,22414,46383
"11285",1951,"73",22749,21185,43934
"11286",1951,"74",21170,19665,40835
"11287",1951,"75",18914,17356,36270
"11288",1951,"76",17192,15705,32897
"11289",1951,"77",15818,14239,30057
"11290",1951,"78",13969,12410,26379
"11291",1951,"79",11640,10256,21896
"11292",1951,"80",10373,9107,19480
"11293",1951,"81",9013,7731,16744
"11294",1951,"82",7738,6471,14209
"11295",1951,"83",6517,5500,12017
"11296",1951,"84",5494,4516,10010
"11297",1951,"85",4311,3745,8056
"11298",1951,"86",3553,2902,6455
"11299",1951,"87",2856,2214,5070
"11300",1951,"88",1940,1587,3527
"11301",1951,"89",1602,1161,2763
"11302",1951,"90",1037,805,1842
"11303",1951,"91",791,604,1395
"11304",1951,"92",542,376,918
"11305",1951,"93",346,236,582
"11306",1951,"94",256,146,402
"11307",1951,"95",167,101,268
"11308",1951,"96",106,54,160
"11309",1951,"97",62,42,104
"11310",1951,"98",38,20,58
"11311",1951,"99",17,11,28
"11312",1951,"100",8,7,15
"11313",1951,"101",7,3,10
"11314",1951,"102",5,2,7
"11315",1951,"103",1,0,1
"11316",1951,"104",0,1,1
"11317",1951,"105",0,0,0
"11318",1951,"106",0,0,0
"11319",1951,"107",0,0,0
"11320",1951,"108",0,0,0
"11321",1951,"109",0,0,0
"11322",1951,"110+",0,0,0
"11323",1952,"0",108283,114592,222875
"11324",1952,"1",108606,114994,223600
"11325",1952,"2",111779,118097,229876
"11326",1952,"3",116084,123406,239490
"11327",1952,"4",124953,131127,256080
"11328",1952,"5",130889,138163,269052
"11329",1952,"6",93707,98300,192007
"11330",1952,"7",98933,103957,202890
"11331",1952,"8",94818,99922,194740
"11332",1952,"9",86747,91635,178382
"11333",1952,"10",82991,87179,170170
"11334",1952,"11",85548,88638,174186
"11335",1952,"12",83429,86345,169774
"11336",1952,"13",81963,85495,167458
"11337",1952,"14",78381,81651,160032
"11338",1952,"15",78669,82176,160845
"11339",1952,"16",77720,81361,159081
"11340",1952,"17",78299,81661,159960
"11341",1952,"18",77641,80776,158417
"11342",1952,"19",81263,83810,165073
"11343",1952,"20",80109,82479,162588
"11344",1952,"21",81760,84594,166354
"11345",1952,"22",79179,80799,159978
"11346",1952,"23",79583,80451,160034
"11347",1952,"24",77477,78188,155665
"11348",1952,"25",77677,77573,155250
"11349",1952,"26",78146,76986,155132
"11350",1952,"27",79809,77509,157318
"11351",1952,"28",81248,79623,160871
"11352",1952,"29",78747,76936,155683
"11353",1952,"30",79965,77691,157656
"11354",1952,"31",81396,79343,160739
"11355",1952,"32",68126,66729,134855
"11356",1952,"33",66832,65310,132142
"11357",1952,"34",68710,66986,135696
"11358",1952,"35",69204,67494,136698
"11359",1952,"36",67634,66085,133719
"11360",1952,"37",71965,69646,141611
"11361",1952,"38",70811,68307,139118
"11362",1952,"39",70436,67810,138246
"11363",1952,"40",66204,63084,129288
"11364",1952,"41",66985,64283,131268
"11365",1952,"42",68058,65234,133292
"11366",1952,"43",67227,64068,131295
"11367",1952,"44",66191,63099,129290
"11368",1952,"45",64700,61005,125705
"11369",1952,"46",63859,60433,124292
"11370",1952,"47",62905,59897,122802
"11371",1952,"48",61210,58125,119335
"11372",1952,"49",60657,57780,118437
"11373",1952,"50",58732,55050,113782
"11374",1952,"51",55911,52257,108168
"11375",1952,"52",54870,51232,106102
"11376",1952,"53",53846,50552,104398
"11377",1952,"54",53007,49545,102552
"11378",1952,"55",52262,49150,101412
"11379",1952,"56",49588,46676,96264
"11380",1952,"57",48043,45090,93133
"11381",1952,"58",47674,45032,92706
"11382",1952,"59",43586,41048,84634
"11383",1952,"60",43640,40938,84578
"11384",1952,"61",40842,38205,79047
"11385",1952,"62",39417,37231,76648
"11386",1952,"63",38772,36728,75500
"11387",1952,"64",37230,35325,72555
"11388",1952,"65",36346,33813,70159
"11389",1952,"66",34352,32614,66966
"11390",1952,"67",32734,30785,63519
"11391",1952,"68",30575,28394,58969
"11392",1952,"69",29779,27774,57553
"11393",1952,"70",27627,25958,53585
"11394",1952,"71",26448,24211,50659
"11395",1952,"72",25215,23310,48525
"11396",1952,"73",23006,21377,44383
"11397",1952,"74",21679,20043,41722
"11398",1952,"75",20058,18571,38629
"11399",1952,"76",17736,16179,33915
"11400",1952,"77",15993,14496,30489
"11401",1952,"78",14609,13052,27661
"11402",1952,"79",12752,11243,23995
"11403",1952,"80",10689.61,9263,19952.61
"11404",1952,"81",9280,8092,17372
"11405",1952,"82",7994,6765,14759
"11406",1952,"83",6739,5639,12378
"11407",1952,"84",5616,4632,10248
"11408",1952,"85",4643,3792,8435
"11409",1952,"86",3609,3037,6646
"11410",1952,"87",2895,2382,5277
"11411",1952,"88",2307,1759,4066
"11412",1952,"89",1535,1226,2761
"11413",1952,"90",1211,871,2082
"11414",1952,"91",790,611,1401
"11415",1952,"92",597,419,1016
"11416",1952,"93",391,265,656
"11417",1952,"94",239,152,391
"11418",1952,"95",173,105,278
"11419",1952,"96",101,63,164
"11420",1952,"97",80,27,107
"11421",1952,"98",39,21,60
"11422",1952,"99",25,11,36
"11423",1952,"100",11,8,19
"11424",1952,"101",3,5,8
"11425",1952,"102",3,2,5
"11426",1952,"103",3,1,4
"11427",1952,"104",0,0,0
"11428",1952,"105",0,0,0
"11429",1952,"106",0,0,0
"11430",1952,"107",0,0,0
"11431",1952,"108",0,0,0
"11432",1952,"109",0,0,0
"11433",1952,"110+",0,0,0
"11434",1953,"0",109995,116582,226577
"11435",1953,"1",107307,113540,220847
"11436",1953,"2",107871,114158,222029
"11437",1953,"3",111052,117307,228359
"11438",1953,"4",115430,122582,238012
"11439",1953,"5",124236,130247,254483
"11440",1953,"6",130045,137263,267308
"11441",1953,"7",93150,97628,190778
"11442",1953,"8",98317,103210,201527
"11443",1953,"9",94264,99287,193551
"11444",1953,"10",86352,91152,177504
"11445",1953,"11",82649,86748,169397
"11446",1953,"12",85165,88324,173489
"11447",1953,"13",83152,86048,169200
"11448",1953,"14",81681,85179,166860
"11449",1953,"15",78081,81359,159440
"11450",1953,"16",78371,81817,160188
"11451",1953,"17",77467,81021,158488
"11452",1953,"18",78023,81225,159248
"11453",1953,"19",77296,80157,157453
"11454",1953,"20",80745,82931,163676
"11455",1953,"21",79483,81616,161099
"11456",1953,"22",80997,83334,164331
"11457",1953,"23",78407,79417,157824
"11458",1953,"24",78742,79040,157782
"11459",1953,"25",76695,76867,153562
"11460",1953,"26",76963,76242,153205
"11461",1953,"27",77451,75780,153231
"11462",1953,"28",79168,76497,155665
"11463",1953,"29",80601,78627,159228
"11464",1953,"30",78178,76091,154269
"11465",1953,"31",79439,77010,156449
"11466",1953,"32",80837,78581,159418
"11467",1953,"33",67667,66100,133767
"11468",1953,"34",66357,64748,131105
"11469",1953,"35",68222,66441,134663
"11470",1953,"36",68792,66935,135727
"11471",1953,"37",67237,65564,132801
"11472",1953,"38",71484,69137,140621
"11473",1953,"39",70367,67804,138171
"11474",1953,"40",70057,67287,137344
"11475",1953,"41",65840,62609,128449
"11476",1953,"42",66512,63821,130333
"11477",1953,"43",67708,64807,132515
"11478",1953,"44",66873,63611,130484
"11479",1953,"45",65875,62664,128539
"11480",1953,"46",64379,60600,124979
"11481",1953,"47",63564,60024,123588
"11482",1953,"48",62590,59557,122147
"11483",1953,"49",60911,57751,118662
"11484",1953,"50",60299,57380,117679
"11485",1953,"51",58461,54656,113117
"11486",1953,"52",55628,51863,107491
"11487",1953,"53",54517,50865,105382
"11488",1953,"54",53513,50082,103595
"11489",1953,"55",52645,49091,101736
"11490",1953,"56",51892,48662,100554
"11491",1953,"57",49245,46175,95420
"11492",1953,"58",47679,44564,92243
"11493",1953,"59",47211,44500,91711
"11494",1953,"60",43206,40485,83691
"11495",1953,"61",43158,40369,83527
"11496",1953,"62",40352,37586,77938
"11497",1953,"63",38913,36574,75487
"11498",1953,"64",38196,36074,74270
"11499",1953,"65",36593,34584,71177
"11500",1953,"66",35664,33023,68687
"11501",1953,"67",33629,31816,65445
"11502",1953,"68",32001,29913,61914
"11503",1953,"69",29756,27465,57221
"11504",1953,"70",28909,26776,55685
"11505",1953,"71",26727,25004,51731
"11506",1953,"72",25485,23211,48696
"11507",1953,"73",24124,22236,46360
"11508",1953,"74",21814,20232,42046
"11509",1953,"75",20560,18900,39460
"11510",1953,"76",18806,17419,36225
"11511",1953,"77",16593,15077,31670
"11512",1953,"78",14834,13384,28218
"11513",1953,"79",13372,11902,25274
"11514",1953,"80",11469.81,10089,21558.81
"11515",1953,"81",9584.61,8247,17831.61
"11516",1953,"82",8272,7132,15404
"11517",1953,"83",7018,5920,12938
"11518",1953,"84",5861,4871,10732
"11519",1953,"85",4781,3937,8718
"11520",1953,"86",3870,3176,7046
"11521",1953,"87",2958,2489,5447
"11522",1953,"88",2338,1911,4249
"11523",1953,"89",1844,1356,3200
"11524",1953,"90",1212,953,2165
"11525",1953,"91",943,641,1584
"11526",1953,"92",596,433,1029
"11527",1953,"93",435,293,728
"11528",1953,"94",275,170,445
"11529",1953,"95",163,102,265
"11530",1953,"96",117,67,184
"11531",1953,"97",70,41,111
"11532",1953,"98",57,14,71
"11533",1953,"99",19,6,25
"11534",1953,"100",17,9,26
"11535",1953,"101",8,5,13
"11536",1953,"102",1,1,2
"11537",1953,"103",0,0,0
"11538",1953,"104",0,0,0
"11539",1953,"105",0,0,0
"11540",1953,"106",0,0,0
"11541",1953,"107",0,0,0
"11542",1953,"108",0,0,0
"11543",1953,"109",0,0,0
"11544",1953,"110+",0,0,0
"11545",1954,"0",108433,114583,223016
"11546",1954,"1",109178,115628,224806
"11547",1954,"2",106801,112981,219782
"11548",1954,"3",107390,113518,220908
"11549",1954,"4",110537,116834,227371
"11550",1954,"5",114982,122073,237055
"11551",1954,"6",123766,129718,253484
"11552",1954,"7",129562,136631,266193
"11553",1954,"8",92768,97191,189959
"11554",1954,"9",97966,102749,200715
"11555",1954,"10",93897,98912,192809
"11556",1954,"11",86084,90884,176968
"11557",1954,"12",82431,86550,168981
"11558",1954,"13",85000,88105,173105
"11559",1954,"14",82975,85815,168790
"11560",1954,"15",81455,84940,166395
"11561",1954,"16",77872,81111,158983
"11562",1954,"17",78132,81560,159692
"11563",1954,"18",77209,80666,157875
"11564",1954,"19",77748,80695,158443
"11565",1954,"20",76948,79514,156462
"11566",1954,"21",80066,82241,162307
"11567",1954,"22",78768,80848,159616
"11568",1954,"23",80227,82282,162509
"11569",1954,"24",77707,78385,156092
"11570",1954,"25",78052,78167,156219
"11571",1954,"26",76087,76036,152123
"11572",1954,"27",76470,75487,151957
"11573",1954,"28",76968,75099,152067
"11574",1954,"29",78647,75906,154553
"11575",1954,"30",80147,78043,158190
"11576",1954,"31",77763,75589,153352
"11577",1954,"32",79016,76468,155484
"11578",1954,"33",80353,78155,158508
"11579",1954,"34",67335,65760,133095
"11580",1954,"35",66023,64432,130455
"11581",1954,"36",67860,66076,133936
"11582",1954,"37",68482,66612,135094
"11583",1954,"38",66955,65254,132209
"11584",1954,"39",71163,68813,139976
"11585",1954,"40",70077,67455,137532
"11586",1954,"41",69766,66934,136700
"11587",1954,"42",65572,62267,127839
"11588",1954,"43",66263,63500,129763
"11589",1954,"44",67374,64478,131852
"11590",1954,"45",66622,63238,129860
"11591",1954,"46",65525,62317,127842
"11592",1954,"47",64089,60263,124352
"11593",1954,"48",63238,59640,122878
"11594",1954,"49",62301,59239,121540
"11595",1954,"50",60556,57422,117978
"11596",1954,"51",59974,57025,116999
"11597",1954,"52",58144,54282,112426
"11598",1954,"53",55328,51503,106831
"11599",1954,"54",54175,50471,104646
"11600",1954,"55",53151,49629,102780
"11601",1954,"56",52259,48575,100834
"11602",1954,"57",51490,48187,99677
"11603",1954,"58",48816,45634,94450
"11604",1954,"59",47246,43986,91232
"11605",1954,"60",46715,43872,90587
"11606",1954,"61",42724,39873,82597
"11607",1954,"62",42655,39700,82355
"11608",1954,"63",39777,36915,76692
"11609",1954,"64",38326,35857,74183
"11610",1954,"65",37513,35317,72830
"11611",1954,"66",35871,33777,69648
"11612",1954,"67",34919,32163,67082
"11613",1954,"68",32834,30876,63710
"11614",1954,"69",31162,28991,60153
"11615",1954,"70",28848,26432,55280
"11616",1954,"71",27892,25715,53607
"11617",1954,"72",25690,23942,49632
"11618",1954,"73",24419,22100,46519
"11619",1954,"74",22956,21055,44011
"11620",1954,"75",20621,18974,39595
"11621",1954,"76",19277,17594,36871
"11622",1954,"77",17476,16098,33574
"11623",1954,"78",15354,13848,29202
"11624",1954,"79",13545,12177,25722
"11625",1954,"80",12253.58,10740.5,22994.08
"11626",1954,"81",10255.81,9022,19277.81
"11627",1954,"82",8477.61,7198,15675.61
"11628",1954,"83",7288,6158,13446
"11629",1954,"84",6063,5073,11136
"11630",1954,"85",5017,4088,9105
"11631",1954,"86",4009,3249,7258
"11632",1954,"87",3184,2582,5766
"11633",1954,"88",2393,1992,4385
"11634",1954,"89",1844,1481,3325
"11635",1954,"90",1418,1015,2433
"11636",1954,"91",933,697,1630
"11637",1954,"92",710,469,1179
"11638",1954,"93",436,296,732
"11639",1954,"94",303,194,497
"11640",1954,"95",172,124,296
"11641",1954,"96",108,70,178
"11642",1954,"97",79,42,121
"11643",1954,"98",48,25,73
"11644",1954,"99",40,6,46
"11645",1954,"100",10,5,15
"11646",1954,"101",9,3,12
"11647",1954,"102",2,3,5
"11648",1954,"103",0,1,1
"11649",1954,"104",0,0,0
"11650",1954,"105",0,0,0
"11651",1954,"106",0,0,0
"11652",1954,"107",0,0,0
"11653",1954,"108",0,0,0
"11654",1954,"109",0,0,0
"11655",1954,"110+",0,0,0
"11656",1955,"0",108517,115037,223554
"11657",1955,"1",107844,113890,221734
"11658",1955,"2",108839,115210,224049
"11659",1955,"3",106554,112608,219162
"11660",1955,"4",107070,113210,220280
"11661",1955,"5",110313,116511,226824
"11662",1955,"6",114739,121752,236491
"11663",1955,"7",123529,129397,252926
"11664",1955,"8",129301,136207,265508
"11665",1955,"9",92471,96897,189368
"11666",1955,"10",97741,102411,200152
"11667",1955,"11",93630,98682,192312
"11668",1955,"12",85939,90714,176653
"11669",1955,"13",82310,86478,168788
"11670",1955,"14",84896,88017,172913
"11671",1955,"15",82888,85710,168598
"11672",1955,"16",81375,84802,166177
"11673",1955,"17",77778,80970,158748
"11674",1955,"18",78009,81367,159376
"11675",1955,"19",77053,80217,157270
"11676",1955,"20",77544,80138,157682
"11677",1955,"21",76486,79055,155541
"11678",1955,"22",79517,81574,161091
"11679",1955,"23",78205,79999,158204
"11680",1955,"24",79620,81439,161059
"11681",1955,"25",77224,77654,154878
"11682",1955,"26",77570,77472,155042
"11683",1955,"27",75753,75508,151261
"11684",1955,"28",76098,74995,151093
"11685",1955,"29",76650,74618,151268
"11686",1955,"30",78349,75566,153915
"11687",1955,"31",79885,77644,157529
"11688",1955,"32",77541,75282,152823
"11689",1955,"33",78798,76199,154997
"11690",1955,"34",80086,77833,157919
"11691",1955,"35",67157,65600,132757
"11692",1955,"36",65855,64221,130076
"11693",1955,"37",67723,65870,133593
"11694",1955,"38",68252,66384,134636
"11695",1955,"39",66770,65011,131781
"11696",1955,"40",70935,68589,139524
"11697",1955,"41",69854,67166,137020
"11698",1955,"42",69580,66653,136233
"11699",1955,"43",65330,62023,127353
"11700",1955,"44",66073,63237,129310
"11701",1955,"45",67173,64236,131409
"11702",1955,"46",66388,62953,129341
"11703",1955,"47",65366,62021,127387
"11704",1955,"48",63867,60005,123872
"11705",1955,"49",63037,59333,122370
"11706",1955,"50",62027,58927,120954
"11707",1955,"51",60296,57065,117361
"11708",1955,"52",59741,56668,116409
"11709",1955,"53",57845,53926,111771
"11710",1955,"54",55051,51083,106134
"11711",1955,"55",53847,50003,103850
"11712",1955,"56",52830,49162,101992
"11713",1955,"57",51930,48056,99986
"11714",1955,"58",51103,47618,98721
"11715",1955,"59",48416,45027,93443
"11716",1955,"60",46836,43369,90205
"11717",1955,"61",46271,43209,89480
"11718",1955,"62",42215,39230,81445
"11719",1955,"63",42051,38993,81044
"11720",1955,"64",39223,36187,75410
"11721",1955,"65",37709,35060,72769
"11722",1955,"66",36820,34517,71337
"11723",1955,"67",35140,32900,68040
"11724",1955,"68",34071,31219,65290
"11725",1955,"69",31980,29882,61862
"11726",1955,"70",30275,28028,58303
"11727",1955,"71",27920,25425,53345
"11728",1955,"72",26887,24614,51501
"11729",1955,"73",24570,22827,47397
"11730",1955,"74",23301,20935,44236
"11731",1955,"75",21807,19795,41602
"11732",1955,"76",19432,17733,37165
"11733",1955,"77",18059,16354,34413
"11734",1955,"78",16155,14864,31019
"11735",1955,"79",14108,12630,26738
"11736",1955,"80",12387.21,11019.5,23406.71
"11737",1955,"81",10990.58,9639.5,20630.08
"11738",1955,"82",9100.81,7938,17038.81
"11739",1955,"83",7470.61,6246,13716.61
"11740",1955,"84",6325,5258,11583
"11741",1955,"85",5154,4274,9428
"11742",1955,"86",4227,3381,7608
"11743",1955,"87",3310,2623,5933
"11744",1955,"88",2619,2028,4647
"11745",1955,"89",1915,1526,3441
"11746",1955,"90",1482,1124,2606
"11747",1955,"91",1096,777,1873
"11748",1955,"92",695,518,1213
"11749",1955,"93",538,350,888
"11750",1955,"94",300,201,501
"11751",1955,"95",211,139,350
"11752",1955,"96",117,89,206
"11753",1955,"97",72,44,116
"11754",1955,"98",53,22,75
"11755",1955,"99",31,15,46
"11756",1955,"100",26,2,28
"11757",1955,"101",6,1,7
"11758",1955,"102",6,1,7
"11759",1955,"103",0,1,1
"11760",1955,"104",0,0,0
"11761",1955,"105",0,0,0
"11762",1955,"106",0,0,0
"11763",1955,"107",0,0,0
"11764",1955,"108",0,0,0
"11765",1955,"109",0,0,0
"11766",1955,"110+",0,0,0
"11767",1956,"0",109771,114942,224713
"11768",1956,"1",108126,114626,222752
"11769",1956,"2",107720,113718,221438
"11770",1956,"3",108740,115016,223756
"11771",1956,"4",106470,112462,218932
"11772",1956,"5",107001,113217,220218
"11773",1956,"6",110289,116405,226694
"11774",1956,"7",114688,121562,236250
"11775",1956,"8",123399,129258,252657
"11776",1956,"9",129104,135851,264955
"11777",1956,"10",92280,96669,188949
"11778",1956,"11",97587,102211,199798
"11779",1956,"12",93521,98539,192060
"11780",1956,"13",85909,90698,176607
"11781",1956,"14",82279,86448,168727
"11782",1956,"15",84873,87967,172840
"11783",1956,"16",82899,85685,168584
"11784",1956,"17",81404,84747,166151
"11785",1956,"18",77720,80821,158541
"11786",1956,"19",77966,81046,159012
"11787",1956,"20",76934,79970,156904
"11788",1956,"21",77205,79845,157050
"11789",1956,"22",76124,78665,154789
"11790",1956,"23",79148,80966,160114
"11791",1956,"24",77800,79507,157307
"11792",1956,"25",79288,80991,160279
"11793",1956,"26",76908,77304,154212
"11794",1956,"27",77320,77112,154432
"11795",1956,"28",75576,75152,150728
"11796",1956,"29",75942,74783,150725
"11797",1956,"30",76557,74390,150947
"11798",1956,"31",78230,75359,153589
"11799",1956,"32",79809,77516,157325
"11800",1956,"33",77474,75150,152624
"11801",1956,"34",78644,76012,154656
"11802",1956,"35",79969,77670,157639
"11803",1956,"36",67062,65507,132569
"11804",1956,"37",65780,64066,129846
"11805",1956,"38",67655,65707,133362
"11806",1956,"39",68161,66229,134390
"11807",1956,"40",66645,64838,131483
"11808",1956,"41",70797,68448,139245
"11809",1956,"42",69719,66981,136700
"11810",1956,"43",69474,66422,135896
"11811",1956,"44",65185,61851,127036
"11812",1956,"45",65916,63013,128929
"11813",1956,"46",66996,63985,130981
"11814",1956,"47",66253,62664,128917
"11815",1956,"48",65233,61738,126971
"11816",1956,"49",63699,59731,123430
"11817",1956,"50",62793,59028,121821
"11818",1956,"51",61823,58538,120361
"11819",1956,"52",60066,56738,116804
"11820",1956,"53",59509,56316,115825
"11821",1956,"54",57597,53522,111119
"11822",1956,"55",54828,50687,105515
"11823",1956,"56",53568,49609,103177
"11824",1956,"57",52482,48653,101135
"11825",1956,"58",51584,47551,99135
"11826",1956,"59",50716,46975,97691
"11827",1956,"60",48024,44404,92428
"11828",1956,"61",46367,42710,89077
"11829",1956,"62",45810,42494,88304
"11830",1956,"63",41719,38575,80294
"11831",1956,"64",41516,38252,79768
"11832",1956,"65",38675,35416,74091
"11833",1956,"66",37068,34303,71371
"11834",1956,"67",36125,33560,69685
"11835",1956,"68",34390,31950,66340
"11836",1956,"69",33227,30252,63479
"11837",1956,"70",31015,28842,59857
"11838",1956,"71",29332,26941,56273
"11839",1956,"72",26940,24310,51250
"11840",1956,"73",25824,23418,49242
"11841",1956,"74",23404,21614,45018
"11842",1956,"75",22088,19705,41793
"11843",1956,"76",20556,18411,38967
"11844",1956,"77",18192,16404,34596
"11845",1956,"78",16767,15025,31792
"11846",1956,"79",14888,13558,28446
"11847",1956,"80",12938.15,11530.11,24468.26
"11848",1956,"81",11094.21,9837.5,20931.71
"11849",1956,"82",9758.58,8466.5,18225.08
"11850",1956,"83",7943.81,6907,14850.81
"11851",1956,"84",6541.61,5302,11843.61
"11852",1956,"85",5398,4394,9792
"11853",1956,"86",4370,3480,7850
"11854",1956,"87",3475,2723,6198
"11855",1956,"88",2656,2057,4713
"11856",1956,"89",2072,1551,3623
"11857",1956,"90",1501,1141,2642
"11858",1956,"91",1137,847,1984
"11859",1956,"92",803,579,1382
"11860",1956,"93",494,374,868
"11861",1956,"94",378,239,617
"11862",1956,"95",197,129,326
"11863",1956,"96",123,91,214
"11864",1956,"97",69,57,126
"11865",1956,"98",46,22,68
"11866",1956,"99",33,11,44
"11867",1956,"100",22,8,30
"11868",1956,"101",17,1,18
"11869",1956,"102",4,0,4
"11870",1956,"103",5,1,6
"11871",1956,"104",0,1,1
"11872",1956,"105",0,0,0
"11873",1956,"106",0,0,0
"11874",1956,"107",0,0,0
"11875",1956,"108",0,0,0
"11876",1956,"109",0,0,0
"11877",1956,"110+",0,0,0
"11878",1957,"0",110502,116652,227154
"11879",1957,"1",109235,114308,223543
"11880",1957,"2",107807,114277,222084
"11881",1957,"3",107453,113374,220827
"11882",1957,"4",108462,114646,223108
"11883",1957,"5",106263,112157,218420
"11884",1957,"6",106838,112946,219784
"11885",1957,"7",110096,116191,226287
"11886",1957,"8",114468,121321,235789
"11887",1957,"9",123208,128990,252198
"11888",1957,"10",128816,135581,264397
"11889",1957,"11",92070,96446,188516
"11890",1957,"12",97415,102073,199488
"11891",1957,"13",93383,98388,191771
"11892",1957,"14",85876,90649,176525
"11893",1957,"15",82221,86380,168601
"11894",1957,"16",84889,87964,172853
"11895",1957,"17",82924,85701,168625
"11896",1957,"18",81428,84650,166078
"11897",1957,"19",77671,80746,158417
"11898",1957,"20",77831,81044,158875
"11899",1957,"21",76676,79856,156532
"11900",1957,"22",76819,79524,156343
"11901",1957,"23",75640,78269,153909
"11902",1957,"24",78676,80584,159260
"11903",1957,"25",77356,79117,156473
"11904",1957,"26",78923,80541,159464
"11905",1957,"27",76504,76941,153445
"11906",1957,"28",77027,76830,153857
"11907",1957,"29",75317,74836,150153
"11908",1957,"30",75685,74517,150202
"11909",1957,"31",76328,74190,150518
"11910",1957,"32",78030,75117,153147
"11911",1957,"33",79566,77271,156837
"11912",1957,"34",77221,74979,152200
"11913",1957,"35",78476,75827,154303
"11914",1957,"36",79730,77486,157216
"11915",1957,"37",66895,65309,132204
"11916",1957,"38",65639,63857,129496
"11917",1957,"39",67453,65498,132951
"11918",1957,"40",68019,66039,134058
"11919",1957,"41",66461,64624,131085
"11920",1957,"42",70667,68255,138922
"11921",1957,"43",69537,66763,136300
"11922",1957,"44",69308,66130,135438
"11923",1957,"45",65012,61614,126626
"11924",1957,"46",65719,62746,128465
"11925",1957,"47",66830,63766,130596
"11926",1957,"48",66073,62424,128497
"11927",1957,"49",64995,61439,126434
"11928",1957,"50",63447,59457,122904
"11929",1957,"51",62567,58690,121257
"11930",1957,"52",61597,58191,119788
"11931",1957,"53",59860,56376,116236
"11932",1957,"54",59281,55881,115162
"11933",1957,"55",57294,53070,110364
"11934",1957,"56",54546,50202,104748
"11935",1957,"57",53246,49075,102321
"11936",1957,"58",52131,48052,100183
"11937",1957,"59",51209,46951,98160
"11938",1957,"60",50324,46305,96629
"11939",1957,"61",47544,43732,91276
"11940",1957,"62",45845,41909,87754
"11941",1957,"63",45281,41711,86992
"11942",1957,"64",41158,37771,78929
"11943",1957,"65",40847,37335,78182
"11944",1957,"66",38021,34544,72565
"11945",1957,"67",36301,33422,69723
"11946",1957,"68",35291,32639,67930
"11947",1957,"69",33599,30963,64562
"11948",1957,"70",32317,29211,61528
"11949",1957,"71",30005,27774,57779
"11950",1957,"72",28288,25700,53988
"11951",1957,"73",25796,23088,48884
"11952",1957,"74",24595,22138,46733
"11953",1957,"75",22143,20276,42419
"11954",1957,"76",20799,18357,39156
"11955",1957,"77",19123,17103,36226
"11956",1957,"78",16808,15066,31874
"11957",1957,"79",15327,13677,29004
"11958",1957,"80",13650.06,12213.89,25863.95
"11959",1957,"81",11621.15,10236.11,21857.26
"11960",1957,"82",9740.21,8598.5,18338.71
"11961",1957,"83",8477.58,7295.5,15773.08
"11962",1957,"84",6863.81,5806,12669.81
"11963",1957,"85",5527.61,4415,9942.61
"11964",1957,"86",4444,3632,8076
"11965",1957,"87",3553,2784,6337
"11966",1957,"88",2760,2115,4875
"11967",1957,"89",2097,1581,3678
"11968",1957,"90",1587,1149,2736
"11969",1957,"91",1115,853,1968
"11970",1957,"92",825,604,1429
"11971",1957,"93",590,390,980
"11972",1957,"94",345,264,609
"11973",1957,"95",265,160,425
"11974",1957,"96",130,81,211
"11975",1957,"97",71,65,136
"11976",1957,"98",39,38,77
"11977",1957,"99",28,15,43
"11978",1957,"100",19,3,22
"11979",1957,"101",10,5,15
"11980",1957,"102",12,1,13
"11981",1957,"103",3,0,3
"11982",1957,"104",3,0,3
"11983",1957,"105",0,1,1
"11984",1957,"106",0,0,0
"11985",1957,"107",0,0,0
"11986",1957,"108",0,0,0
"11987",1957,"109",0,0,0
"11988",1957,"110+",0,0,0
"11989",1958,"0",111955,117991,229946
"11990",1958,"1",110001,116010,226011
"11991",1958,"2",108883,113948,222831
"11992",1958,"3",107491,113927,221418
"11993",1958,"4",107199,113030,220229
"11994",1958,"5",108195,114321,222516
"11995",1958,"6",106052,111881,217933
"11996",1958,"7",106654,112725,219379
"11997",1958,"8",109887,115923,225810
"11998",1958,"9",114314,121077,235391
"11999",1958,"10",123024,128786,251810
"12000",1958,"11",128606,135377,263983
"12001",1958,"12",91918,96310,188228
"12002",1958,"13",97324,101928,199252
"12003",1958,"14",93261,98210,191471
"12004",1958,"15",85846,90537,176383
"12005",1958,"16",82204,86270,168474
"12006",1958,"17",84878,87918,172796
"12007",1958,"18",82906,85523,168429
"12008",1958,"19",81352,84463,165815
"12009",1958,"20",77485,80731,158216
"12010",1958,"21",77462,80985,158447
"12011",1958,"22",76233,79444,155677
"12012",1958,"23",76333,78987,155320
"12013",1958,"24",75196,77871,153067
"12014",1958,"25",78274,80195,158469
"12015",1958,"26",77005,78637,155642
"12016",1958,"27",78652,80122,158774
"12017",1958,"28",76208,76598,152806
"12018",1958,"29",76730,76523,153253
"12019",1958,"30",75033,74500,149533
"12020",1958,"31",75421,74175,149596
"12021",1958,"32",76140,73973,150113
"12022",1958,"33",77811,74879,152690
"12023",1958,"34",79339,77010,156349
"12024",1958,"35",77042,74714,151756
"12025",1958,"36",78215,75585,153800
"12026",1958,"37",79564,77242,156806
"12027",1958,"38",66781,65081,131862
"12028",1958,"39",65472,63599,129071
"12029",1958,"40",67398,65272,132670
"12030",1958,"41",67832,65812,133644
"12031",1958,"42",66341,64417,130758
"12032",1958,"43",70539,68020,138559
"12033",1958,"44",69406,66516,135922
"12034",1958,"45",69187,65889,135076
"12035",1958,"46",64859,61357,126216
"12036",1958,"47",65562,62522,128084
"12037",1958,"48",66661,63509,130170
"12038",1958,"49",65914,62151,128065
"12039",1958,"50",64793,61200,125993
"12040",1958,"51",63247,59162,122409
"12041",1958,"52",62322,58302,120624
"12042",1958,"53",61368,57791,119159
"12043",1958,"54",59576,55920,115496
"12044",1958,"55",59032,55421,114453
"12045",1958,"56",56955,52587,109542
"12046",1958,"57",54226,49711,103937
"12047",1958,"58",52930,48503,101433
"12048",1958,"59",51762,47499,99261
"12049",1958,"60",50753,46284,97037
"12050",1958,"61",49828,45610,95438
"12051",1958,"62",47050,43017,90067
"12052",1958,"63",45275,41123,86398
"12053",1958,"64",44698,40893,85591
"12054",1958,"65",40557,36984,77541
"12055",1958,"66",40180,36448,76628
"12056",1958,"67",37337,33590,70927
"12057",1958,"68",35527,32486,68013
"12058",1958,"69",34415,31618,66033
"12059",1958,"70",32725,29901,62626
"12060",1958,"71",31363,28110,59473
"12061",1958,"72",28956,26554,55510
"12062",1958,"73",27175,24475,51650
"12063",1958,"74",24624,21931,46555
"12064",1958,"75",23287,20783,44070
"12065",1958,"76",20914,19003,39917
"12066",1958,"77",19559,17082,36641
"12067",1958,"78",17753,15781,33534
"12068",1958,"79",15480,13745,29225
"12069",1958,"80",14082.67,12468,26550.67
"12070",1958,"81",12367.06,10948.89,23315.95
"12071",1958,"82",10405.15,9057.11,19462.26
"12072",1958,"83",8563.21,7464.5,16027.71
"12073",1958,"84",7356.58,6272.5,13629.08
"12074",1958,"85",5863.81,4980,10843.81
"12075",1958,"86",4659.61,3663,8322.61
"12076",1958,"87",3690,2921,6611
"12077",1958,"88",2918,2227,5145
"12078",1958,"89",2176,1654,3830
"12079",1958,"90",1659,1169,2828
"12080",1958,"91",1214,873,2087
"12081",1958,"92",816,611,1427
"12082",1958,"93",605,421,1026
"12083",1958,"94",426,278,704
"12084",1958,"95",232,167,399
"12085",1958,"96",184,102,286
"12086",1958,"97",94,50,144
"12087",1958,"98",46,34,80
"12088",1958,"99",21,30,51
"12089",1958,"100",16,8,24
"12090",1958,"101",11,0,11
"12091",1958,"102",4,3,7
"12092",1958,"103",8,1,9
"12093",1958,"104",2,0,2
"12094",1958,"105",1,0,1
"12095",1958,"106",0,1,1
"12096",1958,"107",0,0,0
"12097",1958,"108",0,0,0
"12098",1958,"109",0,0,0
"12099",1958,"110+",0,0,0
"12100",1959,"0",113824,119754,233578
"12101",1959,"1",112345,118221,230566
"12102",1959,"2",110591,116580,227171
"12103",1959,"3",109548,114521,224069
"12104",1959,"4",108144,114623,222767
"12105",1959,"5",107856,113802,221658
"12106",1959,"6",108843,114989,223832
"12107",1959,"7",106650,112507,219157
"12108",1959,"8",107408,113382,220790
"12109",1959,"9",110522,116591,227113
"12110",1959,"10",114893,121684,236577
"12111",1959,"11",123623,129326,252949
"12112",1959,"12",128859,135585,264444
"12113",1959,"13",92009,96356,188365
"12114",1959,"14",97375,101982,199357
"12115",1959,"15",93328,98226,191554
"12116",1959,"16",86010,90664,176674
"12117",1959,"17",82394,86384,168778
"12118",1959,"18",84978,87888,172866
"12119",1959,"19",82961,85229,168190
"12120",1959,"20",81292,84342,165634
"12121",1959,"21",77317,80451,157768
"12122",1959,"22",77173,80422,157595
"12123",1959,"23",75923,78919,154842
"12124",1959,"24",76067,78463,154530
"12125",1959,"25",75041,77376,152417
"12126",1959,"26",78120,79794,157914
"12127",1959,"27",76946,78266,155212
"12128",1959,"28",78643,79858,158501
"12129",1959,"29",76252,76413,152665
"12130",1959,"30",76903,76374,153277
"12131",1959,"31",75287,74549,149836
"12132",1959,"32",75687,74312,149999
"12133",1959,"33",76363,74092,150455
"12134",1959,"34",78003,74990,152993
"12135",1959,"35",79563,77161,156724
"12136",1959,"36",77239,74907,152146
"12137",1959,"37",78432,75682,154114
"12138",1959,"38",79762,77447,157209
"12139",1959,"39",66992,65247,132239
"12140",1959,"40",65666,63738,129404
"12141",1959,"41",67565,65389,132954
"12142",1959,"42",67980,65856,133836
"12143",1959,"43",66450,64434,130884
"12144",1959,"44",70630,67981,138611
"12145",1959,"45",69501,66517,136018
"12146",1959,"46",69251,65910,135161
"12147",1959,"47",64904,61345,126249
"12148",1959,"48",65580,62486,128066
"12149",1959,"49",66652,63433,130085
"12150",1959,"50",65897,62118,128015
"12151",1959,"51",64710,61103,125813
"12152",1959,"52",63181,59010,122191
"12153",1959,"53",62274,58072,120346
"12154",1959,"54",61196,57552,118748
"12155",1959,"55",59438,55590,115028
"12156",1959,"56",58819,55019,113838
"12157",1959,"57",56675,52165,108840
"12158",1959,"58",53981,49191,103172
"12159",1959,"59",52648,47970,100618
"12160",1959,"60",51414,46877,98291
"12161",1959,"61",50354,45617,95971
"12162",1959,"62",49378,44877,94255
"12163",1959,"63",46625,42274,88899
"12164",1959,"64",44818,40324,85142
"12165",1959,"65",44115,40072,84187
"12166",1959,"66",39967,36156,76123
"12167",1959,"67",39472,35514,74986
"12168",1959,"68",36622,32721,69343
"12169",1959,"69",34759,31537,66296
"12170",1959,"70",33582,30567,64149
"12171",1959,"71",31785,28765,60550
"12172",1959,"72",30293,26961,57254
"12173",1959,"73",27898,25294,53192
"12174",1959,"74",26049,23223,49272
"12175",1959,"75",23483,20667,44150
"12176",1959,"76",22088,19443,41531
"12177",1959,"77",19623,17699,37322
"12178",1959,"78",18274,15818,34092
"12179",1959,"79",16372,14409,30781
"12180",1959,"80",14224.03,12459.39,26683.42
"12181",1959,"81",12742.67,11106,23848.67
"12182",1959,"82",11054.06,9640.89,20694.95
"12183",1959,"83",9171.15,7898.11,17069.26
"12184",1959,"84",7486.21,6384.5,13870.71
"12185",1959,"85",6292.58,5267.5,11560.08
"12186",1959,"86",4955.81,4125,9080.81
"12187",1959,"87",3831.61,2981,6812.61
"12188",1959,"88",3005,2329,5334
"12189",1959,"89",2309,1747,4056
"12190",1959,"90",1728,1264,2992
"12191",1959,"91",1252,876,2128
"12192",1959,"92",914,661,1575
"12193",1959,"93",607,432,1039
"12194",1959,"94",426,268,694
"12195",1959,"95",309,171,480
"12196",1959,"96",161,105,266
"12197",1959,"97",134,63,197
"12198",1959,"98",61,26,87
"12199",1959,"99",28,18,46
"12200",1959,"100",13,17,30
"12201",1959,"101",7,5,12
"12202",1959,"102",5,0,5
"12203",1959,"103",4,1,5
"12204",1959,"104",5,1,6
"12205",1959,"105",2,0,2
"12206",1959,"106",1,0,1
"12207",1959,"107",0,0,0
"12208",1959,"108",0,0,0
"12209",1959,"109",0,0,0
"12210",1959,"110+",0,0,0
"12211",1960,"0",116547,121895,238442
"12212",1960,"1",113270,119088,232358
"12213",1960,"2",111979,117769,229748
"12214",1960,"3",110268,116160,226428
"12215",1960,"4",109243,114212,223455
"12216",1960,"5",107879,114305,222184
"12217",1960,"6",107588,113444,221032
"12218",1960,"7",108645,114676,223321
"12219",1960,"8",106455,112272,218727
"12220",1960,"9",107232,113126,220358
"12221",1960,"10",110315,116400,226715
"12222",1960,"11",114794,121551,236345
"12223",1960,"12",123459,129131,252590
"12224",1960,"13",128680,135367,264047
"12225",1960,"14",91894,96201,188095
"12226",1960,"15",97263,101783,199046
"12227",1960,"16",93245,98019,191264
"12228",1960,"17",85899,90465,176364
"12229",1960,"18",82261,86020,168281
"12230",1960,"19",84812,87430,172242
"12231",1960,"20",82723,84958,167681
"12232",1960,"21",80934,83930,164864
"12233",1960,"22",76875,79796,156671
"12234",1960,"23",76743,79773,156516
"12235",1960,"24",75540,78370,153910
"12236",1960,"25",75738,77935,153673
"12237",1960,"26",74759,76851,151610
"12238",1960,"27",77829,79281,157110
"12239",1960,"28",76656,77887,154543
"12240",1960,"29",78389,79445,157834
"12241",1960,"30",76045,76081,152126
"12242",1960,"31",76635,76013,152648
"12243",1960,"32",75086,74219,149305
"12244",1960,"33",75456,74026,149482
"12245",1960,"34",76089,73811,149900
"12246",1960,"35",77819,74779,152598
"12247",1960,"36",79387,76851,156238
"12248",1960,"37",77033,74649,151682
"12249",1960,"38",78214,75441,153655
"12250",1960,"39",79558,77175,156733
"12251",1960,"40",66802,65045,131847
"12252",1960,"41",65489,63506,128995
"12253",1960,"42",67410,65117,132527
"12254",1960,"43",67787,65605,133392
"12255",1960,"44",66283,64210,130493
"12256",1960,"45",70461,67687,138148
"12257",1960,"46",69268,66226,135494
"12258",1960,"47",69063,65616,134679
"12259",1960,"48",64730,61066,125796
"12260",1960,"49",65364,62155,127519
"12261",1960,"50",66465,63184,129649
"12262",1960,"51",65638,61754,127392
"12263",1960,"52",64459,60764,125223
"12264",1960,"53",62913,58587,121500
"12265",1960,"54",61977,57613,119590
"12266",1960,"55",60891,57048,117939
"12267",1960,"56",59115,55013,114128
"12268",1960,"57",58489,54401,112890
"12269",1960,"58",56298,51542,107840
"12270",1960,"59",53597,48541,102138
"12271",1960,"60",52213,47247,99460
"12272",1960,"61",50945,46126,97071
"12273",1960,"62",49841,44799,94640
"12274",1960,"63",48843,44023,92866
"12275",1960,"64",46013,41382,87395
"12276",1960,"65",44178,39417,83595
"12277",1960,"66",43426,39125,82551
"12278",1960,"67",39260,35174,74434
"12279",1960,"68",38679,34465,73144
"12280",1960,"69",35837,31652,67489
"12281",1960,"70",33830,30439,64269
"12282",1960,"71",32678,29447,62125
"12283",1960,"72",30715,27546,58261
"12284",1960,"73",29161,25626,54787
"12285",1960,"74",26788,23928,50716
"12286",1960,"75",24740,21873,46613
"12287",1960,"76",22210,19376,41586
"12288",1960,"77",20775,18007,38782
"12289",1960,"78",18325,16350,34675
"12290",1960,"79",16952,14444,31396
"12291",1960,"80",15109.07,13167.61,28276.68
"12292",1960,"81",12853.03,11212.39,24065.42
"12293",1960,"82",11380.67,9869,21249.67
"12294",1960,"83",9789.06,8448.89,18237.95
"12295",1960,"84",8036.15,6789.11,14825.26
"12296",1960,"85",6437.21,5405.5,11842.71
"12297",1960,"86",5264.58,4366.5,9631.08
"12298",1960,"87",4095.81,3382,7477.81
"12299",1960,"88",3109.61,2407,5516.61
"12300",1960,"89",2419,1806,4225
"12301",1960,"90",1826,1328,3154
"12302",1960,"91",1316,939,2255
"12303",1960,"92",961,651,1612
"12304",1960,"93",669,455,1124
"12305",1960,"94",432,298,730
"12306",1960,"95",295,177,472
"12307",1960,"96",201,113,314
"12308",1960,"97",102,63,165
"12309",1960,"98",88,35,123
"12310",1960,"99",33,15,48
"12311",1960,"100",20,9,29
"12312",1960,"101",7,5,12
"12313",1960,"102",3,4,7
"12314",1960,"103",3,0,3
"12315",1960,"104",3,1,4
"12316",1960,"105",3,1,4
"12317",1960,"106",1,0,1
"12318",1960,"107",1,0,1
"12319",1960,"108",0,0,0
"12320",1960,"109",0,0,0
"12321",1960,"110+",0,0,0
"12322",1961,"0",114630,120351,234981
"12323",1961,"1",116079,121335,237414
"12324",1961,"2",112990,118693,231683
"12325",1961,"3",111571,117310,228881
"12326",1961,"4",110034,115926,225960
"12327",1961,"5",108803,113730,222533
"12328",1961,"6",107795,114048,221843
"12329",1961,"7",107540,113120,220660
"12330",1961,"8",108621,114345,222966
"12331",1961,"9",106149,111760,217909
"12332",1961,"10",107271,112892,220163
"12333",1961,"11",110248,116230,226478
"12334",1961,"12",114966,121268,236234
"12335",1961,"13",123627,128981,252608
"12336",1961,"14",128573,134790,263363
"12337",1961,"15",92168,96150,188318
"12338",1961,"16",97895,102154,200049
"12339",1961,"17",93306,97809,191115
"12340",1961,"18",85817,89904,175721
"12341",1961,"19",82194,85671,167865
"12342",1961,"20",84336,87147,171483
"12343",1961,"21",82312,84872,167184
"12344",1961,"22",80489,83397,163886
"12345",1961,"23",76186,78949,155135
"12346",1961,"24",76188,79102,155290
"12347",1961,"25",75016,77717,152733
"12348",1961,"26",75339,77427,152766
"12349",1961,"27",74327,76202,150529
"12350",1961,"28",77359,78853,156212
"12351",1961,"29",76321,77551,153872
"12352",1961,"30",78507,79473,157980
"12353",1961,"31",75991,75981,151972
"12354",1961,"32",76532,75833,152365
"12355",1961,"33",74647,73741,148388
"12356",1961,"34",75217,73743,148960
"12357",1961,"35",75830,73657,149487
"12358",1961,"36",77557,74473,152030
"12359",1961,"37",79163,76535,155698
"12360",1961,"38",76636,74546,151182
"12361",1961,"39",78070,75049,153119
"12362",1961,"40",79565,76949,156514
"12363",1961,"41",66911,65108,132019
"12364",1961,"42",65489,63302,128791
"12365",1961,"43",67074,64693,131767
"12366",1961,"44",67743,65526,133269
"12367",1961,"45",66176,64234,130410
"12368",1961,"46",70143,67413,137556
"12369",1961,"47",69178,66002,135180
"12370",1961,"48",68786,65395,134181
"12371",1961,"49",64543,60921,125464
"12372",1961,"50",65393,62070,127463
"12373",1961,"51",66290,62825,129115
"12374",1961,"52",65365,61426,126791
"12375",1961,"53",63887,60234,124121
"12376",1961,"54",62649,58204,120853
"12377",1961,"55",61773,57301,119074
"12378",1961,"56",60607,56627,117234
"12379",1961,"57",58724,54434,113158
"12380",1961,"58",57993,53714,111707
"12381",1961,"59",55840,50918,106758
"12382",1961,"60",53222,47728,100950
"12383",1961,"61",51460,46564,98024
"12384",1961,"62",50393,45351,95744
"12385",1961,"63",49204,43906,93110
"12386",1961,"64",48080,43076,91156
"12387",1961,"65",45513,40574,86087
"12388",1961,"66",43679,38500,82179
"12389",1961,"67",42651,37788,80439
"12390",1961,"68",38360,34129,72489
"12391",1961,"69",37798,33649,71447
"12392",1961,"70",35067,30673,65740
"12393",1961,"71",32900,29411,62311
"12394",1961,"72",31749,28236,59985
"12395",1961,"73",29385,26265,55650
"12396",1961,"74",27812,24406,52218
"12397",1961,"75",25508,22641,48149
"12398",1961,"76",23414,20571,43985
"12399",1961,"77",20945,18027,38972
"12400",1961,"78",19358,16725,36083
"12401",1961,"79",16969,14934,31903
"12402",1961,"80",15321.89,13017,28338.89
"12403",1961,"81",13633.07,11775.61,25408.68
"12404",1961,"82",11514.03,9920.39,21434.42
"12405",1961,"83",10059.67,8580,18639.67
"12406",1961,"84",8559.06,7218.89,15777.95
"12407",1961,"85",6943.15,5696.11,12639.26
"12408",1961,"86",5459.21,4497.5,9956.71
"12409",1961,"87",4351.58,3564.5,7916.08
"12410",1961,"88",3348.81,2687,6035.81
"12411",1961,"89",2482.61,1903,4385.61
"12412",1961,"90",1916,1408,3324
"12413",1961,"91",1396,988,2384
"12414",1961,"92",980,681,1661
"12415",1961,"93",703,439,1142
"12416",1961,"94",488,317,805
"12417",1961,"95",291,187,478
"12418",1961,"96",201,116,317
"12419",1961,"97",140,62,202
"12420",1961,"98",63,45,108
"12421",1961,"99",57,23,80
"12422",1961,"100",22,11,33
"12423",1961,"101",13,2,15
"12424",1961,"102",4,3,7
"12425",1961,"103",1,1,2
"12426",1961,"104",2,0,2
"12427",1961,"105",1,0,1
"12428",1961,"106",1,0,1
"12429",1961,"107",1,0,1
"12430",1961,"108",0,0,0
"12431",1961,"109",0,0,0
"12432",1961,"110+",0,0,0
"12433",1962,"0",119068,124493,243561
"12434",1962,"1",114400,120024,234424
"12435",1962,"2",116021,121220,237241
"12436",1962,"3",112937,118620,231557
"12437",1962,"4",111539,117218,228757
"12438",1962,"5",109975,115938,225913
"12439",1962,"6",108781,113684,222465
"12440",1962,"7",107758,113979,221737
"12441",1962,"8",107569,113086,220655
"12442",1962,"9",108638,114362,223000
"12443",1962,"10",106161,111778,217939
"12444",1962,"11",107276,112956,220232
"12445",1962,"12",110332,116261,226593
"12446",1962,"13",115048,121337,236385
"12447",1962,"14",123670,128965,252635
"12448",1962,"15",128617,134788,263405
"12449",1962,"16",92193,96119,188312
"12450",1962,"17",97915,102042,199957
"12451",1962,"18",93224,97623,190847
"12452",1962,"19",85750,89777,175527
"12453",1962,"20",82080,85669,167749
"12454",1962,"21",84119,87074,171193
"12455",1962,"22",82087,84742,166829
"12456",1962,"23",80261,83547,163808
"12457",1962,"24",76001,79297,155298
"12458",1962,"25",76010,79432,155442
"12459",1962,"26",74872,78047,152919
"12460",1962,"27",75163,77691,152854
"12461",1962,"28",74208,76409,150617
"12462",1962,"29",77300,78989,156289
"12463",1962,"30",76221,77694,153915
"12464",1962,"31",78456,79551,158007
"12465",1962,"32",75925,76088,152013
"12466",1962,"33",76489,75897,152386
"12467",1962,"34",74621,73820,148441
"12468",1962,"35",75174,73748,148922
"12469",1962,"36",75781,73691,149472
"12470",1962,"37",77548,74475,152023
"12471",1962,"38",79099,76479,155578
"12472",1962,"39",76614,74459,151073
"12473",1962,"40",77983,74975,152958
"12474",1962,"41",79508,76832,156340
"12475",1962,"42",66870,64968,131838
"12476",1962,"43",65410,63145,128555
"12477",1962,"44",66981,64527,131508
"12478",1962,"45",67676,65385,133061
"12479",1962,"46",66108,64049,130157
"12480",1962,"47",69991,67196,137187
"12481",1962,"48",69017,65795,134812
"12482",1962,"49",68563,65144,133707
"12483",1962,"50",64410,60678,125088
"12484",1962,"51",65200,61760,126960
"12485",1962,"52",66055,62413,128468
"12486",1962,"53",65118,61008,126126
"12487",1962,"54",63583,59787,123370
"12488",1962,"55",62373,57726,120099
"12489",1962,"56",61465,56741,118206
"12490",1962,"57",60259,56044,116303
"12491",1962,"58",58332,53761,112093
"12492",1962,"59",57625,52959,110584
"12493",1962,"60",55432,50210,105642
"12494",1962,"61",52761,46959,99720
"12495",1962,"62",50976,45732,96708
"12496",1962,"63",49898,44441,94339
"12497",1962,"64",48599,42965,91564
"12498",1962,"65",47440,42110,89550
"12499",1962,"66",44744,39570,84314
"12500",1962,"67",42889,37409,80298
"12501",1962,"68",41873,36629,78502
"12502",1962,"69",37528,32999,70527
"12503",1962,"70",36813,32433,69246
"12504",1962,"71",34121,29514,63635
"12505",1962,"72",31859,28174,60033
"12506",1962,"73",30685,26976,57661
"12507",1962,"74",28210,24868,53078
"12508",1962,"75",26539,22974,49513
"12509",1962,"76",24210,21269,45479
"12510",1962,"77",22054,19140,41194
"12511",1962,"78",19538,16695,36233
"12512",1962,"79",17905,15356,33261
"12513",1962,"80",15707.09,13624.38,29331.47
"12514",1962,"81",13853.89,11698,25551.89
"12515",1962,"82",12245.07,10447.61,22692.68
"12516",1962,"83",10239.03,8683.39,18922.42
"12517",1962,"84",8826.67,7450,16276.67
"12518",1962,"85",7372.06,6151.89,13523.95
"12519",1962,"86",5905.15,4767.11,10672.26
"12520",1962,"87",4636.21,3691.5,8327.71
"12521",1962,"88",3597.58,2914.5,6512.08
"12522",1962,"89",2703.81,2114,4817.81
"12523",1962,"90",1976.61,1473,3449.61
"12524",1962,"91",1484,1064,2548
"12525",1962,"92",1057,760,1817
"12526",1962,"93",745,479,1224
"12527",1962,"94",509,303,812
"12528",1962,"95",332,207,539
"12529",1962,"96",211,126,337
"12530",1962,"97",129,80,209
"12531",1962,"98",94,41,135
"12532",1962,"99",37,32,69
"12533",1962,"100",36,11,47
"12534",1962,"101",14,6,20
"12535",1962,"102",8,1,9
"12536",1962,"103",3,2,5
"12537",1962,"104",0,0,0
"12538",1962,"105",1,0,1
"12539",1962,"106",1,0,1
"12540",1962,"107",0,0,0
"12541",1962,"108",0,0,0
"12542",1962,"109",0,0,0
"12543",1962,"110+",0,0,0
"12544",1963,"0",118526,123972,242498
"12545",1963,"1",118980,124313,243293
"12546",1963,"2",114468,120203,234671
"12547",1963,"3",116151,121269,237420
"12548",1963,"4",113110,118742,231852
"12549",1963,"5",111717,117406,229123
"12550",1963,"6",110088,116124,226212
"12551",1963,"7",108992,113880,222872
"12552",1963,"8",107903,114151,222054
"12553",1963,"9",107762,113263,221025
"12554",1963,"10",108815,114567,223382
"12555",1963,"11",106347,111968,218315
"12556",1963,"12",107421,113047,220468
"12557",1963,"13",110468,116400,226868
"12558",1963,"14",115151,121395,236546
"12559",1963,"15",123788,129074,252862
"12560",1963,"16",128635,134844,263479
"12561",1963,"17",92270,96138,188408
"12562",1963,"18",97905,102009,199914
"12563",1963,"19",93212,97688,190900
"12564",1963,"20",85655,89971,175626
"12565",1963,"21",81888,85724,167612
"12566",1963,"22",83916,87064,170980
"12567",1963,"23",81807,84787,166594
"12568",1963,"24",80086,83866,163952
"12569",1963,"25",75842,79536,155378
"12570",1963,"26",76004,79691,155695
"12571",1963,"27",74922,78225,153147
"12572",1963,"28",75137,77867,153004
"12573",1963,"29",74245,76579,150824
"12574",1963,"30",77352,79278,156630
"12575",1963,"31",76218,77816,154034
"12576",1963,"32",78508,79841,158349
"12577",1963,"33",75904,76309,152213
"12578",1963,"34",76526,76123,152649
"12579",1963,"35",74647,73967,148614
"12580",1963,"36",75223,73875,149098
"12581",1963,"37",75823,73861,149684
"12582",1963,"38",77550,74532,152082
"12583",1963,"39",79107,76523,155630
"12584",1963,"40",76632,74473,151105
"12585",1963,"41",78001,74970,152971
"12586",1963,"42",79463,76814,156277
"12587",1963,"43",66810,64963,131773
"12588",1963,"44",65397,63098,128495
"12589",1963,"45",66911,64454,131365
"12590",1963,"46",67579,65213,132792
"12591",1963,"47",66008,63890,129898
"12592",1963,"48",69901,67023,136924
"12593",1963,"49",68863,65554,134417
"12594",1963,"50",68399,64896,133295
"12595",1963,"51",64235,60379,124614
"12596",1963,"52",64990,61389,126379
"12597",1963,"53",65860,62023,127883
"12598",1963,"54",64871,60527,125398
"12599",1963,"55",63314,59260,122574
"12600",1963,"56",62091,57143,119234
"12601",1963,"57",61107,56033,117140
"12602",1963,"58",59913,55349,115262
"12603",1963,"59",57932,52995,110927
"12604",1963,"60",57163,52119,109282
"12605",1963,"61",54994,49307,104301
"12606",1963,"62",52269,46081,98350
"12607",1963,"63",50443,44740,95183
"12608",1963,"64",49274,43460,92734
"12609",1963,"65",47953,41901,89854
"12610",1963,"66",46697,40923,87620
"12611",1963,"67",43941,38492,82433
"12612",1963,"68",42056,36167,78223
"12613",1963,"69",40963,35354,76317
"12614",1963,"70",36576,31797,68373
"12615",1963,"71",35794,31178,66972
"12616",1963,"72",33050,28291,61341
"12617",1963,"73",30673,26818,57491
"12618",1963,"74",29438,25590,55028
"12619",1963,"75",26888,23390,50278
"12620",1963,"76",25186,21453,46639
"12621",1963,"77",22813,19791,42604
"12622",1963,"78",20631,17548,38179
"12623",1963,"79",18084,15194,33278
"12624",1963,"80",16490.23,13844.62,30334.85
"12625",1963,"81",14205.09,12091.38,26296.47
"12626",1963,"82",12446.89,10335,22781.89
"12627",1963,"83",10755.07,8997.61,19752.68
"12628",1963,"84",8906.03,7393.39,16299.42
"12629",1963,"85",7599.67,6298,13897.67
"12630",1963,"86",6221.06,5094.89,11315.95
"12631",1963,"87",4951.15,3925.11,8876.26
"12632",1963,"88",3791.21,2941.5,6732.71
"12633",1963,"89",2874.58,2245.5,5120.08
"12634",1963,"90",2080.81,1618,3698.81
"12635",1963,"91",1515.61,1072,2587.61
"12636",1963,"92",1105,788,1893
"12637",1963,"93",768,543,1311
"12638",1963,"94",504,341,845
"12639",1963,"95",369,177,546
"12640",1963,"96",209,125,334
"12641",1963,"97",125,73,198
"12642",1963,"98",85,47,132
"12643",1963,"99",56,27,83
"12644",1963,"100",24,23,47
"12645",1963,"101",15,6,21
"12646",1963,"102",9,2,11
"12647",1963,"103",3,1,4
"12648",1963,"104",2,0,2
"12649",1963,"105",0,0,0
"12650",1963,"106",0,0,0
"12651",1963,"107",1,0,1
"12652",1963,"108",0,0,0
"12653",1963,"109",0,0,0
"12654",1963,"110+",0,0,0
"12655",1964,"0",119857,126245,246102
"12656",1964,"1",118176,123517,241693
"12657",1964,"2",118808,124056,242864
"12658",1964,"3",114346,120059,234405
"12659",1964,"4",116055,121110,237165
"12660",1964,"5",112973,118612,231585
"12661",1964,"6",111631,117275,228906
"12662",1964,"7",110062,116047,226109
"12663",1964,"8",108941,113799,222740
"12664",1964,"9",107886,114075,221961
"12665",1964,"10",107747,113203,220950
"12666",1964,"11",108769,114554,223323
"12667",1964,"12",106363,111963,218326
"12668",1964,"13",107384,113010,220394
"12669",1964,"14",110383,116299,226682
"12670",1964,"15",115118,121351,236469
"12671",1964,"16",123760,128959,252719
"12672",1964,"17",128596,134765,263361
"12673",1964,"18",92201,96044,188245
"12674",1964,"19",97769,102004,199773
"12675",1964,"20",92975,97719,190694
"12676",1964,"21",85302,89872,175174
"12677",1964,"22",81559,85575,167134
"12678",1964,"23",83515,87319,170834
"12679",1964,"24",81373,85202,166575
"12680",1964,"25",79802,84131,163933
"12681",1964,"26",75688,79721,155409
"12682",1964,"27",75855,79821,155676
"12683",1964,"28",74745,78294,153039
"12684",1964,"29",74995,77992,152987
"12685",1964,"30",74116,76721,150837
"12686",1964,"31",77278,79344,156622
"12687",1964,"32",76103,77817,153920
"12688",1964,"33",78405,79968,158373
"12689",1964,"34",75822,76304,152126
"12690",1964,"35",76464,76196,152660
"12691",1964,"36",74538,73948,148486
"12692",1964,"37",75143,73837,148980
"12693",1964,"38",75682,73765,149447
"12694",1964,"39",77440,74412,151852
"12695",1964,"40",79021,76404,155425
"12696",1964,"41",76509,74303,150812
"12697",1964,"42",77829,74844,152673
"12698",1964,"43",79326,76615,155941
"12699",1964,"44",66626,64771,131397
"12700",1964,"45",65256,62934,128190
"12701",1964,"46",66741,64248,130989
"12702",1964,"47",67420,64990,132410
"12703",1964,"48",65827,63540,129367
"12704",1964,"49",69674,66685,136359
"12705",1964,"50",68583,65206,133789
"12706",1964,"51",68081,64469,132550
"12707",1964,"52",63965,60023,123988
"12708",1964,"53",64685,60901,125586
"12709",1964,"54",65537,61449,126986
"12710",1964,"55",64538,59888,124426
"12711",1964,"56",62963,58594,121557
"12712",1964,"57",61668,56464,118132
"12713",1964,"58",60703,55284,115987
"12714",1964,"59",59422,54465,113887
"12715",1964,"60",57449,52111,109560
"12716",1964,"61",56608,51170,107778
"12717",1964,"62",54426,48347,102773
"12718",1964,"63",51663,45059,96722
"12719",1964,"64",49782,43669,93451
"12720",1964,"65",48573,42301,90874
"12721",1964,"66",47148,40667,87815
"12722",1964,"67",45810,39663,85473
"12723",1964,"68",43025,37171,80196
"12724",1964,"69",41054,34870,75924
"12725",1964,"70",39863,33963,73826
"12726",1964,"71",35492,30439,65931
"12727",1964,"72",34647,29692,64339
"12728",1964,"73",31851,26877,58728
"12729",1964,"74",29399,25352,54751
"12730",1964,"75",28052,23991,52043
"12731",1964,"76",25410,21815,47225
"12732",1964,"77",23689,19927,43616
"12733",1964,"78",21388,18140,39528
"12734",1964,"79",19081,15963,35044
"12735",1964,"80",16775,13804.37,30579.37
"12736",1964,"81",14979.23,12313.62,27292.85
"12737",1964,"82",12735.09,10623.38,23358.47
"12738",1964,"83",10990.89,8967,19957.89
"12739",1964,"84",9395.07,7737.61,17132.68
"12740",1964,"85",7687.03,6216.39,13903.42
"12741",1964,"86",6453.67,5245,11698.67
"12742",1964,"87",5161.06,4134.89,9295.95
"12743",1964,"88",4026.15,3091.11,7117.26
"12744",1964,"89",3041.21,2266.5,5307.71
"12745",1964,"90",2264.58,1741.5,4006.08
"12746",1964,"91",1609.81,1229,2838.81
"12747",1964,"92",1182.61,734,1916.61
"12748",1964,"93",798,547,1345
"12749",1964,"94",545,360,905
"12750",1964,"95",346,217,563
"12751",1964,"96",242,116,358
"12752",1964,"97",123,67,190
"12753",1964,"98",74,42,116
"12754",1964,"99",51,30,81
"12755",1964,"100",38,12,50
"12756",1964,"101",9,10,19
"12757",1964,"102",10,2,12
"12758",1964,"103",5,2,7
"12759",1964,"104",2,1,3
"12760",1964,"105",1,0,1
"12761",1964,"106",0,0,0
"12762",1964,"107",0,0,0
"12763",1964,"108",0,0,0
"12764",1964,"109",0,0,0
"12765",1964,"110+",0,0,0
"12766",1965,"0",120432,126978,247410
"12767",1965,"1",119625,125997,245622
"12768",1965,"2",118081,123442,241523
"12769",1965,"3",118820,123943,242763
"12770",1965,"4",114302,120010,234312
"12771",1965,"5",116019,121016,237035
"12772",1965,"6",113017,118597,231614
"12773",1965,"7",111644,117266,228910
"12774",1965,"8",110126,116076,226202
"12775",1965,"9",109025,113795,222820
"12776",1965,"10",107961,114148,222109
"12777",1965,"11",107798,113325,221123
"12778",1965,"12",108835,114610,223445
"12779",1965,"13",106407,112025,218432
"12780",1965,"14",107420,113023,220443
"12781",1965,"15",110397,116336,226733
"12782",1965,"16",115182,121369,236551
"12783",1965,"17",123794,128985,252779
"12784",1965,"18",128517,134704,263221
"12785",1965,"19",92131,96103,188234
"12786",1965,"20",97539,102102,199641
"12787",1965,"21",92630,97479,190109
"12788",1965,"22",84917,89693,174610
"12789",1965,"23",81130,86010,167140
"12790",1965,"24",83263,88400,171663
"12791",1965,"25",81155,85991,167146
"12792",1965,"26",79665,84807,164472
"12793",1965,"27",75649,80367,156016
"12794",1965,"28",75744,80393,156137
"12795",1965,"29",74719,78773,153492
"12796",1965,"30",74915,78499,153414
"12797",1965,"31",74064,77267,151331
"12798",1965,"32",77255,79809,157064
"12799",1965,"33",76125,78225,154350
"12800",1965,"34",78352,80308,158660
"12801",1965,"35",75781,76531,152312
"12802",1965,"36",76425,76248,152673
"12803",1965,"37",74493,74070,148563
"12804",1965,"38",75170,73867,149037
"12805",1965,"39",75679,73848,149527
"12806",1965,"40",77375,74408,151783
"12807",1965,"41",78973,76446,155419
"12808",1965,"42",76456,74247,150703
"12809",1965,"43",77769,74756,152525
"12810",1965,"44",79194,76478,155672
"12811",1965,"45",66531,64627,131158
"12812",1965,"46",65148,62769,127917
"12813",1965,"47",66623,64037,130660
"12814",1965,"48",67281,64700,131981
"12815",1965,"49",65630,63233,128863
"12816",1965,"50",69490,66371,135861
"12817",1965,"51",68372,64848,133220
"12818",1965,"52",67858,64131,131989
"12819",1965,"53",63728,59614,123342
"12820",1965,"54",64400,60398,124798
"12821",1965,"55",65250,60884,126134
"12822",1965,"56",64204,59223,123427
"12823",1965,"57",62652,57934,120586
"12824",1965,"58",61295,55753,117048
"12825",1965,"59",60290,54507,114797
"12826",1965,"60",58958,53622,112580
"12827",1965,"61",56996,51203,108199
"12828",1965,"62",56064,50196,106260
"12829",1965,"63",53851,47271,101122
"12830",1965,"64",51038,44015,95053
"12831",1965,"65",49146,42556,91702
"12832",1965,"66",47900,41089,88989
"12833",1965,"67",46340,39430,85770
"12834",1965,"68",44969,38352,83321
"12835",1965,"69",42129,35808,77937
"12836",1965,"70",40089,33520,73609
"12837",1965,"71",38785,32573,71358
"12838",1965,"72",34369,29085,63454
"12839",1965,"73",33464,28274,61738
"12840",1965,"74",30638,25435,56073
"12841",1965,"75",28107,23958,52065
"12842",1965,"76",26757,22481,49238
"12843",1965,"77",24009,20333,44342
"12844",1965,"78",22262,18334,40596
"12845",1965,"79",19959,16601,36560
"12846",1965,"80",17645.09,14468.63,32113.72
"12847",1965,"81",15308,12442.37,27750.37
"12848",1965,"82",13552.23,11016.62,24568.85
"12849",1965,"83",11464.09,9387.38,20851.47
"12850",1965,"84",9685.89,7823,17508.89
"12851",1965,"85",8249.07,6665.61,14914.68
"12852",1965,"86",6626.03,5271.39,11897.42
"12853",1965,"87",5427.67,4380,9807.67
"12854",1965,"88",4261.06,3386.89,7647.95
"12855",1965,"89",3336.15,2500.11,5836.26
"12856",1965,"90",2449.21,1766.5,4215.71
"12857",1965,"91",1797.58,1368.5,3166.08
"12858",1965,"92",1233.81,929,2162.81
"12859",1965,"93",883.61,534,1417.61
"12860",1965,"94",607,391,998
"12861",1965,"95",400,262,662
"12862",1965,"96",247,135,382
"12863",1965,"97",151,78,229
"12864",1965,"98",82,45,127
"12865",1965,"99",46,26,72
"12866",1965,"100",31,19,50
"12867",1965,"101",25,6,31
"12868",1965,"102",5,5,10
"12869",1965,"103",7,1,8
"12870",1965,"104",2,0,2
"12871",1965,"105",0,0,0
"12872",1965,"106",1,0,1
"12873",1965,"107",0,0,0
"12874",1965,"108",0,0,0
"12875",1965,"109",0,0,0
"12876",1965,"110+",0,0,0
"12877",1966,"0",117639,124064,241703
"12878",1966,"1",120245,126768,247013
"12879",1966,"2",119571,125872,245443
"12880",1966,"3",118092,123313,241405
"12881",1966,"4",118781,123849,242630
"12882",1966,"5",114343,119996,234339
"12883",1966,"6",116050,121033,237083
"12884",1966,"7",113023,118588,231611
"12885",1966,"8",111708,117248,228956
"12886",1966,"9",110193,116117,226310
"12887",1966,"10",109088,113855,222943
"12888",1966,"11",108025,114244,222269
"12889",1966,"12",107903,113433,221336
"12890",1966,"13",108876,114675,223551
"12891",1966,"14",106484,112083,218567
"12892",1966,"15",107518,113084,220602
"12893",1966,"16",110495,116407,226902
"12894",1966,"17",115238,121427,236665
"12895",1966,"18",123775,129118,252893
"12896",1966,"19",128415,134899,263314
"12897",1966,"20",91977,96479,188456
"12898",1966,"21",97269,102210,199479
"12899",1966,"22",92329,97559,189888
"12900",1966,"23",84538,90278,174816
"12901",1966,"24",80945,86993,167938
"12902",1966,"25",83084,89561,172645
"12903",1966,"26",81087,86692,167779
"12904",1966,"27",79523,85635,165158
"12905",1966,"28",75564,80990,156554
"12906",1966,"29",75679,81013,156692
"12907",1966,"30",74623,79426,154049
"12908",1966,"31",74917,79162,154079
"12909",1966,"32",74071,77863,151934
"12910",1966,"33",77265,80488,157753
"12911",1966,"34",76104,78666,154770
"12912",1966,"35",78361,80773,159134
"12913",1966,"36",75732,76817,152549
"12914",1966,"37",76404,76538,152942
"12915",1966,"38",74479,74258,148737
"12916",1966,"39",75136,74040,149176
"12917",1966,"40",75675,73861,149536
"12918",1966,"41",77335,74415,151750
"12919",1966,"42",78901,76373,155274
"12920",1966,"43",76404,74206,150610
"12921",1966,"44",77653,74675,152328
"12922",1966,"45",79094,76320,155414
"12923",1966,"46",66430,64449,130879
"12924",1966,"47",65003,62571,127574
"12925",1966,"48",66485,63837,130322
"12926",1966,"49",67127,64421,131548
"12927",1966,"50",65471,62963,128434
"12928",1966,"51",69294,66015,135309
"12929",1966,"52",68141,64411,132552
"12930",1966,"53",67593,63673,131266
"12931",1966,"54",63461,59066,122527
"12932",1966,"55",64128,59841,123969
"12933",1966,"56",64944,60260,125204
"12934",1966,"57",63856,58508,122364
"12935",1966,"58",62273,57167,119440
"12936",1966,"59",60901,54953,115854
"12937",1966,"60",59870,53620,113490
"12938",1966,"61",58506,52703,111209
"12939",1966,"62",56481,50213,106694
"12940",1966,"63",55459,49156,104615
"12941",1966,"64",53204,46117,99321
"12942",1966,"65",50329,42880,93209
"12943",1966,"66",48391,41395,89786
"12944",1966,"67",47073,39828,86901
"12945",1966,"68",45475,38110,83585
"12946",1966,"69",43979,36992,80971
"12947",1966,"70",41143,34372,75515
"12948",1966,"71",38956,32111,71067
"12949",1966,"72",37595,31068,68663
"12950",1966,"73",33224,27601,60825
"12951",1966,"74",32176,26672,58848
"12952",1966,"75",29278,23954,53232
"12953",1966,"76",26740,22389,49129
"12954",1966,"77",25276,20873,46149
"12955",1966,"78",22443,18743,41186
"12956",1966,"79",20651,16694,37345
"12957",1966,"80",18405.78,15118,33523.78
"12958",1966,"81",16119.09,12948.63,29067.72
"12959",1966,"82",13810,11010.37,24820.37
"12960",1966,"83",12113.23,9675.62,21788.85
"12961",1966,"84",10154.09,8122.38,18276.47
"12962",1966,"85",8429.89,6669,15098.89
"12963",1966,"86",7047.07,5579.61,12626.68
"12964",1966,"87",5563.03,4318.39,9881.42
"12965",1966,"88",4494.67,3549,8043.67
"12966",1966,"89",3498.06,2695.89,6193.95
"12967",1966,"90",2639.15,1916.11,4555.26
"12968",1966,"91",1948.21,1375.5,3323.71
"12969",1966,"92",1387.58,1000.5,2388.08
"12970",1966,"93",904.81,683,1587.81
"12971",1966,"94",647.61,356,1003.61
"12972",1966,"95",435,274,709
"12973",1966,"96",283,176,459
"12974",1966,"97",161,86,247
"12975",1966,"98",99,43,142
"12976",1966,"99",45,25,70
"12977",1966,"100",32,15,47
"12978",1966,"101",22,8,30
"12979",1966,"102",13,3,16
"12980",1966,"103",3,3,6
"12981",1966,"104",4,0,4
"12982",1966,"105",1,0,1
"12983",1966,"106",0,0,0
"12984",1966,"107",0,0,0
"12985",1966,"108",0,0,0
"12986",1966,"109",0,0,0
"12987",1966,"110+",0,0,0
"12988",1967,"0",115362,120923,236285
"12989",1967,"1",117471,123798,241269
"12990",1967,"2",120127,126713,246840
"12991",1967,"3",119560,125732,245292
"12992",1967,"4",118065,123324,241389
"12993",1967,"5",118866,123897,242763
"12994",1967,"6",114358,119960,234318
"12995",1967,"7",116090,121087,237177
"12996",1967,"8",113055,118642,231697
"12997",1967,"9",111818,117253,229071
"12998",1967,"10",110247,116217,226464
"12999",1967,"11",109147,113910,223057
"13000",1967,"12",108159,114310,222469
"13001",1967,"13",108003,113436,221439
"13002",1967,"14",108912,114703,223615
"13003",1967,"15",106562,112121,218683
"13004",1967,"16",107590,113130,220720
"13005",1967,"17",110595,116426,227021
"13006",1967,"18",115368,121587,236955
"13007",1967,"19",123799,129233,253032
"13008",1967,"20",128297,135052,263349
"13009",1967,"21",91785,96570,188355
"13010",1967,"22",96968,102304,199272
"13011",1967,"23",92007,98298,190305
"13012",1967,"24",84367,91389,175756
"13013",1967,"25",80770,87806,168576
"13014",1967,"26",83034,90553,173587
"13015",1967,"27",81003,87318,168321
"13016",1967,"28",79482,86346,165828
"13017",1967,"29",75537,81529,157066
"13018",1967,"30",75760,81594,157354
"13019",1967,"31",74627,80011,154638
"13020",1967,"32",74885,79734,154619
"13021",1967,"33",74061,78592,152653
"13022",1967,"34",77216,81038,158254
"13023",1967,"35",76130,78939,155069
"13024",1967,"36",78367,81241,159608
"13025",1967,"37",75686,77031,152717
"13026",1967,"38",76400,76837,153237
"13027",1967,"39",74472,74442,148914
"13028",1967,"40",75081,74133,149214
"13029",1967,"41",75625,73967,149592
"13030",1967,"42",77287,74429,151716
"13031",1967,"43",78827,76366,155193
"13032",1967,"44",76334,74163,150497
"13033",1967,"45",77521,74560,152081
"13034",1967,"46",79000,76174,155174
"13035",1967,"47",66337,64267,130604
"13036",1967,"48",64840,62368,127208
"13037",1967,"49",66338,63547,129885
"13038",1967,"50",66935,64151,131086
"13039",1967,"51",65255,62637,127892
"13040",1967,"52",69043,65615,134658
"13041",1967,"53",67874,63939,131813
"13042",1967,"54",67376,63114,130490
"13043",1967,"55",63180,58559,121739
"13044",1967,"56",63811,59249,123060
"13045",1967,"57",64575,59566,124141
"13046",1967,"58",63466,57719,121185
"13047",1967,"59",61825,56321,118146
"13048",1967,"60",60465,54068,114533
"13049",1967,"61",59408,52675,112083
"13050",1967,"62",57986,51674,109660
"13051",1967,"63",55898,49113,105011
"13052",1967,"64",54814,47973,102787
"13053",1967,"65",52494,44919,97413
"13054",1967,"66",49589,41655,91244
"13055",1967,"67",47564,40155,87719
"13056",1967,"68",46192,38533,84725
"13057",1967,"69",44550,36691,81241
"13058",1967,"70",42851,35533,78384
"13059",1967,"71",39999,32890,72889
"13060",1967,"72",37768,30557,68325
"13061",1967,"73",36297,29403,65700
"13062",1967,"74",31899,26132,58031
"13063",1967,"75",30744,25076,55820
"13064",1967,"76",27895,22354,50249
"13065",1967,"77",25274,20718,45992
"13066",1967,"78",23724,19202,42926
"13067",1967,"79",20886,17221,38107
"13068",1967,"80",18998.29,15104,34102.29
"13069",1967,"81",16802.78,13581,30383.78
"13070",1967,"82",14593.09,11510.63,26103.72
"13071",1967,"83",12305,9704.37,22009.37
"13072",1967,"84",10736.23,8322.62,19058.85
"13073",1967,"85",8821.09,6853.38,15674.47
"13074",1967,"86",7184.89,5584,12768.89
"13075",1967,"87",5913.07,4590.61,10503.68
"13076",1967,"88",4594.03,3507.39,8101.42
"13077",1967,"89",3621.67,2830,6451.67
"13078",1967,"90",2767.06,2108.89,4875.95
"13079",1967,"91",2083.15,1470.11,3553.26
"13080",1967,"92",1473.21,1021.5,2494.71
"13081",1967,"93",1019.58,715.5,1735.08
"13082",1967,"94",661.81,471,1132.81
"13083",1967,"95",460.61,236,696.61
"13084",1967,"96",291,188,479
"13085",1967,"97",188,124,312
"13086",1967,"98",99,63,162
"13087",1967,"99",63,25,88
"13088",1967,"100",22,12,34
"13089",1967,"101",18,4,22
"13090",1967,"102",16,6,22
"13091",1967,"103",9,2,11
"13092",1967,"104",3,0,3
"13093",1967,"105",3,0,3
"13094",1967,"106",1,0,1
"13095",1967,"107",0,0,0
"13096",1967,"108",0,0,0
"13097",1967,"109",0,0,0
"13098",1967,"110+",0,0,0
"13099",1968,"0",114848,120760,235608
"13100",1968,"1",115154,120579,235733
"13101",1968,"2",117328,123617,240945
"13102",1968,"3",120028,126614,246642
"13103",1968,"4",119475,125673,245148
"13104",1968,"5",118009,123190,241199
"13105",1968,"6",118817,123816,242633
"13106",1968,"7",114288,119925,234213
"13107",1968,"8",116057,121034,237091
"13108",1968,"9",113045,118607,231652
"13109",1968,"10",111854,117270,229124
"13110",1968,"11",110303,116174,226477
"13111",1968,"12",109179,113891,223070
"13112",1968,"13",108185,114260,222445
"13113",1968,"14",108034,113369,221403
"13114",1968,"15",108975,114646,223621
"13115",1968,"16",106630,112011,218641
"13116",1968,"17",107626,113103,220729
"13117",1968,"18",110682,116347,227029
"13118",1968,"19",115361,121392,236753
"13119",1968,"20",123641,128999,252640
"13120",1968,"21",127907,134592,262499
"13121",1968,"22",91451,96121,187572
"13122",1968,"23",96629,101992,198621
"13123",1968,"24",91612,98017,189629
"13124",1968,"25",84088,90893,174981
"13125",1968,"26",80492,87037,167529
"13126",1968,"27",82851,89518,172369
"13127",1968,"28",80826,86498,167324
"13128",1968,"29",79285,85442,164727
"13129",1968,"30",75396,80598,155994
"13130",1968,"31",75620,80672,156292
"13131",1968,"32",74520,79315,153835
"13132",1968,"33",74811,78956,153767
"13133",1968,"34",73964,77749,151713
"13134",1968,"35",77164,80356,157520
"13135",1968,"36",76018,78321,154339
"13136",1968,"37",78274,80678,158952
"13137",1968,"38",75641,76552,152193
"13138",1968,"39",76319,76385,152704
"13139",1968,"40",74352,74094,148446
"13140",1968,"41",75010,73717,148727
"13141",1968,"42",75521,73584,149105
"13142",1968,"43",77191,74069,151260
"13143",1968,"44",78680,76004,154684
"13144",1968,"45",76185,73806,149991
"13145",1968,"46",77369,74198,151567
"13146",1968,"47",78793,75818,154611
"13147",1968,"48",66151,63912,130063
"13148",1968,"49",64667,61960,126627
"13149",1968,"50",66173,63172,129345
"13150",1968,"51",66708,63708,130416
"13151",1968,"52",65037,62220,127257
"13152",1968,"53",68784,65097,133881
"13153",1968,"54",67582,63391,130973
"13154",1968,"55",67074,62534,129608
"13155",1968,"56",62871,57925,120796
"13156",1968,"57",63484,58499,121983
"13157",1968,"58",64185,58742,122927
"13158",1968,"59",63085,56881,119966
"13159",1968,"60",61354,55378,116732
"13160",1968,"61",59950,53057,113007
"13161",1968,"62",58862,51627,110489
"13162",1968,"63",57336,50575,107911
"13163",1968,"64",55244,47984,103228
"13164",1968,"65",54099,46726,100825
"13165",1968,"66",51770,43566,95336
"13166",1968,"67",48778,40356,89134
"13167",1968,"68",46755,38775,85530
"13168",1968,"69",45232,37055,82287
"13169",1968,"70",43540,35234,78774
"13170",1968,"71",41718,33938,75656
"13171",1968,"72",38770,31361,70131
"13172",1968,"73",36584,28982,65566
"13173",1968,"74",34985,27776,62761
"13174",1968,"75",30595,24517,55112
"13175",1968,"76",29272,23372,52644
"13176",1968,"77",26427,20730,47157
"13177",1968,"78",23776,19105,42881
"13178",1968,"79",22174,17649,39823
"13179",1968,"80",19403.34,15750,35153.34
"13180",1968,"81",17399.29,13603,31002.29
"13181",1968,"82",15240.78,12071,27311.78
"13182",1968,"83",13162.09,10179.63,23341.72
"13183",1968,"84",10933,8514.37,19447.37
"13184",1968,"85",9434.23,7155.62,16589.85
"13185",1968,"86",7642.09,5800.38,13442.47
"13186",1968,"87",6087.89,4661,10748.89
"13187",1968,"88",4942.07,3796.61,8738.68
"13188",1968,"89",3799.03,2805.39,6604.42
"13189",1968,"90",2955.67,2267,5222.67
"13190",1968,"91",2174.06,1602.89,3776.95
"13191",1968,"92",1597.15,1117.11,2714.26
"13192",1968,"93",1118.21,755.5,1873.71
"13193",1968,"94",767.58,529.5,1297.08
"13194",1968,"95",505.81,331,836.81
"13195",1968,"96",337.61,171,508.61
"13196",1968,"97",210,122,332
"13197",1968,"98",126,94,220
"13198",1968,"99",59,41,100
"13199",1968,"100",38,17,55
"13200",1968,"101",11,11,22
"13201",1968,"102",10,2,12
"13202",1968,"103",9,4,13
"13203",1968,"104",3,2,5
"13204",1968,"105",1,0,1
"13205",1968,"106",2,0,2
"13206",1968,"107",0,0,0
"13207",1968,"108",0,0,0
"13208",1968,"109",0,0,0
"13209",1968,"110+",0,0,0
"13210",1969,"0",114644,119602,234246
"13211",1969,"1",114737,120520,235257
"13212",1969,"2",115081,120494,235575
"13213",1969,"3",117277,123573,240850
"13214",1969,"4",120033,126547,246580
"13215",1969,"5",119430,125619,245049
"13216",1969,"6",117999,123163,241162
"13217",1969,"7",118803,123766,242569
"13218",1969,"8",114321,119894,234215
"13219",1969,"9",116046,121052,237098
"13220",1969,"10",113070,118645,231715
"13221",1969,"11",111911,117307,229218
"13222",1969,"12",110385,116141,226526
"13223",1969,"13",109204,113878,223082
"13224",1969,"14",108237,114290,222527
"13225",1969,"15",108087,113394,221481
"13226",1969,"16",109096,114676,223772
"13227",1969,"17",106747,112044,218791
"13228",1969,"18",107755,113107,220862
"13229",1969,"19",110782,116269,227051
"13230",1969,"20",115354,121257,236611
"13231",1969,"21",123362,128752,252114
"13232",1969,"22",127489,134121,261610
"13233",1969,"23",91250,96238,187488
"13234",1969,"24",96434,102195,198629
"13235",1969,"25",91483,98154,189637
"13236",1969,"26",84021,90913,174934
"13237",1969,"27",80402,87086,167488
"13238",1969,"28",82852,89670,172522
"13239",1969,"29",80768,86444,167212
"13240",1969,"30",79269,85435,164704
"13241",1969,"31",75341,80569,155910
"13242",1969,"32",75560,80639,156199
"13243",1969,"33",74533,79297,153830
"13244",1969,"34",74813,78932,153745
"13245",1969,"35",73930,77812,151742
"13246",1969,"36",77140,80256,157396
"13247",1969,"37",75992,78199,154191
"13248",1969,"38",78276,80647,158923
"13249",1969,"39",75576,76470,152046
"13250",1969,"40",76273,76266,152539
"13251",1969,"41",74262,73966,148228
"13252",1969,"42",74937,73540,148477
"13253",1969,"43",75444,73408,148852
"13254",1969,"44",77071,73859,150930
"13255",1969,"45",78559,75771,154330
"13256",1969,"46",76086,73527,149613
"13257",1969,"47",77187,73868,151055
"13258",1969,"48",78597,75503,154100
"13259",1969,"49",65984,63548,129532
"13260",1969,"50",64484,61653,126137
"13261",1969,"51",65962,62828,128790
"13262",1969,"52",66477,63217,129694
"13263",1969,"53",64810,61744,126554
"13264",1969,"54",68534,64589,133123
"13265",1969,"55",67252,62763,130015
"13266",1969,"56",66750,61853,128603
"13267",1969,"57",62506,57217,119723
"13268",1969,"58",63131,57762,120893
"13269",1969,"59",63751,57849,121600
"13270",1969,"60",62633,55972,118605
"13271",1969,"61",60870,54338,115208
"13272",1969,"62",59382,51993,111375
"13273",1969,"63",58234,50444,108678
"13274",1969,"64",56698,49464,106162
"13275",1969,"65",54552,46719,101271
"13276",1969,"66",53287,45345,98632
"13277",1969,"67",50928,42214,93142
"13278",1969,"68",47887,38926,86813
"13279",1969,"69",45799,37305,83104
"13280",1969,"70",44245,35513,79758
"13281",1969,"71",42419,33644,76063
"13282",1969,"72",40470,32254,72724
"13283",1969,"73",37498,29773,67271
"13284",1969,"74",35228,27305,62533
"13285",1969,"75",33495,26001,59496
"13286",1969,"76",29112,22833,51945
"13287",1969,"77",27657,21647,49304
"13288",1969,"78",24876,19055,43931
"13289",1969,"79",22199,17440,39639
"13290",1969,"80",20393.1,15909,36302.1
"13291",1969,"81",17731.34,14129,31860.34
"13292",1969,"82",15821.29,12038,27859.29
"13293",1969,"83",13663.78,10552,24215.78
"13294",1969,"84",11573.09,8759.63,20332.72
"13295",1969,"85",9497,7184.37,16681.37
"13296",1969,"86",8045.23,5986.62,14031.85
"13297",1969,"87",6502.09,4749.38,11251.47
"13298",1969,"88",5023.89,3758,8781.89
"13299",1969,"89",3986.07,2996.61,6982.68
"13300",1969,"90",3015.03,2175.39,5190.42
"13301",1969,"91",2322.67,1712,4034.67
"13302",1969,"92",1662.06,1180.89,2842.95
"13303",1969,"93",1159.15,826.11,1985.26
"13304",1969,"94",823.21,524.5,1347.71
"13305",1969,"95",562.58,357.5,920.08
"13306",1969,"96",363.81,222,585.81
"13307",1969,"97",231.61,111,342.61
"13308",1969,"98",133,75,208
"13309",1969,"99",73,59,132
"13310",1969,"100",41,25,66
"13311",1969,"101",23,14,37
"13312",1969,"102",5,4,9
"13313",1969,"103",5,1,6
"13314",1969,"104",3,3,6
"13315",1969,"105",0,2,2
"13316",1969,"106",1,0,1
"13317",1969,"107",1,0,1
"13318",1969,"108",0,0,0
"13319",1969,"109",0,0,0
"13320",1969,"110+",0,0,0
"13321",1970,"0",119307,125324,244631
"13322",1970,"1",114507,119418,233925
"13323",1970,"2",114670,120501,235171
"13324",1970,"3",115147,120507,235654
"13325",1970,"4",117310,123611,240921
"13326",1970,"5",120089,126546,246635
"13327",1970,"6",119514,125637,245151
"13328",1970,"7",118045,123213,241258
"13329",1970,"8",118904,123813,242717
"13330",1970,"9",114417,119960,234377
"13331",1970,"10",116158,121114,237272
"13332",1970,"11",113124,118715,231839
"13333",1970,"12",112018,117409,229427
"13334",1970,"13",110491,116239,226730
"13335",1970,"14",109279,113964,223243
"13336",1970,"15",108331,114374,222705
"13337",1970,"16",108216,113504,221720
"13338",1970,"17",109230,114719,223949
"13339",1970,"18",106946,112188,219134
"13340",1970,"19",107938,113209,221147
"13341",1970,"20",110878,116375,227253
"13342",1970,"21",115374,121279,236653
"13343",1970,"22",123225,128793,252018
"13344",1970,"23",127282,134780,262062
"13345",1970,"24",91196,97221,188417
"13346",1970,"25",96382,102958,199340
"13347",1970,"26",91504,98758,190262
"13348",1970,"27",84015,91485,175500
"13349",1970,"28",80410,87629,168039
"13350",1970,"29",82826,90392,173218
"13351",1970,"30",80823,86934,167757
"13352",1970,"31",79289,85999,165288
"13353",1970,"32",75398,81147,156545
"13354",1970,"33",75543,81228,156771
"13355",1970,"34",74482,79708,154190
"13356",1970,"35",74793,79474,154267
"13357",1970,"36",73955,78026,151981
"13358",1970,"37",77159,80429,157588
"13359",1970,"38",75946,78304,154250
"13360",1970,"39",78234,80729,158963
"13361",1970,"40",75538,76512,152050
"13362",1970,"41",76224,76202,152426
"13363",1970,"42",74213,73858,148071
"13364",1970,"43",74863,73462,148325
"13365",1970,"44",75366,73235,148601
"13366",1970,"45",76992,73663,150655
"13367",1970,"46",78450,75508,153958
"13368",1970,"47",75950,73257,149207
"13369",1970,"48",77030,73529,150559
"13370",1970,"49",78432,75122,153554
"13371",1970,"50",65807,63239,129046
"13372",1970,"51",64275,61286,125561
"13373",1970,"52",65714,62482,128196
"13374",1970,"53",66224,62732,128956
"13375",1970,"54",64510,61161,125671
"13376",1970,"55",68165,63958,132123
"13377",1970,"56",66919,62098,129017
"13378",1970,"57",66375,61123,127498
"13379",1970,"58",62138,56499,118637
"13380",1970,"59",62740,56864,119604
"13381",1970,"60",63250,56918,120168
"13382",1970,"61",62118,54920,117038
"13383",1970,"62",60298,53233,113531
"13384",1970,"63",58737,50780,109517
"13385",1970,"64",57543,49166,106709
"13386",1970,"65",55985,48150,104135
"13387",1970,"66",53733,45222,98955
"13388",1970,"67",52397,43928,96325
"13389",1970,"68",49995,40729,90724
"13390",1970,"69",46870,37449,84319
"13391",1970,"70",44697,35728,80425
"13392",1970,"71",43105,33985,77090
"13393",1970,"72",41118,31821,72939
"13394",1970,"73",39141,30491,69632
"13395",1970,"74",36077,27989,64066
"13396",1970,"75",33768,25535,59303
"13397",1970,"76",31932,24280,56212
"13398",1970,"77",27552,21112,48664
"13399",1970,"78",25928,19893,45821
"13400",1970,"79",23263,17359,40622
"13401",1970,"80",20660.45,15860,36520.45
"13402",1970,"81",18566.1,14294,32860.1
"13403",1970,"82",16052.34,12506,28558.34
"13404",1970,"83",14152.29,10502,24654.29
"13405",1970,"84",12126.78,9163,21289.78
"13406",1970,"85",10109.09,7509.63,17618.72
"13407",1970,"86",8179,6002.37,14181.37
"13408",1970,"87",6811.23,5001.62,11812.85
"13409",1970,"88",5421.09,3875.38,9296.47
"13410",1970,"89",4120.89,3002,7122.89
"13411",1970,"90",3220.07,2352.61,5572.68
"13412",1970,"91",2335.03,1687.39,4022.42
"13413",1970,"92",1774.67,1294,3068.67
"13414",1970,"93",1227.06,845.89,2072.95
"13415",1970,"94",825.15,566.11,1391.26
"13416",1970,"95",605.21,378.5,983.71
"13417",1970,"96",378.58,246.5,625.08
"13418",1970,"97",264.81,151,415.81
"13419",1970,"98",156.61,64,220.61
"13420",1970,"99",83,40,123
"13421",1970,"100",55,37,92
"13422",1970,"101",22,12,34
"13423",1970,"102",14,6,20
"13424",1970,"103",2,3,5
"13425",1970,"104",1,0,1
"13426",1970,"105",2,0,2
"13427",1970,"106",0,2,2
"13428",1970,"107",0,0,0
"13429",1970,"108",0,0,0
"13430",1970,"109",0,0,0
"13431",1970,"110+",0,0,0
"13432",1971,"0",115460,120723,236183
"13433",1971,"1",119254,125258,244512
"13434",1971,"2",114622,119487,234109
"13435",1971,"3",114822,120609,235431
"13436",1971,"4",115278,120600,235878
"13437",1971,"5",117505,123789,241294
"13438",1971,"6",120303,126745,247048
"13439",1971,"7",119673,125766,245439
"13440",1971,"8",118228,123379,241607
"13441",1971,"9",119090,123989,243079
"13442",1971,"10",114621,120140,234761
"13443",1971,"11",116337,121327,237664
"13444",1971,"12",113330,118937,232267
"13445",1971,"13",112201,117554,229755
"13446",1971,"14",110653,116387,227040
"13447",1971,"15",109456,114089,223545
"13448",1971,"16",108516,114463,222979
"13449",1971,"17",108489,113590,222079
"13450",1971,"18",109612,114874,224486
"13451",1971,"19",107335,112338,219673
"13452",1971,"20",108277,113419,221696
"13453",1971,"21",111046,116768,227814
"13454",1971,"22",115466,122034,237500
"13455",1971,"23",123253,130050,253303
"13456",1971,"24",127250,136214,263464
"13457",1971,"25",91409,98482,189891
"13458",1971,"26",96356,104000,200356
"13459",1971,"27",91654,99736,191390
"13460",1971,"28",84132,92492,176624
"13461",1971,"29",80440,88509,168949
"13462",1971,"30",82940,91672,174612
"13463",1971,"31",80987,87925,168912
"13464",1971,"32",79390,87012,166402
"13465",1971,"33",75507,82191,157698
"13466",1971,"34",75662,82201,157863
"13467",1971,"35",74546,80482,155028
"13468",1971,"36",74881,79847,154728
"13469",1971,"37",74007,78197,152204
"13470",1971,"38",77225,80457,157682
"13471",1971,"39",75952,78377,154329
"13472",1971,"40",78202,80722,158924
"13473",1971,"41",75523,76440,151963
"13474",1971,"42",76183,76071,152254
"13475",1971,"43",74200,73706,147906
"13476",1971,"44",74786,73306,148092
"13477",1971,"45",75224,73052,148276
"13478",1971,"46",76876,73374,150250
"13479",1971,"47",78310,75227,153537
"13480",1971,"48",75802,72937,148739
"13481",1971,"49",76893,73146,150039
"13482",1971,"50",78204,74753,152957
"13483",1971,"51",65610,62842,128452
"13484",1971,"52",64085,60827,124912
"13485",1971,"53",65464,61970,127434
"13486",1971,"54",65944,62171,128115
"13487",1971,"55",64199,60553,124752
"13488",1971,"56",67809,63238,131047
"13489",1971,"57",66579,61336,127915
"13490",1971,"58",65968,60261,126229
"13491",1971,"59",61716,55636,117352
"13492",1971,"60",62282,55906,118188
"13493",1971,"61",62743,55861,118604
"13494",1971,"62",61505,53741,115246
"13495",1971,"63",59702,51975,111677
"13496",1971,"64",58063,49484,107547
"13497",1971,"65",56781,47779,104560
"13498",1971,"66",55209,46735,101944
"13499",1971,"67",52880,43728,96608
"13500",1971,"68",51445,42326,93771
"13501",1971,"69",48985,39077,88062
"13502",1971,"70",45788,35905,81693
"13503",1971,"71",43503,34081,77584
"13504",1971,"72",41785,32311,74096
"13505",1971,"73",39808,29998,69806
"13506",1971,"74",37642,28729,66371
"13507",1971,"75",34552,26159,60711
"13508",1971,"76",32250,23755,56005
"13509",1971,"77",30230,22428,52658
"13510",1971,"78",25919,19412,45331
"13511",1971,"79",24205,18099,42304
"13512",1971,"80",21444.99,15695.43,37140.42
"13513",1971,"81",18901.45,14169,33070.45
"13514",1971,"82",16790.1,12662,29452.1
"13515",1971,"83",14417.34,10963,25380.34
"13516",1971,"84",12517.29,9136,21653.29
"13517",1971,"85",10646.78,7809,18455.78
"13518",1971,"86",8700.09,6298.63,14998.72
"13519",1971,"87",6924,4953.37,11877.37
"13520",1971,"88",5672.23,4089.62,9761.85
"13521",1971,"89",4419.09,3077.38,7496.47
"13522",1971,"90",3302.89,2365,5667.89
"13523",1971,"91",2563.07,1814.61,4377.68
"13524",1971,"92",1812.03,1272.39,3084.42
"13525",1971,"93",1300.67,955,2255.67
"13526",1971,"94",898.06,605.89,1503.95
"13527",1971,"95",586.15,393.11,979.26
"13528",1971,"96",447.21,247.5,694.71
"13529",1971,"97",258.58,165.5,424.08
"13530",1971,"98",183.81,98,281.81
"13531",1971,"99",99.61,41,140.61
"13532",1971,"100",47,21,68
"13533",1971,"101",29,23,52
"13534",1971,"102",8,7,15
"13535",1971,"103",6,3,9
"13536",1971,"104",1,2,3
"13537",1971,"105",0,0,0
"13538",1971,"106",1,0,1
"13539",1971,"107",0,0,0
"13540",1971,"108",0,0,0
"13541",1971,"109",0,0,0
"13542",1971,"110+",0,0,0
"13543",1972,"0",109607,115270,224877
"13544",1972,"1",115608,120884,236492
"13545",1972,"2",119525,125541,245066
"13546",1972,"3",114957,119760,234717
"13547",1972,"4",115044,120915,235959
"13548",1972,"5",115584,120895,236479
"13549",1972,"6",117822,124164,241986
"13550",1972,"7",120635,127031,247666
"13551",1972,"8",119962,126036,245998
"13552",1972,"9",118541,123644,242185
"13553",1972,"10",119355,124315,243670
"13554",1972,"11",114965,120396,235361
"13555",1972,"12",116641,121576,238217
"13556",1972,"13",113575,119149,232724
"13557",1972,"14",112407,117762,230169
"13558",1972,"15",110857,116594,227451
"13559",1972,"16",109731,114268,223999
"13560",1972,"17",108835,114647,223482
"13561",1972,"18",109024,113827,222851
"13562",1972,"19",110283,115118,225401
"13563",1972,"20",107837,112578,220415
"13564",1972,"21",108621,113708,222329
"13565",1972,"22",111274,117188,228462
"13566",1972,"23",115656,123079,238735
"13567",1972,"24",123349,131197,254546
"13568",1972,"25",127181,136968,264149
"13569",1972,"26",91610,99153,190763
"13570",1972,"27",96559,104563,201122
"13571",1972,"28",91798,100204,192002
"13572",1972,"29",84319,93076,177395
"13573",1972,"30",80641,89018,169659
"13574",1972,"31",83129,92266,175395
"13575",1972,"32",81174,88393,169567
"13576",1972,"33",79578,87601,167179
"13577",1972,"34",75689,82749,158438
"13578",1972,"35",75866,82611,158477
"13579",1972,"36",74701,80736,155437
"13580",1972,"37",75092,79913,155005
"13581",1972,"38",74162,78246,152408
"13582",1972,"39",77353,80341,157694
"13583",1972,"40",76060,78308,154368
"13584",1972,"41",78284,80616,158900
"13585",1972,"42",75585,76322,151907
"13586",1972,"43",76209,75881,152090
"13587",1972,"44",74201,73439,147640
"13588",1972,"45",74791,73052,147843
"13589",1972,"46",75232,72770,148002
"13590",1972,"47",76811,73070,149881
"13591",1972,"48",78198,74882,153080
"13592",1972,"49",75670,72539,148209
"13593",1972,"50",76674,72731,149405
"13594",1972,"51",77988,74288,152276
"13595",1972,"52",65377,62439,127816
"13596",1972,"53",63856,60340,124196
"13597",1972,"54",65220,61382,126602
"13598",1972,"55",65640,61575,127215
"13599",1972,"56",63907,59891,123798
"13600",1972,"57",67463,62477,129940
"13601",1972,"58",66233,60532,126765
"13602",1972,"59",65539,59420,124959
"13603",1972,"60",61328,54716,116044
"13604",1972,"61",61770,54912,116682
"13605",1972,"62",62160,54718,116878
"13606",1972,"63",60906,52549,113455
"13607",1972,"64",59050,50710,109760
"13608",1972,"65",57358,48142,105500
"13609",1972,"66",55996,46333,102329
"13610",1972,"67",54338,45273,99611
"13611",1972,"68",51987,42126,94113
"13612",1972,"69",50418,40677,91095
"13613",1972,"70",47855,37466,85321
"13614",1972,"71",44677,34341,79018
"13615",1972,"72",42175,32378,74553
"13616",1972,"73",40452,30555,71007
"13617",1972,"74",38308,28124,66432
"13618",1972,"75",36083,26904,62987
"13619",1972,"76",33007,24257,57264
"13620",1972,"77",30504,21978,52482
"13621",1972,"78",28443,20553,48996
"13622",1972,"79",24327,17743,42070
"13623",1972,"80",22737.01,16383.01,39120.02
"13624",1972,"81",19639.99,14082.43,33722.42
"13625",1972,"82",17088.45,12574,29662.45
"13626",1972,"83",15033.1,11104,26137.1
"13627",1972,"84",12758.34,9501,22259.34
"13628",1972,"85",10910.29,7801,18711.29
"13629",1972,"86",9091.78,6492,15583.78
"13630",1972,"87",7386.09,5235.63,12621.72
"13631",1972,"88",5766,4060.37,9826.37
"13632",1972,"89",4690.23,3316.62,8006.85
"13633",1972,"90",3566.09,2423.38,5989.47
"13634",1972,"91",2594.89,1808,4402.89
"13635",1972,"92",2011.07,1378.61,3389.68
"13636",1972,"93",1342.03,918.39,2260.42
"13637",1972,"94",948.67,701,1649.67
"13638",1972,"95",641.06,403.89,1044.95
"13639",1972,"96",412.15,252.11,664.26
"13640",1972,"97",305.21,166.5,471.71
"13641",1972,"98",151.58,92.5,244.08
"13642",1972,"99",120.81,70,190.81
"13643",1972,"100",62.61,24,86.61
"13644",1972,"101",24,15,39
"13645",1972,"102",17,14,31
"13646",1972,"103",6,3,9
"13647",1972,"104",2,2,4
"13648",1972,"105",1,0,1
"13649",1972,"106",0,0,0
"13650",1972,"107",0,0,0
"13651",1972,"108",0,0,0
"13652",1972,"109",0,0,0
"13653",1972,"110+",0,0,0
"13654",1973,"0",103836,108166,212002
"13655",1973,"1",109729,115356,225085
"13656",1973,"2",115821,121101,236922
"13657",1973,"3",119749,125847,245596
"13658",1973,"4",115161,120023,235184
"13659",1973,"5",115314,121177,236491
"13660",1973,"6",115882,121152,237034
"13661",1973,"7",118118,124409,242527
"13662",1973,"8",120937,127241,248178
"13663",1973,"9",120203,126275,246478
"13664",1973,"10",118805,123951,242756
"13665",1973,"11",119613,124631,244244
"13666",1973,"12",115288,120679,235967
"13667",1973,"13",116887,121855,238742
"13668",1973,"14",113775,119345,233120
"13669",1973,"15",112623,118007,230630
"13670",1973,"16",111130,116846,227976
"13671",1973,"17",110057,114430,224487
"13672",1973,"18",109362,114886,224248
"13673",1973,"19",109566,113968,223534
"13674",1973,"20",110650,115133,225783
"13675",1973,"21",108071,112521,220592
"13676",1973,"22",108873,113749,222622
"13677",1973,"23",111527,117318,228845
"13678",1973,"24",115887,123367,239254
"13679",1973,"25",123537,131204,254741
"13680",1973,"26",127262,136728,263990
"13681",1973,"27",91742,98953,190695
"13682",1973,"28",96755,104294,201049
"13683",1973,"29",91938,99968,191906
"13684",1973,"30",84405,92861,177266
"13685",1973,"31",80750,88807,169557
"13686",1973,"32",83231,91966,175197
"13687",1973,"33",81297,88126,169423
"13688",1973,"34",79732,87245,166977
"13689",1973,"35",75770,82464,158234
"13690",1973,"36",75974,82285,158259
"13691",1973,"37",74807,80374,155181
"13692",1973,"38",75151,79631,154782
"13693",1973,"39",74201,77881,152082
"13694",1973,"40",77383,80089,157472
"13695",1973,"41",76135,78042,154177
"13696",1973,"42",78327,80318,158645
"13697",1973,"43",75557,76040,151597
"13698",1973,"44",76138,75611,151749
"13699",1973,"45",74165,73143,147308
"13700",1973,"46",74704,72732,147436
"13701",1973,"47",75150,72481,147631
"13702",1973,"48",76640,72764,149404
"13703",1973,"49",78033,74474,152507
"13704",1973,"50",75467,72157,147624
"13705",1973,"51",76443,72257,148700
"13706",1973,"52",77713,73776,151489
"13707",1973,"53",65139,61929,127068
"13708",1973,"54",63609,59798,123407
"13709",1973,"55",64947,60807,125754
"13710",1973,"56",65319,60870,126189
"13711",1973,"57",63560,59129,122689
"13712",1973,"58",67064,61648,128712
"13713",1973,"59",65817,59660,125477
"13714",1973,"60",65128,58425,123553
"13715",1973,"61",60839,53706,114545
"13716",1973,"62",61271,53861,115132
"13717",1973,"63",61559,53469,115028
"13718",1973,"64",60228,51197,111425
"13719",1973,"65",58346,49301,107647
"13720",1973,"66",56601,46682,103283
"13721",1973,"67",55165,44769,99934
"13722",1973,"68",53380,43622,97002
"13723",1973,"69",50929,40515,91444
"13724",1973,"70",49383,38912,88295
"13725",1973,"71",46676,35679,82355
"13726",1973,"72",43490,32518,76008
"13727",1973,"73",40810,30580,71390
"13728",1973,"74",38977,28675,67652
"13729",1973,"75",36691,26285,62976
"13730",1973,"76",34374,24976,59350
"13731",1973,"77",31260,22322,53582
"13732",1973,"78",28651,20051,48702
"13733",1973,"79",26555,18726,45281
"13734",1973,"80",22551.35,15995.41,38546.76
"13735",1973,"81",20790.01,14630.01,35420.02
"13736",1973,"82",17817.99,12479.43,30297.42
"13737",1973,"83",15238.45,11024,26262.45
"13738",1973,"84",13318.1,9521,22839.1
"13739",1973,"85",11121.34,8123,19244.34
"13740",1973,"86",9415.29,6541,15956.29
"13741",1973,"87",7679.78,5342,13021.78
"13742",1973,"88",6154.09,4247.63,10401.72
"13743",1973,"89",4689,3202.37,7891.37
"13744",1973,"90",3733.23,2565.62,6298.85
"13745",1973,"91",2817.09,1856.38,4673.47
"13746",1973,"92",2006.89,1367,3373.89
"13747",1973,"93",1497.07,1037.61,2534.68
"13748",1973,"94",996.03,641.39,1637.42
"13749",1973,"95",670.67,490,1160.67
"13750",1973,"96",438.06,261.89,699.95
"13751",1973,"97",276.15,153.11,429.26
"13752",1973,"98",220.21,105.5,325.71
"13753",1973,"99",78.58,57.5,136.08
"13754",1973,"100",68.81,38,106.81
"13755",1973,"101",41.61,14,55.61
"13756",1973,"102",16,12,28
"13757",1973,"103",12,9,21
"13758",1973,"104",3,1,4
"13759",1973,"105",0,0,0
"13760",1973,"106",0,0,0
"13761",1973,"107",0,0,0
"13762",1973,"108",0,0,0
"13763",1973,"109",0,0,0
"13764",1973,"110+",0,0,0
"13765",1974,"0",94391,98629,193020
"13766",1974,"1",103934,108317,212251
"13767",1974,"2",109970,115512,225482
"13768",1974,"3",116047,121448,237495
"13769",1974,"4",120102,126123,246225
"13770",1974,"5",115440,120346,235786
"13771",1974,"6",115481,121400,236881
"13772",1974,"7",116115,121439,237554
"13773",1974,"8",118382,124653,243035
"13774",1974,"9",121168,127507,248675
"13775",1974,"10",120505,126539,247044
"13776",1974,"11",119040,124261,243301
"13777",1974,"12",119835,124924,244759
"13778",1974,"13",115566,121003,236569
"13779",1974,"14",117090,122125,239215
"13780",1974,"15",113948,119635,233583
"13781",1974,"16",112890,118264,231154
"13782",1974,"17",111491,117113,228604
"13783",1974,"18",110595,114690,225285
"13784",1974,"19",109953,115086,225039
"13785",1974,"20",110037,114232,224269
"13786",1974,"21",110866,115309,226175
"13787",1974,"22",108238,112736,220974
"13788",1974,"23",109077,114088,223165
"13789",1974,"24",111655,117649,229304
"13790",1974,"25",115975,123541,239516
"13791",1974,"26",123569,131230,254799
"13792",1974,"27",127174,136640,263814
"13793",1974,"28",91871,98918,190789
"13794",1974,"29",96777,104167,200944
"13795",1974,"30",91936,99871,191807
"13796",1974,"31",84416,92798,177214
"13797",1974,"32",80754,88694,169448
"13798",1974,"33",83344,91773,175117
"13799",1974,"34",81349,87965,169314
"13800",1974,"35",79766,87057,166823
"13801",1974,"36",75845,82235,158080
"13802",1974,"37",75942,81998,157940
"13803",1974,"38",74816,80094,154910
"13804",1974,"39",75177,79389,154566
"13805",1974,"40",74191,77602,151793
"13806",1974,"41",77390,79842,157232
"13807",1974,"42",76110,77767,153877
"13808",1974,"43",78286,80106,158392
"13809",1974,"44",75497,75792,151289
"13810",1974,"45",76064,75313,151377
"13811",1974,"46",74022,72836,146858
"13812",1974,"47",74611,72405,147016
"13813",1974,"48",74985,72134,147119
"13814",1974,"49",76476,72404,148880
"13815",1974,"50",77814,74093,151907
"13816",1974,"51",75308,71716,147024
"13817",1974,"52",76194,71748,147942
"13818",1974,"53",77432,73210,150642
"13819",1974,"54",64864,61396,126260
"13820",1974,"55",63292,59200,122492
"13821",1974,"56",64656,60119,124775
"13822",1974,"57",64986,60165,125151
"13823",1974,"58",63225,58431,121656
"13824",1974,"59",66660,60848,127508
"13825",1974,"60",65369,58699,124068
"13826",1974,"61",64625,57404,122029
"13827",1974,"62",60399,52627,113026
"13828",1974,"63",60691,52660,113351
"13829",1974,"64",60952,52188,113140
"13830",1974,"65",59491,49865,109356
"13831",1974,"66",57560,47828,105388
"13832",1974,"67",55757,45215,100972
"13833",1974,"68",54241,43211,97452
"13834",1974,"69",52439,41862,94301
"13835",1974,"70",49830,38895,88725
"13836",1974,"71",48227,37102,85329
"13837",1974,"72",45472,33931,79403
"13838",1974,"73",42175,30807,72982
"13839",1974,"74",39426,28822,68248
"13840",1974,"75",37469,26794,64263
"13841",1974,"76",35096,24425,59521
"13842",1974,"77",32735,23074,55809
"13843",1974,"78",29564,20498,50062
"13844",1974,"79",26878,18311,45189
"13845",1974,"80",24821.37,17011.48,41832.85
"13846",1974,"81",20794.35,14355.41,35149.76
"13847",1974,"82",18959.01,12989.01,31948.02
"13848",1974,"83",16024.99,10924.43,26949.42
"13849",1974,"84",13597.45,9553,23150.45
"13850",1974,"85",11771.1,8153,19924.1
"13851",1974,"86",9662.34,6866,16528.34
"13852",1974,"87",8031.29,5436,13467.29
"13853",1974,"88",6450.78,4319,10769.78
"13854",1974,"89",5049.09,3410.63,8459.72
"13855",1974,"90",3779,2521.37,6300.37
"13856",1974,"91",2926.23,1974.62,4900.85
"13857",1974,"92",2166.09,1425.38,3591.47
"13858",1974,"93",1536.89,975,2511.89
"13859",1974,"94",1120.07,732.61,1852.68
"13860",1974,"95",753.03,437.39,1190.42
"13861",1974,"96",468.67,349,817.67
"13862",1974,"97",300.06,162.89,462.95
"13863",1974,"98",177.15,101.11,278.26
"13864",1974,"99",137.21,68.5,205.71
"13865",1974,"100",42.58,30.5,73.08
"13866",1974,"101",41.81,18,59.81
"13867",1974,"102",28.61,10,38.61
"13868",1974,"103",9,4,13
"13869",1974,"104",6,3,9
"13870",1974,"105",2,1,3
"13871",1974,"106",0,0,0
"13872",1974,"107",0,0,0
"13873",1974,"108",0,0,0
"13874",1974,"109",0,0,0
"13875",1974,"110+",0,0,0
"13876",1975,"0",90026,94615,184641
"13877",1975,"1",94665,98844,193509
"13878",1975,"2",104363,108598,212961
"13879",1975,"3",110402,116011,226413
"13880",1975,"4",116501,121947,238448
"13881",1975,"5",120526,126537,247063
"13882",1975,"6",115869,120695,236564
"13883",1975,"7",115785,121682,237467
"13884",1975,"8",116529,121845,238374
"13885",1975,"9",118752,125059,243811
"13886",1975,"10",121659,127985,249644
"13887",1975,"11",120941,126949,247890
"13888",1975,"12",119443,124678,244121
"13889",1975,"13",120199,125274,245473
"13890",1975,"14",115900,121407,237307
"13891",1975,"15",117503,122525,240028
"13892",1975,"16",114370,119973,234343
"13893",1975,"17",113399,118650,232049
"13894",1975,"18",112176,117531,229707
"13895",1975,"19",111353,115066,226419
"13896",1975,"20",110604,115427,226031
"13897",1975,"21",110629,114612,225241
"13898",1975,"22",111177,115712,226889
"13899",1975,"23",108475,113240,221715
"13900",1975,"24",109367,114771,224138
"13901",1975,"25",111886,118098,229984
"13902",1975,"26",116111,123819,239930
"13903",1975,"27",123762,131360,255122
"13904",1975,"28",127295,136632,263927
"13905",1975,"29",91978,99110,191088
"13906",1975,"30",96927,104169,201096
"13907",1975,"31",92020,99895,191915
"13908",1975,"32",84620,92974,177594
"13909",1975,"33",80911,88800,169711
"13910",1975,"34",83457,91802,175259
"13911",1975,"35",81434,87993,169427
"13912",1975,"36",79882,86920,166802
"13913",1975,"37",75969,82036,158005
"13914",1975,"38",76017,81789,157806
"13915",1975,"39",74885,79905,154790
"13916",1975,"40",75245,79157,154402
"13917",1975,"41",74226,77423,151649
"13918",1975,"42",77392,79635,157027
"13919",1975,"43",76135,77536,153671
"13920",1975,"44",78271,79963,158234
"13921",1975,"45",75509,75538,151047
"13922",1975,"46",75976,75063,151039
"13923",1975,"47",73920,72577,146497
"13924",1975,"48",74525,72096,146621
"13925",1975,"49",74832,71766,146598
"13926",1975,"50",76279,72022,148301
"13927",1975,"51",77611,73656,151267
"13928",1975,"52",75059,71313,146372
"13929",1975,"53",75967,71184,147151
"13930",1975,"54",77153,72625,149778
"13931",1975,"55",64589,60823,125412
"13932",1975,"56",63042,58606,121648
"13933",1975,"57",64346,59420,123766
"13934",1975,"58",64619,59315,123934
"13935",1975,"59",62848,57658,120506
"13936",1975,"60",66200,59880,126080
"13937",1975,"61",64885,57704,122589
"13938",1975,"62",64139,56285,120424
"13939",1975,"63",59838,51530,111368
"13940",1975,"64",60134,51454,111588
"13941",1975,"65",60322,50793,111115
"13942",1975,"66",58685,48457,107142
"13943",1975,"67",56705,46221,102926
"13944",1975,"68",54767,43647,98414
"13945",1975,"69",53271,41584,94855
"13946",1975,"70",51392,40191,91583
"13947",1975,"71",48704,37210,85914
"13948",1975,"72",47003,35258,82261
"13949",1975,"73",44135,32130,76265
"13950",1975,"74",40779,29076,69855
"13951",1975,"75",37930,27042,64972
"13952",1975,"76",35983,25034,61017
"13953",1975,"77",33448,22537,55985
"13954",1975,"78",31027,21224,52251
"13955",1975,"79",27814,18674,46488
"13956",1975,"80",25025.3,16621.84,41647.14
"13957",1975,"81",22951.37,15311.48,38262.85
"13958",1975,"82",19075.35,12812.41,31887.76
"13959",1975,"83",17193.01,11507.01,28700.02
"13960",1975,"84",14294.99,9555.43,23850.42
"13961",1975,"85",12027.45,8264,20291.45
"13962",1975,"86",10262.1,6867,17129.1
"13963",1975,"87",8384.34,5746,14130.34
"13964",1975,"88",6823.29,4422,11245.29
"13965",1975,"89",5352.78,3446,8798.78
"13966",1975,"90",4066.09,2718.63,6784.72
"13967",1975,"91",3024,1977.37,5001.37
"13968",1975,"92",2295.23,1536.62,3831.85
"13969",1975,"93",1632.09,1030.38,2662.47
"13970",1975,"94",1122.89,720,1842.89
"13971",1975,"95",841.07,531.61,1372.68
"13972",1975,"96",546.03,304.39,850.42
"13973",1975,"97",298.67,228,526.67
"13974",1975,"98",205.06,95.89,300.95
"13975",1975,"99",114.15,63.11,177.26
"13976",1975,"100",95.21,40.5,135.71
"13977",1975,"101",28.58,14.5,43.08
"13978",1975,"102",22.81,12,34.81
"13979",1975,"103",15.61,5,20.61
"13980",1975,"104",1,1,2
"13981",1975,"105",5,1,6
"13982",1975,"106",0,0,0
"13983",1975,"107",0,0,0
"13984",1975,"108",0,0,0
"13985",1975,"109",0,0,0
"13986",1975,"110+",0,0,0
"13987",1976,"0",86522,90514,177036
"13988",1976,"1",90727,95313,186040
"13989",1976,"2",95497,99726,195223
"13990",1976,"3",105141,109454,214595
"13991",1976,"4",110855,116762,227617
"13992",1976,"5",117401,122789,240190
"13993",1976,"6",121467,127296,248763
"13994",1976,"7",116546,121341,237887
"13995",1976,"8",116324,122069,238393
"13996",1976,"9",117167,122474,239641
"13997",1976,"10",119458,125649,245107
"13998",1976,"11",122420,128701,251121
"13999",1976,"12",121648,127553,249201
"14000",1976,"13",120097,125234,245331
"14001",1976,"14",120818,125769,246587
"14002",1976,"15",116648,122052,238700
"14003",1976,"16",118105,123268,241373
"14004",1976,"17",115188,120635,235823
"14005",1976,"18",114498,119498,233996
"14006",1976,"19",113078,118407,231485
"14007",1976,"20",112730,116227,228957
"14008",1976,"21",111372,116444,227816
"14009",1976,"22",111183,115891,227074
"14010",1976,"23",111828,117369,229197
"14011",1976,"24",109270,115018,224288
"14012",1976,"25",109900,116420,226320
"14013",1976,"26",112372,119619,231991
"14014",1976,"27",116246,124988,241234
"14015",1976,"28",123993,132206,256199
"14016",1976,"29",127698,137758,265456
"14017",1976,"30",92058,99604,191662
"14018",1976,"31",96935,104666,201601
"14019",1976,"32",92195,100298,192493
"14020",1976,"33",84618,93229,177847
"14021",1976,"34",81321,89229,170550
"14022",1976,"35",83610,91629,175239
"14023",1976,"36",81839,87974,169813
"14024",1976,"37",80202,86993,167195
"14025",1976,"38",76329,82111,158440
"14026",1976,"39",76304,81769,158073
"14027",1976,"40",75285,79894,155179
"14028",1976,"41",75507,79396,154903
"14029",1976,"42",74654,77647,152301
"14030",1976,"43",77424,79679,157103
"14031",1976,"44",76544,77931,154475
"14032",1976,"45",78149,79667,157816
"14033",1976,"46",75709,75440,151149
"14034",1976,"47",75981,74877,150858
"14035",1976,"48",73775,72313,146088
"14036",1976,"49",74426,72003,146429
"14037",1976,"50",74821,71634,146455
"14038",1976,"51",76320,71807,148127
"14039",1976,"52",77413,73446,150859
"14040",1976,"53",75140,71012,146152
"14041",1976,"54",75955,70906,146861
"14042",1976,"55",76895,71909,148804
"14043",1976,"56",64376,60175,124551
"14044",1976,"57",62768,57988,120756
"14045",1976,"58",64152,58735,122887
"14046",1976,"59",64313,58460,122773
"14047",1976,"60",62702,56787,119489
"14048",1976,"61",65737,58864,124601
"14049",1976,"62",64590,56637,121227
"14050",1976,"63",63507,55023,118530
"14051",1976,"64",59255,50240,109495
"14052",1976,"65",59293,49830,109123
"14053",1976,"66",59808,49338,109146
"14054",1976,"67",57907,46916,104823
"14055",1976,"68",55919,44675,100594
"14056",1976,"69",53853,41817,95670
"14057",1976,"70",52337,39962,92299
"14058",1976,"71",50246,38314,88560
"14059",1976,"72",47583,35316,82899
"14060",1976,"73",45741,33394,79135
"14061",1976,"74",42999,30329,73328
"14062",1976,"75",38929,27167,66096
"14063",1976,"76",36621,25201,61822
"14064",1976,"77",34090,22952,57042
"14065",1976,"78",31976,20779,52755
"14066",1976,"79",29289,19281,48570
"14067",1976,"80",25956.3,16766.58,42722.88
"14068",1976,"81",23096.3,14815.84,37912.14
"14069",1976,"82",20974.37,13522.48,34496.85
"14070",1976,"83",17320.35,11290.41,28610.76
"14071",1976,"84",15419.01,9951.01,25370.02
"14072",1976,"85",12552.99,8105.43,20658.42
"14073",1976,"86",10453.45,6931,17384.45
"14074",1976,"87",8822.1,5698,14520.1
"14075",1976,"88",7059.34,4657,11716.34
"14076",1976,"89",5625.29,3527,9152.29
"14077",1976,"90",4314.78,2706,7020.78
"14078",1976,"91",3249.09,2091.63,5340.72
"14079",1976,"92",2367,1475.37,3842.37
"14080",1976,"93",1752.23,1112.62,2864.85
"14081",1976,"94",1238.09,730.38,1968.47
"14082",1976,"95",813.89,494,1307.89
"14083",1976,"96",590.07,364.61,954.68
"14084",1976,"97",367.03,198.39,565.42
"14085",1976,"98",191.67,150,341.67
"14086",1976,"99",149.06,65.89,214.95
"14087",1976,"100",76.15,32.11,108.26
"14088",1976,"101",56.21,28.5,84.71
"14089",1976,"102",12.58,7.5,20.08
"14090",1976,"103",11.81,7,18.81
"14091",1976,"104",8.61,1,9.61
"14092",1976,"105",0,0,0
"14093",1976,"106",3,1,4
"14094",1976,"107",0,0,0
"14095",1976,"108",0,0,0
"14096",1976,"109",0,0,0
"14097",1976,"110+",0,0,0
"14098",1977,"0",85431,90330,175761
"14099",1977,"1",86735,90802,177537
"14100",1977,"2",91077,95693,186770
"14101",1977,"3",95908,100126,196034
"14102",1977,"4",105582,109801,215383
"14103",1977,"5",111338,117151,228489
"14104",1977,"6",117689,123116,240805
"14105",1977,"7",121685,127534,249219
"14106",1977,"8",116631,121566,238197
"14107",1977,"9",116565,122327,238892
"14108",1977,"10",117442,122729,240171
"14109",1977,"11",119808,125894,245702
"14110",1977,"12",122702,128988,251690
"14111",1977,"13",121859,127794,249653
"14112",1977,"14",120285,125460,245745
"14113",1977,"15",121047,126003,247050
"14114",1977,"16",116759,122309,239068
"14115",1977,"17",118400,123481,241881
"14116",1977,"18",115647,120863,236510
"14117",1977,"19",114967,119681,234648
"14118",1977,"20",113549,118578,232127
"14119",1977,"21",113115,116355,229470
"14120",1977,"22",111779,116644,228423
"14121",1977,"23",111549,116190,227739
"14122",1977,"24",112161,117760,229921
"14123",1977,"25",109583,115387,224970
"14124",1977,"26",110089,116601,226690
"14125",1977,"27",112482,119818,232300
"14126",1977,"28",116272,124956,241228
"14127",1977,"29",123955,132213,256168
"14128",1977,"30",127754,137631,265385
"14129",1977,"31",92065,99460,191525
"14130",1977,"32",96961,104550,201511
"14131",1977,"33",92221,100157,192378
"14132",1977,"34",84623,93000,177623
"14133",1977,"35",81373,89062,170435
"14134",1977,"36",83630,91212,174842
"14135",1977,"37",81896,87776,169672
"14136",1977,"38",80215,86745,166960
"14137",1977,"39",76360,81940,158300
"14138",1977,"40",76317,81439,157756
"14139",1977,"41",75296,79656,154952
"14140",1977,"42",75436,79083,154519
"14141",1977,"43",74531,77349,151880
"14142",1977,"44",77312,79320,156632
"14143",1977,"45",76435,77626,154061
"14144",1977,"46",77880,79116,156996
"14145",1977,"47",75415,74957,150372
"14146",1977,"48",75765,74432,150197
"14147",1977,"49",73556,71906,145462
"14148",1977,"50",74182,71580,145762
"14149",1977,"51",74550,71215,145765
"14150",1977,"52",76048,71257,147305
"14151",1977,"53",77148,72862,150010
"14152",1977,"54",74834,70378,145212
"14153",1977,"55",75624,70194,145818
"14154",1977,"56",76518,71168,147686
"14155",1977,"57",64011,59483,123494
"14156",1977,"58",62420,57207,119627
"14157",1977,"59",63747,57912,121659
"14158",1977,"60",63872,57560,121432
"14159",1977,"61",62251,55693,117944
"14160",1977,"62",65180,57687,122867
"14161",1977,"63",63999,55318,119317
"14162",1977,"64",62874,53710,116584
"14163",1977,"65",58563,48919,107482
"14164",1977,"66",58544,48314,106858
"14165",1977,"67",58944,47707,106651
"14166",1977,"68",57003,45186,102189
"14167",1977,"69",54915,42920,97835
"14168",1977,"70",52796,39972,92768
"14169",1977,"71",51152,38064,89216
"14170",1977,"72",48931,36342,85273
"14171",1977,"73",46231,33359,79590
"14172",1977,"74",44249,31392,75641
"14173",1977,"75",41408,28321,69729
"14174",1977,"76",37342,25240,62582
"14175",1977,"77",35005,23184,58189
"14176",1977,"78",32279,21101,53380
"14177",1977,"79",30078,18883,48961
"14178",1977,"80",27313.51,17429.07,44742.58
"14179",1977,"81",24062.3,14958.58,39020.88
"14180",1977,"82",21289.3,13111.84,34401.14
"14181",1977,"83",19098.37,11837.48,30935.85
"14182",1977,"84",15460.35,9724.41,25184.76
"14183",1977,"85",13703.01,8516.01,22219.02
"14184",1977,"86",10949.99,6818.43,17768.42
"14185",1977,"87",9021.45,5774,14795.45
"14186",1977,"88",7452.1,4677,12129.1
"14187",1977,"89",5820.34,3685,9505.34
"14188",1977,"90",4595.29,2791,7386.29
"14189",1977,"91",3450.78,2120,5570.78
"14190",1977,"92",2495.09,1537.63,4032.72
"14191",1977,"93",1834,1072.37,2906.37
"14192",1977,"94",1308.23,797.62,2105.85
"14193",1977,"95",875.09,506.38,1381.47
"14194",1977,"96",564.89,327,891.89
"14195",1977,"97",420.07,246.61,666.68
"14196",1977,"98",238.03,115.39,353.42
"14197",1977,"99",135.67,86,221.67
"14198",1977,"100",102.06,34.89,136.95
"14199",1977,"101",45.15,13.11,58.26
"14200",1977,"102",38.21,16.5,54.71
"14201",1977,"103",7.58,7.5,15.08
"14202",1977,"104",5.81,6,11.81
"14203",1977,"105",6.61,0,6.61
"14204",1977,"106",0,0,0
"14205",1977,"107",1,0,1
"14206",1977,"108",0,0,0
"14207",1977,"109",0,0,0
"14208",1977,"110+",0,0,0
"14209",1978,"0",84005,88266,172271
"14210",1978,"1",85625,90539,176164
"14211",1978,"2",87072,91092,178164
"14212",1978,"3",91449,96082,187531
"14213",1978,"4",96266,100479,196745
"14214",1978,"5",105889,110170,216059
"14215",1978,"6",111642,117447,229089
"14216",1978,"7",117870,123353,241223
"14217",1978,"8",121901,127754,249655
"14218",1978,"9",116863,121760,238623
"14219",1978,"10",116798,122566,239364
"14220",1978,"11",117781,122973,240754
"14221",1978,"12",120162,126201,246363
"14222",1978,"13",123040,129286,252326
"14223",1978,"14",122082,128087,250169
"14224",1978,"15",120594,125787,246381
"14225",1978,"16",121232,126230,247462
"14226",1978,"17",117175,122705,239880
"14227",1978,"18",118902,123765,242667
"14228",1978,"19",116278,121126,237404
"14229",1978,"20",115499,119900,235399
"14230",1978,"21",113963,118747,232710
"14231",1978,"22",113455,116664,230119
"14232",1978,"23",112114,116942,229056
"14233",1978,"24",111849,116507,228356
"14234",1978,"25",112417,117983,230400
"14235",1978,"26",109747,115495,225242
"14236",1978,"27",110330,116646,226976
"14237",1978,"28",112624,119810,232434
"14238",1978,"29",116389,124833,241222
"14239",1978,"30",124011,132114,256125
"14240",1978,"31",127678,137482,265160
"14241",1978,"32",92113,99327,191440
"14242",1978,"33",96975,104453,201428
"14243",1978,"34",92235,99944,192179
"14244",1978,"35",84677,92727,177404
"14245",1978,"36",81420,88822,170242
"14246",1978,"37",83698,91024,174722
"14247",1978,"38",81945,87517,169462
"14248",1978,"39",80310,86455,166765
"14249",1978,"40",76346,81659,158005
"14250",1978,"41",76332,81153,157485
"14251",1978,"42",75294,79371,154665
"14252",1978,"43",75421,78793,154214
"14253",1978,"44",74488,77091,151579
"14254",1978,"45",77227,79094,156321
"14255",1978,"46",76179,77194,153373
"14256",1978,"47",77725,78759,156484
"14257",1978,"48",75220,74581,149801
"14258",1978,"49",75598,74024,149622
"14259",1978,"50",73362,71495,144857
"14260",1978,"51",73924,71197,145121
"14261",1978,"52",74288,70740,145028
"14262",1978,"53",75776,70716,146492
"14263",1978,"54",76849,72266,149115
"14264",1978,"55",74512,69755,144267
"14265",1978,"56",75239,69516,144755
"14266",1978,"57",76062,70364,146426
"14267",1978,"58",63656,58677,122333
"14268",1978,"59",62029,56407,118436
"14269",1978,"60",63302,56976,120278
"14270",1978,"61",63365,56496,119861
"14271",1978,"62",61747,54620,116367
"14272",1978,"63",64604,56515,121119
"14273",1978,"64",63358,54051,117409
"14274",1978,"65",62150,52301,114451
"14275",1978,"66",57819,47519,105338
"14276",1978,"67",57776,46799,104575
"14277",1978,"68",58048,46052,104100
"14278",1978,"69",56033,43416,99449
"14279",1978,"70",53856,41156,95012
"14280",1978,"71",51674,38188,89862
"14281",1978,"72",49973,36211,86184
"14282",1978,"73",47605,34373,81978
"14283",1978,"74",44891,31360,76251
"14284",1978,"75",42728,29458,72186
"14285",1978,"76",39829,26395,66224
"14286",1978,"77",35679,23404,59083
"14287",1978,"78",33330,21354,54684
"14288",1978,"79",30504,19317,49821
"14289",1978,"80",28236.29,17104.85,45341.14
"14290",1978,"81",25502.51,15717.07,41219.58
"14291",1978,"82",22208.3,13401.58,35609.88
"14292",1978,"83",19551.3,11570.84,31122.14
"14293",1978,"84",17376.37,10373.48,27749.85
"14294",1978,"85",13817.35,8449.41,22266.76
"14295",1978,"86",12141.01,7241.01,19382.02
"14296",1978,"87",9537.99,5750.43,15288.42
"14297",1978,"88",7780.45,4779,12559.45
"14298",1978,"89",6278.1,3863,10141.1
"14299",1978,"90",4841.34,2985,7826.34
"14300",1978,"91",3761.29,2203,5964.29
"14301",1978,"92",2713.78,1620,4333.78
"14302",1978,"93",1943.09,1163.63,3106.72
"14303",1978,"94",1429,804.37,2233.37
"14304",1978,"95",967.23,606.62,1573.85
"14305",1978,"96",618.09,353.38,971.47
"14306",1978,"97",379.89,223,602.89
"14307",1978,"98",303.07,160.61,463.68
"14308",1978,"99",161.03,73.39,234.42
"14309",1978,"100",95.67,52,147.67
"14310",1978,"101",68.06,26.89,94.95
"14311",1978,"102",29.15,6.11,35.26
"14312",1978,"103",24.21,6.5,30.71
"14313",1978,"104",5.58,4.5,10.08
"14314",1978,"105",3.81,2,5.81
"14315",1978,"106",2.61,0,2.61
"14316",1978,"107",0,0,0
"14317",1978,"108",0,0,0
"14318",1978,"109",0,0,0
"14319",1978,"110+",0,0,0
"14320",1979,"0",85299,89353,174652
"14321",1979,"1",84426,88541,172967
"14322",1979,"2",85912,90902,176814
"14323",1979,"3",87505,91508,179013
"14324",1979,"4",91856,96450,188306
"14325",1979,"5",96660,100894,197554
"14326",1979,"6",106232,110438,216670
"14327",1979,"7",112023,117662,229685
"14328",1979,"8",118145,123681,241826
"14329",1979,"9",122149,127996,250145
"14330",1979,"10",117175,122107,239282
"14331",1979,"11",117031,122849,239880
"14332",1979,"12",118077,123390,241467
"14333",1979,"13",120409,126546,246955
"14334",1979,"14",123336,129692,253028
"14335",1979,"15",122417,128499,250916
"14336",1979,"16",120923,126139,247062
"14337",1979,"17",121666,126645,248311
"14338",1979,"18",117894,123233,241127
"14339",1979,"19",119593,124282,243875
"14340",1979,"20",116952,121549,238501
"14341",1979,"21",115970,120164,236134
"14342",1979,"22",114586,119199,233785
"14343",1979,"23",113938,117093,231031
"14344",1979,"24",112587,117353,229940
"14345",1979,"25",112055,116929,228984
"14346",1979,"26",112694,118204,230898
"14347",1979,"27",109874,115678,225552
"14348",1979,"28",110483,116784,227267
"14349",1979,"29",112680,119871,232551
"14350",1979,"30",116453,124849,241302
"14351",1979,"31",124116,132065,256181
"14352",1979,"32",127712,137406,265118
"14353",1979,"33",92177,99198,191375
"14354",1979,"34",96998,104283,201281
"14355",1979,"35",92229,99811,192040
"14356",1979,"36",84813,92583,177396
"14357",1979,"37",81449,88744,170193
"14358",1979,"38",83833,90841,174674
"14359",1979,"39",81990,87276,169266
"14360",1979,"40",80396,86197,166593
"14361",1979,"41",76384,81383,157767
"14362",1979,"42",76349,80999,157348
"14363",1979,"43",75262,79121,154383
"14364",1979,"44",75403,78589,153992
"14365",1979,"45",74438,76832,151270
"14366",1979,"46",76982,78596,155578
"14367",1979,"47",76060,76823,152883
"14368",1979,"48",77561,78403,155964
"14369",1979,"49",75001,74212,149213
"14370",1979,"50",75404,73647,149051
"14371",1979,"51",73154,71064,144218
"14372",1979,"52",73727,70711,144438
"14373",1979,"53",73996,70185,144181
"14374",1979,"54",75453,70164,145617
"14375",1979,"55",76493,71618,148111
"14376",1979,"56",74179,69007,143186
"14377",1979,"57",74863,68751,143614
"14378",1979,"58",75632,69459,145091
"14379",1979,"59",63277,57891,121168
"14380",1979,"60",61599,55565,117164
"14381",1979,"61",62840,55991,118831
"14382",1979,"62",62866,55383,118249
"14383",1979,"63",61165,53469,114634
"14384",1979,"64",63938,55144,119082
"14385",1979,"65",62709,52669,115378
"14386",1979,"66",61441,50770,112211
"14387",1979,"67",57086,46012,103098
"14388",1979,"68",56893,45163,102056
"14389",1979,"69",57065,44248,101313
"14390",1979,"70",54986,41587,96573
"14391",1979,"71",52723,39185,91908
"14392",1979,"72",50443,36302,86745
"14393",1979,"73",48633,34192,82825
"14394",1979,"74",46131,32340,78471
"14395",1979,"75",43394,29355,72749
"14396",1979,"76",41145,27387,68532
"14397",1979,"77",38090,24367,62457
"14398",1979,"78",34002,21475,55477
"14399",1979,"79",31505,19488,50993
"14400",1979,"80",28546.49,17432.29,45978.78
"14401",1979,"81",26266.29,15312.85,41579.14
"14402",1979,"82",23572.51,13973.07,37545.58
"14403",1979,"83",20370.3,11792.58,32162.88
"14404",1979,"84",17695.3,10060.84,27756.14
"14405",1979,"85",15496.37,8948.48,24444.85
"14406",1979,"86",12153.35,7191.41,19344.76
"14407",1979,"87",10559.01,6057.01,16616.02
"14408",1979,"88",8138.99,4688.43,12827.42
"14409",1979,"89",6560.45,3877,10437.45
"14410",1979,"90",5193.1,3107,8300.1
"14411",1979,"91",3950.34,2320,6270.34
"14412",1979,"92",3005.29,1666,4671.29
"14413",1979,"93",2067.78,1198,3265.78
"14414",1979,"94",1451.09,850.63,2301.72
"14415",1979,"95",1038,551.37,1589.37
"14416",1979,"96",696.23,404.62,1100.85
"14417",1979,"97",416.09,207.38,623.47
"14418",1979,"98",263.89,147,410.89
"14419",1979,"99",202.07,93.61,295.68
"14420",1979,"100",108.03,47.39,155.42
"14421",1979,"101",60.67,31,91.67
"14422",1979,"102",39.06,17.89,56.95
"14423",1979,"103",13.15,1.11,14.26
"14424",1979,"104",12.21,2.5,14.71
"14425",1979,"105",3.58,2.5,6.08
"14426",1979,"106",1.81,2,3.81
"14427",1979,"107",0.61,0,0.61
"14428",1979,"108",0,0,0
"14429",1979,"109",0,0,0
"14430",1979,"110+",0,0,0
"14431",1980,"0",85213,89230,174443
"14432",1980,"1",85840,89960,175800
"14433",1980,"2",84971,89022,173993
"14434",1980,"3",86362,91361,177723
"14435",1980,"4",88082,92074,180156
"14436",1980,"5",92467,97004,189471
"14437",1980,"6",97213,101429,198642
"14438",1980,"7",106696,110944,217640
"14439",1980,"8",112542,118140,230682
"14440",1980,"9",118649,124217,242866
"14441",1980,"10",122684,128485,251169
"14442",1980,"11",117626,122641,240267
"14443",1980,"12",117498,123335,240833
"14444",1980,"13",118513,123915,242428
"14445",1980,"14",120876,127131,248007
"14446",1980,"15",123884,130327,254211
"14447",1980,"16",122846,129161,252007
"14448",1980,"17",121614,126898,248512
"14449",1980,"18",122409,127451,249860
"14450",1980,"19",118911,124164,243075
"14451",1980,"20",120497,125188,245685
"14452",1980,"21",117788,122315,240103
"14453",1980,"22",116793,120981,237774
"14454",1980,"23",115186,120153,235339
"14455",1980,"24",114515,117822,232337
"14456",1980,"25",113205,118074,231279
"14457",1980,"26",112460,117475,229935
"14458",1980,"27",113011,118679,231690
"14459",1980,"28",110128,115986,226114
"14460",1980,"29",110771,117067,227838
"14461",1980,"30",112827,120050,232877
"14462",1980,"31",116625,125079,241704
"14463",1980,"32",124254,132109,256363
"14464",1980,"33",127805,137418,265223
"14465",1980,"34",92306,99251,191557
"14466",1980,"35",97143,104218,201361
"14467",1980,"36",92348,99757,192105
"14468",1980,"37",84951,92461,177412
"14469",1980,"38",81615,88615,170230
"14470",1980,"39",83995,90658,174653
"14471",1980,"40",82106,87149,169255
"14472",1980,"41",80482,86061,166543
"14473",1980,"42",76448,81203,157651
"14474",1980,"43",76413,80858,157271
"14475",1980,"44",75291,78933,154224
"14476",1980,"45",75376,78360,153736
"14477",1980,"46",74239,76428,150667
"14478",1980,"47",76883,78285,155168
"14479",1980,"48",75928,76489,152417
"14480",1980,"49",77394,78015,155409
"14481",1980,"50",74853,73832,148685
"14482",1980,"51",75216,73259,148475
"14483",1980,"52",72949,70617,143566
"14484",1980,"53",73496,70246,143742
"14485",1980,"54",73734,69616,143350
"14486",1980,"55",75103,69565,144668
"14487",1980,"56",76171,70941,147112
"14488",1980,"57",73808,68265,142073
"14489",1980,"58",74406,67873,142279
"14490",1980,"59",75141,68543,143684
"14491",1980,"60",62867,57048,119915
"14492",1980,"61",61160,54586,115746
"14493",1980,"62",62361,54996,117357
"14494",1980,"63",62310,54185,116495
"14495",1980,"64",60564,52274,112838
"14496",1980,"65",63245,53722,116967
"14497",1980,"66",61954,51203,113157
"14498",1980,"67",60607,49181,109788
"14499",1980,"68",56301,44494,100795
"14500",1980,"69",55996,43576,99572
"14501",1980,"70",56049,42468,98517
"14502",1980,"71",53790,39703,93493
"14503",1980,"72",51546,37180,88726
"14504",1980,"73",49162,34295,83457
"14505",1980,"74",47225,32209,79434
"14506",1980,"75",44676,30293,74969
"14507",1980,"76",41804,27395,69199
"14508",1980,"77",39440,25343,64783
"14509",1980,"78",36326,22414,58740
"14510",1980,"79",32244,19606,51850
"14511",1980,"80",29624.58,17670.37,47294.95
"14512",1980,"81",26716.49,15618.29,42334.78
"14513",1980,"82",24311.29,13657.85,37969.14
"14514",1980,"83",21636.51,12317.07,33953.58
"14515",1980,"84",18507.3,10364.58,28871.88
"14516",1980,"85",15934.3,8686.84,24621.14
"14517",1980,"86",13717.37,7653.48,21370.85
"14518",1980,"87",10690.35,6101.41,16791.76
"14519",1980,"88",9070.01,5048.01,14118.02
"14520",1980,"89",6918.99,3867.43,10786.42
"14521",1980,"90",5500.45,3100,8600.45
"14522",1980,"91",4233.1,2429,6662.1
"14523",1980,"92",3157.34,1800,4957.34
"14524",1980,"93",2337.29,1229,3566.29
"14525",1980,"94",1603.78,875,2478.78
"14526",1980,"95",1068.09,622.63,1690.72
"14527",1980,"96",760,374.37,1134.37
"14528",1980,"97",495.23,272.62,767.85
"14529",1980,"98",308.09,141.38,449.47
"14530",1980,"99",181.89,98,279.89
"14531",1980,"100",124.07,60.61,184.68
"14532",1980,"101",67.03,29.39,96.42
"14533",1980,"102",42.67,19,61.67
"14534",1980,"103",20.06,9.89,29.95
"14535",1980,"104",7.15,0.11,7.26
"14536",1980,"105",3.21,1.5,4.71
"14537",1980,"106",1.58,0.5,2.08
"14538",1980,"107",1.81,2,3.81
"14539",1980,"108",0.61,0,0.61
"14540",1980,"109",0,0,0
"14541",1980,"110+",0,0,0
"14542",1981,"0",88241,92660,180901
"14543",1981,"1",85860,89832,175692
"14544",1981,"2",86510,90640,177150
"14545",1981,"3",85537,89605,175142
"14546",1981,"4",86980,91966,178946
"14547",1981,"5",88643,92646,181289
"14548",1981,"6",93059,97575,190634
"14549",1981,"7",97850,102003,199853
"14550",1981,"8",107377,111480,218857
"14551",1981,"9",113117,118821,231938
"14552",1981,"10",119235,124886,244121
"14553",1981,"11",123307,129210,252517
"14554",1981,"12",118197,123310,241507
"14555",1981,"13",117988,123901,241889
"14556",1981,"14",119119,124668,243787
"14557",1981,"15",121565,127966,249531
"14558",1981,"16",124577,131152,255729
"14559",1981,"17",123757,130071,253828
"14560",1981,"18",122640,127923,250563
"14561",1981,"19",123447,128477,251924
"14562",1981,"20",120186,125238,245424
"14563",1981,"21",121404,126078,247482
"14564",1981,"22",118630,123119,241749
"14565",1981,"23",117440,121879,239319
"14566",1981,"24",115911,120904,236815
"14567",1981,"25",115129,118617,233746
"14568",1981,"26",113618,118754,232372
"14569",1981,"27",112852,117909,230761
"14570",1981,"28",113392,119042,232434
"14571",1981,"29",110374,116252,226626
"14572",1981,"30",110997,117329,228326
"14573",1981,"31",113061,120066,233127
"14574",1981,"32",116769,125135,241904
"14575",1981,"33",124448,132081,256529
"14576",1981,"34",127957,137371,265328
"14577",1981,"35",92507,99320,191827
"14578",1981,"36",97305,104126,201431
"14579",1981,"37",92454,99700,192154
"14580",1981,"38",85143,92428,177571
"14581",1981,"39",81737,88507,170244
"14582",1981,"40",84195,90538,174733
"14583",1981,"41",82283,87058,169341
"14584",1981,"42",80628,85933,166561
"14585",1981,"43",76472,80995,157467
"14586",1981,"44",76476,80678,157154
"14587",1981,"45",75335,78740,154075
"14588",1981,"46",75191,77852,153043
"14589",1981,"47",74203,76117,150320
"14590",1981,"48",76831,77921,154752
"14591",1981,"49",75837,76130,151967
"14592",1981,"50",77276,77671,154947
"14593",1981,"51",74679,73419,148098
"14594",1981,"52",75083,72781,147864
"14595",1981,"53",72691,70122,142813
"14596",1981,"54",73303,69777,143080
"14597",1981,"55",73467,68976,142443
"14598",1981,"56",74795,68858,143653
"14599",1981,"57",75811,70200,146011
"14600",1981,"58",73447,67423,140870
"14601",1981,"59",74024,67037,141061
"14602",1981,"60",74688,67512,142200
"14603",1981,"61",62456,56119,118575
"14604",1981,"62",60690,53580,114270
"14605",1981,"63",61845,53848,115693
"14606",1981,"64",61701,52920,114621
"14607",1981,"65",59992,50968,110960
"14608",1981,"66",62562,52256,114818
"14609",1981,"67",61127,49647,110774
"14610",1981,"68",59760,47487,107247
"14611",1981,"69",55426,42880,98306
"14612",1981,"70",55015,41863,96878
"14613",1981,"71",54974,40595,95569
"14614",1981,"72",52587,37826,90413
"14615",1981,"73",50213,35163,85376
"14616",1981,"74",47789,32236,80025
"14617",1981,"75",45808,30189,75997
"14618",1981,"76",43067,28199,71266
"14619",1981,"77",40079,25302,65381
"14620",1981,"78",37585,23351,60936
"14621",1981,"79",34500,20470,54970
"14622",1981,"80",30405.65,17756.18,48161.83
"14623",1981,"81",27645.58,15918.37,43563.95
"14624",1981,"82",24814.49,13895.29,38709.78
"14625",1981,"83",22377.29,12104.85,34482.14
"14626",1981,"84",19693.51,10728.07,30421.58
"14627",1981,"85",16632.3,8967.58,25599.88
"14628",1981,"86",14176.3,7391.84,21568.14
"14629",1981,"87",12038.37,6447.48,18485.85
"14630",1981,"88",9248.35,5025.41,14273.76
"14631",1981,"89",7730.01,4109.01,11839.02
"14632",1981,"90",5839.99,3072.43,8912.42
"14633",1981,"91",4498.45,2467,6965.45
"14634",1981,"92",3397.1,1842,5239.1
"14635",1981,"93",2533.34,1354,3887.34
"14636",1981,"94",1792.29,916,2708.29
"14637",1981,"95",1202.78,627,1829.78
"14638",1981,"96",776.09,438.63,1214.72
"14639",1981,"97",534,263.37,797.37
"14640",1981,"98",326.23,174.62,500.85
"14641",1981,"99",204.09,91.38,295.47
"14642",1981,"100",121.89,57,178.89
"14643",1981,"101",73.07,36.61,109.68
"14644",1981,"102",42.03,19.39,61.42
"14645",1981,"103",23.67,11,34.67
"14646",1981,"104",12.06,3.89,15.95
"14647",1981,"105",3.15,0.11,3.26
"14648",1981,"106",2.21,0.5,2.71
"14649",1981,"107",0.58,0.5,1.08
"14650",1981,"108",0.42,0,0.42
"14651",1981,"109",0,0,0
"14652",1981,"110+",0,0,0
"14653",1982,"0",87239,90637,177876
"14654",1982,"1",88489,92861,181350
"14655",1982,"2",86046,90044,176090
"14656",1982,"3",86644,90715,177359
"14657",1982,"4",85686,89789,175475
"14658",1982,"5",87145,92104,179249
"14659",1982,"6",88818,92841,181659
"14660",1982,"7",93174,97747,190921
"14661",1982,"8",97917,102115,200032
"14662",1982,"9",107598,111642,219240
"14663",1982,"10",113327,119049,232376
"14664",1982,"11",119462,125136,244598
"14665",1982,"12",123607,129490,253097
"14666",1982,"13",118394,123567,241961
"14667",1982,"14",118188,124066,242254
"14668",1982,"15",119382,125016,244398
"14669",1982,"16",121819,128252,250071
"14670",1982,"17",125031,131605,256636
"14671",1982,"18",124229,130432,254661
"14672",1982,"19",123192,128291,251483
"14673",1982,"20",123963,128781,252744
"14674",1982,"21",120626,125376,246002
"14675",1982,"22",121664,126298,247962
"14676",1982,"23",118831,123335,242166
"14677",1982,"24",117685,122149,239834
"14678",1982,"25",116069,121129,237198
"14679",1982,"26",115152,118740,233892
"14680",1982,"27",113620,118803,232423
"14681",1982,"28",112879,117893,230772
"14682",1982,"29",113393,118942,232335
"14683",1982,"30",110235,116099,226334
"14684",1982,"31",110942,117160,228102
"14685",1982,"32",113008,119823,232831
"14686",1982,"33",116725,124839,241564
"14687",1982,"34",124314,131730,256044
"14688",1982,"35",127945,137080,265025
"14689",1982,"36",92495,99130,191625
"14690",1982,"37",97288,103941,201229
"14691",1982,"38",92474,99449,191923
"14692",1982,"39",85159,92176,177335
"14693",1982,"40",81729,88247,169976
"14694",1982,"41",84179,90295,174474
"14695",1982,"42",82266,86749,169015
"14696",1982,"43",80582,85664,166246
"14697",1982,"44",76440,80726,157166
"14698",1982,"45",76412,80366,156778
"14699",1982,"46",75044,78319,153363
"14700",1982,"47",75067,77451,152518
"14701",1982,"48",74049,75728,149777
"14702",1982,"49",76659,77537,154196
"14703",1982,"50",75613,75636,151249
"14704",1982,"51",77059,77145,154204
"14705",1982,"52",74415,72924,147339
"14706",1982,"53",74821,72268,147089
"14707",1982,"54",72407,69592,141999
"14708",1982,"55",73001,69161,142162
"14709",1982,"56",73164,68319,141483
"14710",1982,"57",74392,68108,142500
"14711",1982,"58",75402,69309,144711
"14712",1982,"59",73038,66459,139497
"14713",1982,"60",73538,66044,139582
"14714",1982,"61",74177,66409,140586
"14715",1982,"62",61932,55107,117039
"14716",1982,"63",60143,52435,112578
"14717",1982,"64",61264,52651,113915
"14718",1982,"65",61039,51605,112644
"14719",1982,"66",59293,49557,108850
"14720",1982,"67",61728,50619,112347
"14721",1982,"68",60206,48054,108260
"14722",1982,"69",58828,45714,104542
"14723",1982,"70",54476,41154,95630
"14724",1982,"71",53962,39997,93959
"14725",1982,"72",53791,38600,92391
"14726",1982,"73",51290,35859,87149
"14727",1982,"74",48814,33184,81998
"14728",1982,"75",46293,30125,76418
"14729",1982,"76",44112,28126,72238
"14730",1982,"77",41355,26126,67481
"14731",1982,"78",38355,23274,61629
"14732",1982,"79",35674,21270,56944
"14733",1982,"80",32394.23,18577.44,50971.67
"14734",1982,"81",28454.65,15950.18,44404.83
"14735",1982,"82",25771.58,14147.37,39918.95
"14736",1982,"83",22876.49,12228.29,35104.78
"14737",1982,"84",20428.29,10551.85,30980.14
"14738",1982,"85",17743.51,9267.07,27010.58
"14739",1982,"86",14754.3,7630.58,22384.88
"14740",1982,"87",12418.3,6153.84,18572.14
"14741",1982,"88",10453.37,5361.48,15814.85
"14742",1982,"89",7841.35,4103.41,11944.76
"14743",1982,"90",6479.01,3313.01,9792.02
"14744",1982,"91",4777.99,2403.43,7181.42
"14745",1982,"92",3585.45,1917,5502.45
"14746",1982,"93",2725.1,1381,4106.1
"14747",1982,"94",1945.34,1008,2953.34
"14748",1982,"95",1348.29,657,2005.29
"14749",1982,"96",878.78,443,1321.78
"14750",1982,"97",551.09,272.63,823.72
"14751",1982,"98",355,154.37,509.37
"14752",1982,"99",223.23,111.62,334.85
"14753",1982,"100",129.09,54.38,183.47
"14754",1982,"101",75.89,35,110.89
"14755",1982,"102",44.07,24.61,68.68
"14756",1982,"103",25.03,7.39,32.42
"14757",1982,"104",14.67,4,18.67
"14758",1982,"105",7.06,3.89,10.95
"14759",1982,"106",2.15,0.11,2.26
"14760",1982,"107",2.21,0.5,2.71
"14761",1982,"108",0,0.5,0.5
"14762",1982,"109",0,0,0
"14763",1982,"110+",0,0,0
"14764",1983,"0",83464,87527,170991
"14765",1983,"1",87312,90576,177888
"14766",1983,"2",88468,92829,181297
"14767",1983,"3",86050,89984,176034
"14768",1983,"4",86537,90747,177284
"14769",1983,"5",85809,89721,175530
"14770",1983,"6",87124,92138,179262
"14771",1983,"7",88791,92776,181567
"14772",1983,"8",93137,97684,190821
"14773",1983,"9",98138,102134,200272
"14774",1983,"10",107685,111627,219312
"14775",1983,"11",113676,119328,233004
"14776",1983,"12",119476,125118,244594
"14777",1983,"13",123596,129609,253205
"14778",1983,"14",118467,123590,242057
"14779",1983,"15",118246,124152,242398
"14780",1983,"16",119448,125096,244544
"14781",1983,"17",122055,128307,250362
"14782",1983,"18",125303,131659,256962
"14783",1983,"19",124770,130606,255376
"14784",1983,"20",123807,128567,252374
"14785",1983,"21",124300,128858,253158
"14786",1983,"22",121006,125515,246521
"14787",1983,"23",121791,126240,248031
"14788",1983,"24",119036,123318,242354
"14789",1983,"25",117806,121969,239775
"14790",1983,"26",116193,121177,237370
"14791",1983,"27",115012,118465,233477
"14792",1983,"28",113667,118757,232424
"14793",1983,"29",112686,117660,230346
"14794",1983,"30",113166,118732,231898
"14795",1983,"31",109833,115749,225582
"14796",1983,"32",110936,116959,227895
"14797",1983,"33",112785,119514,232299
"14798",1983,"34",116733,124585,241318
"14799",1983,"35",123992,130912,254904
"14800",1983,"36",127601,136524,264125
"14801",1983,"37",92379,98727,191106
"14802",1983,"38",97141,103648,200789
"14803",1983,"39",92147,98883,191030
"14804",1983,"40",85137,91836,176973
"14805",1983,"41",81586,87726,169312
"14806",1983,"42",84161,89891,174052
"14807",1983,"43",81997,86277,168274
"14808",1983,"44",80447,85359,165806
"14809",1983,"45",76345,80264,156609
"14810",1983,"46",76241,80038,156279
"14811",1983,"47",74999,78063,153062
"14812",1983,"48",75124,77390,152514
"14813",1983,"49",74099,75542,149641
"14814",1983,"50",76614,77339,153953
"14815",1983,"51",75475,75254,150729
"14816",1983,"52",76901,76780,153681
"14817",1983,"53",74192,72523,146715
"14818",1983,"54",74540,71806,146346
"14819",1983,"55",72091,69018,141109
"14820",1983,"56",72802,68565,141367
"14821",1983,"57",72761,67507,140268
"14822",1983,"58",73932,67423,141355
"14823",1983,"59",74928,68303,143231
"14824",1983,"60",72532,65479,138011
"14825",1983,"61",72940,64905,137845
"14826",1983,"62",73576,65037,138613
"14827",1983,"63",61439,53860,115299
"14828",1983,"64",59546,51311,110857
"14829",1983,"65",60604,51301,111905
"14830",1983,"66",60324,50221,110545
"14831",1983,"67",58547,48033,106580
"14832",1983,"68",60850,48935,109785
"14833",1983,"69",59246,46294,105540
"14834",1983,"70",57801,43940,101741
"14835",1983,"71",53367,39367,92734
"14836",1983,"72",52837,38093,90930
"14837",1983,"73",52439,36532,88971
"14838",1983,"74",49921,33773,83694
"14839",1983,"75",47314,31159,78473
"14840",1983,"76",44696,28070,72766
"14841",1983,"77",42263,25899,68162
"14842",1983,"78",39557,24032,63589
"14843",1983,"79",36429,21265,57694
"14844",1983,"80",33636.32,19263.52,52899.84
"14845",1983,"81",30450.23,16743.44,47193.67
"14846",1983,"82",26448.65,14182.18,40630.83
"14847",1983,"83",23771.58,12493.37,36264.95
"14848",1983,"84",20788.49,10645.29,31433.78
"14849",1983,"85",18394.29,9133.85,27528.14
"14850",1983,"86",15794.51,7841.07,23635.58
"14851",1983,"87",12935.3,6412.58,19347.88
"14852",1983,"88",10756.3,5046.84,15803.14
"14853",1983,"89",8884.37,4372.48,13256.85
"14854",1983,"90",6533.35,3268.41,9801.76
"14855",1983,"91",5355.01,2599.01,7954.02
"14856",1983,"92",3879.99,1860.43,5740.42
"14857",1983,"93",2821.45,1422,4243.45
"14858",1983,"94",2114.1,997,3111.1
"14859",1983,"95",1465.34,720,2185.34
"14860",1983,"96",967.29,461,1428.29
"14861",1983,"97",597.78,306,903.78
"14862",1983,"98",383.09,189.63,572.72
"14863",1983,"99",243,91.37,334.37
"14864",1983,"100",149.23,75.62,224.85
"14865",1983,"101",77.09,33.38,110.47
"14866",1983,"102",41.89,14,55.89
"14867",1983,"103",26.07,14.61,40.68
"14868",1983,"104",18.03,5.39,23.42
"14869",1983,"105",5.67,1,6.67
"14870",1983,"106",3.06,1.89,4.95
"14871",1983,"107",1.15,0.11,1.26
"14872",1983,"108",1.21,0,1.21
"14873",1983,"109",0,0,0
"14874",1983,"110+",0,0,0
"14875",1984,"0",82891,86584,169475
"14876",1984,"1",83589,87546,171135
"14877",1984,"2",87374,90638,178012
"14878",1984,"3",88522,92814,181336
"14879",1984,"4",86052,90007,176059
"14880",1984,"5",86484,90800,177284
"14881",1984,"6",85691,89688,175379
"14882",1984,"7",87091,92004,179095
"14883",1984,"8",88718,92716,181434
"14884",1984,"9",93101,97595,190696
"14885",1984,"10",98091,102064,200155
"14886",1984,"11",107635,111586,219221
"14887",1984,"12",113664,119349,233013
"14888",1984,"13",119439,125135,244574
"14889",1984,"14",123583,129576,253159
"14890",1984,"15",118473,123546,242019
"14891",1984,"16",118285,124156,242441
"14892",1984,"17",119716,125144,244860
"14893",1984,"18",122369,128348,250717
"14894",1984,"19",125680,131806,257486
"14895",1984,"20",125137,130639,255776
"14896",1984,"21",124143,128568,252711
"14897",1984,"22",124605,128889,253494
"14898",1984,"23",121104,125564,246668
"14899",1984,"24",121942,126239,248181
"14900",1984,"25",119202,123382,242584
"14901",1984,"26",117799,121833,239632
"14902",1984,"27",116333,121073,237406
"14903",1984,"28",115029,118242,233271
"14904",1984,"29",113604,118519,232123
"14905",1984,"30",112677,117439,230116
"14906",1984,"31",113164,118590,231754
"14907",1984,"32",109840,115573,225413
"14908",1984,"33",110839,116686,227525
"14909",1984,"34",112690,119213,231903
"14910",1984,"35",116612,124275,240887
"14911",1984,"36",123885,130574,254459
"14912",1984,"37",127615,136282,263897
"14913",1984,"38",92345,98474,190819
"14914",1984,"39",97071,103347,200418
"14915",1984,"40",92037,98545,190582
"14916",1984,"41",85095,91559,176654
"14917",1984,"42",81458,87446,168904
"14918",1984,"43",84104,89615,173719
"14919",1984,"44",81855,86017,167872
"14920",1984,"45",80330,84995,165325
"14921",1984,"46",76196,79866,156062
"14922",1984,"47",76050,79669,155719
"14923",1984,"48",74827,77666,152493
"14924",1984,"49",74904,76960,151864
"14925",1984,"50",73867,75113,148980
"14926",1984,"51",76377,76936,153313
"14927",1984,"52",75213,74761,149974
"14928",1984,"53",76623,76224,152847
"14929",1984,"54",73854,71915,145769
"14930",1984,"55",74234,71109,145343
"14931",1984,"56",71796,68391,140187
"14932",1984,"57",72393,67835,140228
"14933",1984,"58",72305,66724,139029
"14934",1984,"59",73501,66505,140006
"14935",1984,"60",74467,67345,141812
"14936",1984,"61",71976,64464,136440
"14937",1984,"62",72380,63741,136121
"14938",1984,"63",72945,63760,136705
"14939",1984,"64",60886,52710,113596
"14940",1984,"65",58943,50067,109010
"14941",1984,"66",59894,49916,109810
"14942",1984,"67",59593,48706,108299
"14943",1984,"68",57754,46467,104221
"14944",1984,"69",59926,47227,107153
"14945",1984,"70",58275,44420,102695
"14946",1984,"71",56743,42126,98869
"14947",1984,"72",52309,37490,89799
"14948",1984,"73",51570,36130,87700
"14949",1984,"74",51098,34414,85512
"14950",1984,"75",48480,31666,80146
"14951",1984,"76",45700,28963,74663
"14952",1984,"77",43050,25960,69010
"14953",1984,"78",40546,23870,64416
"14954",1984,"79",37622,21892,59514
"14955",1984,"80",34353.58,19207.31,53560.89
"14956",1984,"81",31618.32,17290.52,48908.84
"14957",1984,"82",28373.23,14958.44,43331.67
"14958",1984,"83",24463.65,12524.18,36987.83
"14959",1984,"84",21669.58,10900.37,32569.95
"14960",1984,"85",18816.49,9145.29,27961.78
"14961",1984,"86",16379.29,7739.85,24119.14
"14962",1984,"87",13894.51,6561.07,20455.58
"14963",1984,"88",11307.3,5310.58,16617.88
"14964",1984,"89",9146.3,4080.84,13227.14
"14965",1984,"90",7445.37,3520.48,10965.85
"14966",1984,"91",5411.35,2597.41,8008.76
"14967",1984,"92",4316.01,2034.01,6350.02
"14968",1984,"93",3031.99,1388.43,4420.42
"14969",1984,"94",2153.45,1027,3180.45
"14970",1984,"95",1592.1,704,2296.1
"14971",1984,"96",1086.34,478,1564.34
"14972",1984,"97",687.29,306,993.29
"14973",1984,"98",411.78,206,617.78
"14974",1984,"99",277.09,116.63,393.72
"14975",1984,"100",155,53.37,208.37
"14976",1984,"101",103.23,45.62,148.85
"14977",1984,"102",44.09,22.38,66.47
"14978",1984,"103",20.89,11,31.89
"14979",1984,"104",13.07,8.61,21.68
"14980",1984,"105",8.03,3.39,11.42
"14981",1984,"106",2.67,1,3.67
"14982",1984,"107",2.06,0.89,2.95
"14983",1984,"108",0.36,0.11,0.47
"14984",1984,"109",0,0,0
"14985",1984,"110+",0,0,0
"14986",1985,"0",84683,88979,173662
"14987",1985,"1",83028,86652,169680
"14988",1985,"2",83730,87593,171323
"14989",1985,"3",87388,90714,178102
"14990",1985,"4",88475,92801,181276
"14991",1985,"5",86140,90009,176149
"14992",1985,"6",86434,90719,177153
"14993",1985,"7",85670,89599,175269
"14994",1985,"8",87025,91933,178958
"14995",1985,"9",88629,92636,181265
"14996",1985,"10",93081,97602,190683
"14997",1985,"11",97998,102055,200053
"14998",1985,"12",107673,111587,219260
"14999",1985,"13",113606,119254,232860
"15000",1985,"14",119423,125091,244514
"15001",1985,"15",123559,129584,253143
"15002",1985,"16",118513,123571,242084
"15003",1985,"17",118472,124214,242686
"15004",1985,"18",119914,125243,245157
"15005",1985,"19",122714,128515,251229
"15006",1985,"20",126021,131912,257933
"15007",1985,"21",125477,130631,256108
"15008",1985,"22",124396,128674,253070
"15009",1985,"23",124788,128991,253779
"15010",1985,"24",121334,125659,246993
"15011",1985,"25",122114,126343,248457
"15012",1985,"26",119385,123363,242748
"15013",1985,"27",117829,121789,239618
"15014",1985,"28",116354,121018,237372
"15015",1985,"29",115084,118223,233307
"15016",1985,"30",113630,118381,232011
"15017",1985,"31",112706,117366,230072
"15018",1985,"32",113082,118486,231568
"15019",1985,"33",109695,115439,225134
"15020",1985,"34",110741,116491,227232
"15021",1985,"35",112687,119097,231784
"15022",1985,"36",116518,124034,240552
"15023",1985,"37",123800,130365,254165
"15024",1985,"38",127529,136003,263532
"15025",1985,"39",92293,98228,190521
"15026",1985,"40",97002,103115,200117
"15027",1985,"41",91965,98337,190302
"15028",1985,"42",84960,91263,176223
"15029",1985,"43",81344,87126,168470
"15030",1985,"44",84000,89288,173288
"15031",1985,"45",81718,85689,167407
"15032",1985,"46",80143,84563,164706
"15033",1985,"47",76021,79454,155475
"15034",1985,"48",75848,79288,155136
"15035",1985,"49",74648,77240,151888
"15036",1985,"50",74729,76507,151236
"15037",1985,"51",73614,74686,148300
"15038",1985,"52",76120,76389,152509
"15039",1985,"53",74950,74237,149187
"15040",1985,"54",76313,75592,151905
"15041",1985,"55",73479,71324,144803
"15042",1985,"56",73873,70407,144280
"15043",1985,"57",71462,67653,139115
"15044",1985,"58",71975,67059,139034
"15045",1985,"59",71884,65916,137800
"15046",1985,"60",73024,65496,138520
"15047",1985,"61",73915,66306,140221
"15048",1985,"62",71451,63329,134780
"15049",1985,"63",71752,62539,134291
"15050",1985,"64",72270,62362,134632
"15051",1985,"65",60252,51502,111754
"15052",1985,"66",58203,48645,106848
"15053",1985,"67",59152,48502,107654
"15054",1985,"68",58752,47148,105900
"15055",1985,"69",56917,44796,101713
"15056",1985,"70",58949,45367,104316
"15057",1985,"71",57154,42551,99705
"15058",1985,"72",55551,40132,95683
"15059",1985,"73",51097,35573,86670
"15060",1985,"74",50248,34093,84341
"15061",1985,"75",49600,32218,81818
"15062",1985,"76",46794,29474,76268
"15063",1985,"77",44034,26881,70915
"15064",1985,"78",41179,23916,65095
"15065",1985,"79",38555,21803,60358
"15066",1985,"80",35449.89,19780.98,55230.87
"15067",1985,"81",32271.58,17214.31,49485.89
"15068",1985,"82",29469.32,15454.52,44923.84
"15069",1985,"83",26224.23,13213.44,39437.67
"15070",1985,"84",22344.65,10881.18,33225.83
"15071",1985,"85",19586.58,9367.37,28953.95
"15072",1985,"86",16864.49,7777.29,24641.78
"15073",1985,"87",14432.29,6492.85,20925.14
"15074",1985,"88",12085.51,5437.07,17522.58
"15075",1985,"89",9653.3,4324.58,13977.88
"15076",1985,"90",7713.3,3281.84,10995.14
"15077",1985,"91",6154.37,2773.48,8927.85
"15078",1985,"92",4368.35,1983.41,6351.76
"15079",1985,"93",3391.01,1560.01,4951.02
"15080",1985,"94",2365.99,1000.43,3366.42
"15081",1985,"95",1590.45,706,2296.45
"15082",1985,"96",1180.1,500,1680.1
"15083",1985,"97",757.34,329,1086.34
"15084",1985,"98",460.29,216,676.29
"15085",1985,"99",285.78,123,408.78
"15086",1985,"100",181.09,69.63,250.72
"15087",1985,"101",112,33.37,145.37
"15088",1985,"102",61.23,31.62,92.85
"15089",1985,"103",27.09,16.38,43.47
"15090",1985,"104",13.89,4,17.89
"15091",1985,"105",9.07,2.61,11.68
"15092",1985,"106",6.03,2.39,8.42
"15093",1985,"107",1.67,0,1.67
"15094",1985,"108",0.42,0,0.42
"15095",1985,"109",0,0,0
"15096",1985,"110+",0,0,0
"15097",1986,"0",86998,90581,177579
"15098",1986,"1",85094,89342,174436
"15099",1986,"2",83342,86963,170305
"15100",1986,"3",83994,87887,171881
"15101",1986,"4",87546,90872,178418
"15102",1986,"5",88601,93028,181629
"15103",1986,"6",86279,90165,176444
"15104",1986,"7",86602,90783,177385
"15105",1986,"8",85767,89715,175482
"15106",1986,"9",87160,92029,179189
"15107",1986,"10",88731,92742,181473
"15108",1986,"11",93218,97768,190986
"15109",1986,"12",98100,102240,200340
"15110",1986,"13",107766,111718,219484
"15111",1986,"14",113765,119437,233202
"15112",1986,"15",119580,125283,244863
"15113",1986,"16",123791,129762,253553
"15114",1986,"17",118846,123734,242580
"15115",1986,"18",118850,124462,243312
"15116",1986,"19",120496,125593,246089
"15117",1986,"20",123331,128816,252147
"15118",1986,"21",126529,132078,258607
"15119",1986,"22",125847,130946,256793
"15120",1986,"23",124843,129099,253942
"15121",1986,"24",125035,129513,254548
"15122",1986,"25",121565,126590,248155
"15123",1986,"26",122330,126801,249131
"15124",1986,"27",119571,123772,243343
"15125",1986,"28",117978,122171,240149
"15126",1986,"29",116537,121226,237763
"15127",1986,"30",115162,118437,233599
"15128",1986,"31",113677,118513,232190
"15129",1986,"32",112730,117456,230186
"15130",1986,"33",113145,118503,231648
"15131",1986,"34",109754,115371,225125
"15132",1986,"35",110743,116440,227183
"15133",1986,"36",112675,118925,231600
"15134",1986,"37",116587,123844,240431
"15135",1986,"38",123753,130227,253980
"15136",1986,"39",127501,135834,263335
"15137",1986,"40",92272,98032,190304
"15138",1986,"41",96902,102925,199827
"15139",1986,"42",91850,98089,189939
"15140",1986,"43",84903,91027,175930
"15141",1986,"44",81316,86842,168158
"15142",1986,"45",83884,88968,172852
"15143",1986,"46",81631,85348,166979
"15144",1986,"47",80018,84210,164228
"15145",1986,"48",75926,79087,155013
"15146",1986,"49",75660,78883,154543
"15147",1986,"50",74499,76846,151345
"15148",1986,"51",74516,76062,150578
"15149",1986,"52",73373,74212,147585
"15150",1986,"53",75786,75837,151623
"15151",1986,"54",74633,73655,148288
"15152",1986,"55",75975,74865,150840
"15153",1986,"56",73174,70645,143819
"15154",1986,"57",73513,69627,143140
"15155",1986,"58",71061,66855,137916
"15156",1986,"59",71577,66205,137782
"15157",1986,"60",71467,64898,136365
"15158",1986,"61",72464,64496,136960
"15159",1986,"62",73350,65164,138514
"15160",1986,"63",70862,62101,132963
"15161",1986,"64",71125,61141,132266
"15162",1986,"65",71589,60808,132397
"15163",1986,"66",59525,50122,109647
"15164",1986,"67",57498,47182,104680
"15165",1986,"68",58338,46889,105227
"15166",1986,"69",57898,45462,103360
"15167",1986,"70",55954,43094,99048
"15168",1986,"71",57817,43421,101238
"15169",1986,"72",55961,40635,96596
"15170",1986,"73",54194,38119,92313
"15171",1986,"74",49802,33591,83393
"15172",1986,"75",48733,31906,80639
"15173",1986,"76",47948,30028,77976
"15174",1986,"77",45030,27283,72313
"15175",1986,"78",42187,24720,66907
"15176",1986,"79",39212,21850,61062
"15177",1986,"80",36518.2,19788.68,56306.88
"15178",1986,"81",33288.89,17740.98,51029.87
"15179",1986,"82",29979.58,15351.31,45330.89
"15180",1986,"83",27167.32,13567.52,40734.84
"15181",1986,"84",23930.23,11501.44,35431.67
"15182",1986,"85",20175.65,9301.18,29476.83
"15183",1986,"86",17494.58,7893.37,25387.95
"15184",1986,"87",14872.49,6506.29,21378.78
"15185",1986,"88",12552.29,5303.85,17856.14
"15186",1986,"89",10342.51,4398.07,14740.58
"15187",1986,"90",8046.3,3404.58,11450.88
"15188",1986,"91",6361.3,2530.84,8892.14
"15189",1986,"92",4961.37,2126.48,7087.85
"15190",1986,"93",3475.35,1529.41,5004.76
"15191",1986,"94",2624.01,1143.01,3767.02
"15192",1986,"95",1782.99,710.43,2493.42
"15193",1986,"96",1204.45,484,1688.45
"15194",1986,"97",832.1,336,1168.1
"15195",1986,"98",525.34,230,755.34
"15196",1986,"99",309.29,140,449.29
"15197",1986,"100",168.78,71,239.78
"15198",1986,"101",124.09,43.63,167.72
"15199",1986,"102",60,23.37,83.37
"15200",1986,"103",33.23,15.62,48.85
"15201",1986,"104",16.09,10.38,26.47
"15202",1986,"105",10.89,3,13.89
"15203",1986,"106",5.07,1.61,6.68
"15204",1986,"107",3.03,0.39,3.42
"15205",1986,"108",1.08,0,1.08
"15206",1986,"109",0,0,0
"15207",1986,"110+",0,0,0
"15208",1987,"0",90212,93263,183475
"15209",1987,"1",87322,90944,178266
"15210",1987,"2",85461,89694,175155
"15211",1987,"3",83645,87275,170920
"15212",1987,"4",84299,88317,172616
"15213",1987,"5",87758,91138,178896
"15214",1987,"6",88824,93254,182078
"15215",1987,"7",86493,90309,176802
"15216",1987,"8",86807,91046,177853
"15217",1987,"9",85963,89981,175944
"15218",1987,"10",87311,92314,179625
"15219",1987,"11",88918,92964,181882
"15220",1987,"12",93496,97913,191409
"15221",1987,"13",98205,102457,200662
"15222",1987,"14",107927,112005,219932
"15223",1987,"15",114087,119738,233825
"15224",1987,"16",120185,125690,245875
"15225",1987,"17",124298,130153,254451
"15226",1987,"18",119612,124176,243788
"15227",1987,"19",119565,125004,244569
"15228",1987,"20",121224,126129,247353
"15229",1987,"21",123967,129272,253239
"15230",1987,"22",127138,132823,259961
"15231",1987,"23",126236,131697,257933
"15232",1987,"24",125113,129777,254890
"15233",1987,"25",125421,129916,255337
"15234",1987,"26",121832,127051,248883
"15235",1987,"27",122461,127123,249584
"15236",1987,"28",119704,123988,243692
"15237",1987,"29",118128,122430,240558
"15238",1987,"30",116579,121425,238004
"15239",1987,"31",115261,118520,233781
"15240",1987,"32",113655,118536,232191
"15241",1987,"33",112757,117419,230176
"15242",1987,"34",113151,118332,231483
"15243",1987,"35",109738,115245,224983
"15244",1987,"36",110690,116379,227069
"15245",1987,"37",112671,118787,231458
"15246",1987,"38",116552,123702,240254
"15247",1987,"39",123832,130230,254062
"15248",1987,"40",127588,135680,263268
"15249",1987,"41",92250,97869,190119
"15250",1987,"42",96996,102747,199743
"15251",1987,"43",91927,98028,189955
"15252",1987,"44",84848,90818,175666
"15253",1987,"45",81323,86552,167875
"15254",1987,"46",83753,88644,172397
"15255",1987,"47",81540,85051,166591
"15256",1987,"48",79935,83806,163741
"15257",1987,"49",75772,78736,154508
"15258",1987,"50",75519,78361,153880
"15259",1987,"51",74380,76438,150818
"15260",1987,"52",74266,75486,149752
"15261",1987,"53",73109,73685,146794
"15262",1987,"54",75464,75168,150632
"15263",1987,"55",74311,73026,147337
"15264",1987,"56",75652,74038,149690
"15265",1987,"57",72851,69851,142702
"15266",1987,"58",73140,68783,141923
"15267",1987,"59",70654,66027,136681
"15268",1987,"60",71106,65206,136312
"15269",1987,"61",70958,63871,134829
"15270",1987,"62",71894,63329,135223
"15271",1987,"63",72797,63910,136707
"15272",1987,"64",70248,60806,131054
"15273",1987,"65",70458,59746,130204
"15274",1987,"66",70771,59273,130044
"15275",1987,"67",58769,48666,107435
"15276",1987,"68",56758,45526,102284
"15277",1987,"69",57586,45193,102779
"15278",1987,"70",56963,43700,100663
"15279",1987,"71",55025,41307,96332
"15280",1987,"72",56605,41426,98031
"15281",1987,"73",54683,38553,93236
"15282",1987,"74",52812,35963,88775
"15283",1987,"75",48377,31508,79885
"15284",1987,"76",47153,29697,76850
"15285",1987,"77",46174,27892,74066
"15286",1987,"78",43153,25085,68238
"15287",1987,"79",40299,22541,62840
"15288",1987,"80",37023.37,19759.07,56782.44
"15289",1987,"81",34326.2,17752.68,52078.88
"15290",1987,"82",30975.89,15774.98,46750.87
"15291",1987,"83",27602.58,13531.31,41133.89
"15292",1987,"84",24780.32,11808.52,36588.84
"15293",1987,"85",21619.23,9827.44,31446.67
"15294",1987,"86",17986.65,7900.18,25886.83
"15295",1987,"87",15412.58,6584.37,21996.95
"15296",1987,"88",12811.49,5337.29,18148.78
"15297",1987,"89",10590.29,4300.85,14891.14
"15298",1987,"90",8629.51,3493.07,12122.58
"15299",1987,"91",6586.3,2640.58,9226.88
"15300",1987,"92",5107.3,1920.84,7028.14
"15301",1987,"93",3869.37,1618.48,5487.85
"15302",1987,"94",2695.35,1126.41,3821.76
"15303",1987,"95",1996.01,772.01,2768.02
"15304",1987,"96",1335.99,496.43,1832.42
"15305",1987,"97",839.45,322,1161.45
"15306",1987,"98",570.1,208,778.1
"15307",1987,"99",355.34,148,503.34
"15308",1987,"100",208.29,75,283.29
"15309",1987,"101",106.78,36,142.78
"15310",1987,"102",77.09,25.63,102.72
"15311",1987,"103",36,15.37,51.37
"15312",1987,"104",14.23,9.62,23.85
"15313",1987,"105",14.09,6.38,20.47
"15314",1987,"106",4.89,2,6.89
"15315",1987,"107",2.07,0.61,2.68
"15316",1987,"108",1.11,0.39,1.5
"15317",1987,"109",0,0,0
"15318",1987,"110+",0,0,0
"15319",1988,"0",90595,95322,185917
"15320",1988,"1",90561,93612,184173
"15321",1988,"2",87676,91318,178994
"15322",1988,"3",85712,90031,175743
"15323",1988,"4",83889,87501,171390
"15324",1988,"5",84561,88588,173149
"15325",1988,"6",87954,91325,179279
"15326",1988,"7",89032,93450,182482
"15327",1988,"8",86705,90549,177254
"15328",1988,"9",87035,91244,178279
"15329",1988,"10",86207,90194,176401
"15330",1988,"11",87597,92552,180149
"15331",1988,"12",89158,93234,182392
"15332",1988,"13",93778,98198,191976
"15333",1988,"14",98392,102738,201130
"15334",1988,"15",108289,112361,220650
"15335",1988,"16",114588,120170,234758
"15336",1988,"17",120762,126141,246903
"15337",1988,"18",125092,130728,255820
"15338",1988,"19",120566,124906,245472
"15339",1988,"20",120420,125569,245989
"15340",1988,"21",122026,126587,248613
"15341",1988,"22",124643,129868,254511
"15342",1988,"23",127760,133737,261497
"15343",1988,"24",126812,132703,259515
"15344",1988,"25",125618,130873,256491
"15345",1988,"26",125846,130887,256733
"15346",1988,"27",122258,128279,250537
"15347",1988,"28",122821,127960,250781
"15348",1988,"29",119945,124695,244640
"15349",1988,"30",118421,122987,241408
"15350",1988,"31",116764,121863,238627
"15351",1988,"32",115446,118844,234290
"15352",1988,"33",113821,118732,232553
"15353",1988,"34",112876,117589,230465
"15354",1988,"35",113217,118413,231630
"15355",1988,"36",109884,115305,225189
"15356",1988,"37",110776,116390,227166
"15357",1988,"38",112751,118734,231485
"15358",1988,"39",116644,123565,240209
"15359",1988,"40",123771,130079,253850
"15360",1988,"41",127600,135439,263039
"15361",1988,"42",92248,97686,189934
"15362",1988,"43",96901,102551,199452
"15363",1988,"44",91866,97740,189606
"15364",1988,"45",84770,90486,175256
"15365",1988,"46",81211,86257,167468
"15366",1988,"47",83652,88313,171965
"15367",1988,"48",81393,84680,166073
"15368",1988,"49",79786,83403,163189
"15369",1988,"50",75647,78307,153954
"15370",1988,"51",75355,77900,153255
"15371",1988,"52",74157,75925,150082
"15372",1988,"53",74041,74957,148998
"15373",1988,"54",72830,73133,145963
"15374",1988,"55",75155,74479,149634
"15375",1988,"56",73971,72298,146269
"15376",1988,"57",75267,73215,148482
"15377",1988,"58",72503,69011,141514
"15378",1988,"59",72743,67898,140641
"15379",1988,"60",70215,65014,135229
"15380",1988,"61",70598,64274,134872
"15381",1988,"62",70425,62851,133276
"15382",1988,"63",71345,62097,133442
"15383",1988,"64",72150,62648,134798
"15384",1988,"65",69569,59464,129033
"15385",1988,"66",69718,58185,127903
"15386",1988,"67",69952,57546,127498
"15387",1988,"68",58018,47164,105182
"15388",1988,"69",55898,43940,99838
"15389",1988,"70",56656,43512,100168
"15390",1988,"71",55949,41854,97803
"15391",1988,"72",53936,39443,93379
"15392",1988,"73",55409,39409,94818
"15393",1988,"74",53299,36595,89894
"15394",1988,"75",51187,33937,85124
"15395",1988,"76",46900,29452,76352
"15396",1988,"77",45477,27576,73053
"15397",1988,"78",44410,25698,70108
"15398",1988,"79",41192,22919,64111
"15399",1988,"80",38187.96,20504.66,58692.62
"15400",1988,"81",34891.37,17864.07,52755.44
"15401",1988,"82",32044.2,15793.68,47837.88
"15402",1988,"83",28814.89,13937.98,42752.87
"15403",1988,"84",25365.58,11777.31,37142.89
"15404",1988,"85",22568.32,10166.52,32734.84
"15405",1988,"86",19419.23,8354.44,27773.67
"15406",1988,"87",15940.65,6610.18,22550.83
"15407",1988,"88",13434.58,5466.37,18900.95
"15408",1988,"89",11008.49,4367.29,15375.78
"15409",1988,"90",8945.29,3494.85,12440.14
"15410",1988,"91",7210.51,2758.07,9968.58
"15411",1988,"92",5316.3,2021.58,7337.88
"15412",1988,"93",4023.3,1432.84,5456.14
"15413",1988,"94",3015.37,1178.48,4193.85
"15414",1988,"95",2075.35,823.41,2898.76
"15415",1988,"96",1488.01,538.01,2026.02
"15416",1988,"97",952.99,334.43,1287.42
"15417",1988,"98",576.45,232,808.45
"15418",1988,"99",395.1,137,532.1
"15419",1988,"100",240.34,88,328.34
"15420",1988,"101",138.29,49,187.29
"15421",1988,"102",66.78,18,84.78
"15422",1988,"103",48.09,15.63,63.72
"15423",1988,"104",23,9.37,32.37
"15424",1988,"105",9.23,4.62,13.85
"15425",1988,"106",9.09,3.38,12.47
"15426",1988,"107",2.89,0,2.89
"15427",1988,"108",1.18,0,1.18
"15428",1988,"109",0,0,0
"15429",1988,"110+",0,0,0
"15430",1989,"0",90846,94945,185791
"15431",1989,"1",90870,95581,186451
"15432",1989,"2",90918,93931,184849
"15433",1989,"3",87937,91586,179523
"15434",1989,"4",85924,90285,176209
"15435",1989,"5",84134,87682,171816
"15436",1989,"6",84722,88697,173419
"15437",1989,"7",88077,91440,179517
"15438",1989,"8",89219,93623,182842
"15439",1989,"9",86904,90701,177605
"15440",1989,"10",87280,91444,178724
"15441",1989,"11",86442,90457,176899
"15442",1989,"12",87771,92800,180571
"15443",1989,"13",89359,93498,182857
"15444",1989,"14",93966,98549,192515
"15445",1989,"15",98774,103116,201890
"15446",1989,"16",108739,112711,221450
"15447",1989,"17",115287,120695,235982
"15448",1989,"18",121659,126741,248400
"15449",1989,"19",126018,131373,257391
"15450",1989,"20",121544,125455,246999
"15451",1989,"21",121133,126043,247176
"15452",1989,"22",122663,127340,250003
"15453",1989,"23",125110,130749,255859
"15454",1989,"24",128301,134497,262798
"15455",1989,"25",127226,133438,260664
"15456",1989,"26",126064,131372,257436
"15457",1989,"27",126136,131241,257377
"15458",1989,"28",122650,128615,251265
"15459",1989,"29",123121,128298,251419
"15460",1989,"30",120074,124920,244994
"15461",1989,"31",118432,123080,241512
"15462",1989,"32",116938,122044,238982
"15463",1989,"33",115616,118922,234538
"15464",1989,"34",113878,118739,232617
"15465",1989,"35",112947,117659,230606
"15466",1989,"36",113336,118380,231716
"15467",1989,"37",109946,115265,225211
"15468",1989,"38",110869,116329,227198
"15469",1989,"39",112796,118575,231371
"15470",1989,"40",116583,123394,239977
"15471",1989,"41",123684,129889,253573
"15472",1989,"42",127484,135149,262633
"15473",1989,"43",92185,97434,189619
"15474",1989,"44",96807,102192,198999
"15475",1989,"45",91737,97429,189166
"15476",1989,"46",84655,90148,174803
"15477",1989,"47",81097,85967,167064
"15478",1989,"48",83470,87929,171399
"15479",1989,"49",81183,84314,165497
"15480",1989,"50",79536,82915,162451
"15481",1989,"51",75435,77755,153190
"15482",1989,"52",75122,77282,152404
"15483",1989,"53",73913,75280,149193
"15484",1989,"54",73861,74372,148233
"15485",1989,"55",72531,72511,145042
"15486",1989,"56",74729,73690,148419
"15487",1989,"57",73662,71600,145262
"15488",1989,"58",74887,72404,147291
"15489",1989,"59",72087,68176,140263
"15490",1989,"60",72278,66893,139171
"15491",1989,"61",69726,64020,133746
"15492",1989,"62",70104,63185,133289
"15493",1989,"63",69861,61685,131546
"15494",1989,"64",70713,60848,131561
"15495",1989,"65",71426,61107,132533
"15496",1989,"66",68810,57983,126793
"15497",1989,"67",68927,56568,125495
"15498",1989,"68",69043,55760,124803
"15499",1989,"69",57186,45581,102767
"15500",1989,"70",54994,42354,97348
"15501",1989,"71",55623,41774,97397
"15502",1989,"72",54832,39927,94759
"15503",1989,"73",52744,37464,90208
"15504",1989,"74",53985,37238,91223
"15505",1989,"75",51873,34443,86316
"15506",1989,"76",49647,31827,81474
"15507",1989,"77",45254,27357,72611
"15508",1989,"78",43651,25406,69057
"15509",1989,"79",42377,23492,65869
"15510",1989,"80",39007.13,20739.39,59746.52
"15511",1989,"81",35990.96,18384.66,54375.62
"15512",1989,"82",32542.37,15886.07,48428.44
"15513",1989,"83",29605.2,13949.68,43554.88
"15514",1989,"84",26473.89,12133.98,38607.87
"15515",1989,"85",23001.58,10160.31,33161.89
"15516",1989,"86",20229.32,8649.52,28878.84
"15517",1989,"87",17253.23,6977.44,24230.67
"15518",1989,"88",13914.65,5467.18,19381.83
"15519",1989,"89",11538.58,4530.37,16068.95
"15520",1989,"90",9271.49,3533.29,12804.78
"15521",1989,"91",7408.29,2739.85,10148.14
"15522",1989,"92",5822.51,2129.07,7951.58
"15523",1989,"93",4218.3,1531.58,5749.88
"15524",1989,"94",3159.3,1046.84,4206.14
"15525",1989,"95",2285.37,848.48,3133.85
"15526",1989,"96",1527.35,575.41,2102.76
"15527",1989,"97",1055.01,350.01,1405.02
"15528",1989,"98",652.99,217.43,870.42
"15529",1989,"99",394.45,143,537.45
"15530",1989,"100",260.1,90,350.1
"15531",1989,"101",163.34,61,224.34
"15532",1989,"102",80.29,27,107.29
"15533",1989,"103",39.78,9,48.78
"15534",1989,"104",27.09,9.63,36.72
"15535",1989,"105",16,2.37,18.37
"15536",1989,"106",4.23,1.62,5.85
"15537",1989,"107",4.09,1.38,5.47
"15538",1989,"108",1.07,0,1.07
"15539",1989,"109",0,0,0
"15540",1989,"110+",0,0,0
"15541",1990,"0",91989,95512,187501
"15542",1990,"1",91136,95236,186372
"15543",1990,"2",91297,95965,187262
"15544",1990,"3",91373,94400,185773
"15545",1990,"4",88260,91932,180192
"15546",1990,"5",86293,90517,176810
"15547",1990,"6",84435,88022,172457
"15548",1990,"7",85116,89140,174256
"15549",1990,"8",88479,91787,180266
"15550",1990,"9",89568,94038,183606
"15551",1990,"10",87242,91080,178322
"15552",1990,"11",87630,91839,179469
"15553",1990,"12",86756,90884,177640
"15554",1990,"13",88108,93215,181323
"15555",1990,"14",89739,93881,183620
"15556",1990,"15",94454,99103,193557
"15557",1990,"16",99464,103612,203076
"15558",1990,"17",109552,113344,222896
"15559",1990,"18",116286,121451,237737
"15560",1990,"19",122532,127538,250070
"15561",1990,"20",126788,132129,258917
"15562",1990,"21",122069,126143,248212
"15563",1990,"22",121515,126716,248231
"15564",1990,"23",123064,128175,251239
"15565",1990,"24",125426,131746,257172
"15566",1990,"25",128590,135145,263735
"15567",1990,"26",127408,133823,261231
"15568",1990,"27",126230,131571,257801
"15569",1990,"28",126184,131257,257441
"15570",1990,"29",122693,128366,251059
"15571",1990,"30",123072,128229,251301
"15572",1990,"31",120107,124951,245058
"15573",1990,"32",118553,122922,241475
"15574",1990,"33",116883,121860,238743
"15575",1990,"34",115567,118719,234286
"15576",1990,"35",113870,118529,232399
"15577",1990,"36",112970,117436,230406
"15578",1990,"37",113313,118086,231399
"15579",1990,"38",109888,115057,224945
"15580",1990,"39",110927,116151,227078
"15581",1990,"40",112864,118389,231253
"15582",1990,"41",116571,123129,239700
"15583",1990,"42",123707,129611,253318
"15584",1990,"43",127426,134782,262208
"15585",1990,"44",92153,97188,189341
"15586",1990,"45",96667,101846,198513
"15587",1990,"46",91651,97192,188843
"15588",1990,"47",84568,89821,174389
"15589",1990,"48",80996,85649,166645
"15590",1990,"49",83459,87602,171061
"15591",1990,"50",81067,83962,165029
"15592",1990,"51",79374,82371,161745
"15593",1990,"52",75211,77249,152460
"15594",1990,"53",74856,76658,151514
"15595",1990,"54",73681,74766,148447
"15596",1990,"55",73547,73602,147149
"15597",1990,"56",72284,71781,144065
"15598",1990,"57",74519,73021,147540
"15599",1990,"58",73192,70708,143900
"15600",1990,"59",74337,71449,145786
"15601",1990,"60",71605,67218,138823
"15602",1990,"61",71767,65886,137653
"15603",1990,"62",69202,62947,132149
"15604",1990,"63",69459,62012,131471
"15605",1990,"64",69217,60398,129615
"15606",1990,"65",70003,59428,129431
"15607",1990,"66",70634,59543,130177
"15608",1990,"67",68008,56454,124462
"15609",1990,"68",68024,54967,122991
"15610",1990,"69",68051,53947,121998
"15611",1990,"70",56291,43993,100284
"15612",1990,"71",53983,40640,94623
"15613",1990,"72",54524,39953,94477
"15614",1990,"73",53671,37951,91622
"15615",1990,"74",51467,35486,86953
"15616",1990,"75",52531,35046,87577
"15617",1990,"76",50212,32181,82393
"15618",1990,"77",47910,29610,77520
"15619",1990,"78",43370,25225,68595
"15620",1990,"79",41642,23164,64806
"15621",1990,"80",39923.23,21180.26,61103.49
"15622",1990,"81",36737.13,18623.39,55360.52
"15623",1990,"82",33608.96,16326.66,49935.62
"15624",1990,"83",30177.37,13952.07,44129.44
"15625",1990,"84",27129.2,12079.68,39208.88
"15626",1990,"85",23993.89,10464.98,34458.87
"15627",1990,"86",20591.58,8569.31,29160.89
"15628",1990,"87",17823.32,7179.52,25002.84
"15629",1990,"88",14970.23,5706.44,20676.67
"15630",1990,"89",11913.65,4422.18,16335.83
"15631",1990,"90",9649.58,3571.37,13220.95
"15632",1990,"91",7601.49,2680.29,10281.78
"15633",1990,"92",5943.29,2082.85,8026.14
"15634",1990,"93",4537.51,1594.07,6131.58
"15635",1990,"94",3225.3,1131.58,4356.88
"15636",1990,"95",2335.3,750.84,3086.14
"15637",1990,"96",1685.37,580.48,2265.85
"15638",1990,"97",1062.35,394.41,1456.76
"15639",1990,"98",716.01,218.01,934.02
"15640",1990,"99",422.99,133.43,556.42
"15641",1990,"100",254.45,87,341.45
"15642",1990,"101",154.1,56,210.1
"15643",1990,"102",101.34,38,139.34
"15644",1990,"103",46.29,17,63.29
"15645",1990,"104",23.78,6,29.78
"15646",1990,"105",11.09,6.63,17.72
"15647",1990,"106",7,0.37,7.37
"15648",1990,"107",2.23,0.62,2.85
"15649",1990,"108",1.16,0.38,1.54
"15650",1990,"109",0,0,0
"15651",1990,"110+",0,0,0
"15652",1991,"0",96150,101131,197281
"15653",1991,"1",92460,96023,188483
"15654",1991,"2",91535,95670,187205
"15655",1991,"3",91606,96376,187982
"15656",1991,"4",91709,94756,186465
"15657",1991,"5",88598,92339,180937
"15658",1991,"6",86530,90889,177419
"15659",1991,"7",84722,88336,173058
"15660",1991,"8",85374,89456,174830
"15661",1991,"9",88823,92150,180973
"15662",1991,"10",89895,94369,184264
"15663",1991,"11",87543,91441,178984
"15664",1991,"12",87949,92224,180173
"15665",1991,"13",87060,91192,178252
"15666",1991,"14",88424,93603,182027
"15667",1991,"15",90151,94360,184511
"15668",1991,"16",95048,99622,194670
"15669",1991,"17",100133,104157,204290
"15670",1991,"18",110497,114106,224603
"15671",1991,"19",117372,122385,239757
"15672",1991,"20",123593,128469,252062
"15673",1991,"21",127769,133023,260792
"15674",1991,"22",122923,127335,250258
"15675",1991,"23",122251,128050,250301
"15676",1991,"24",123736,129618,253354
"15677",1991,"25",126187,133147,259334
"15678",1991,"26",129212,136462,265674
"15679",1991,"27",128040,134878,262918
"15680",1991,"28",126737,132581,259318
"15681",1991,"29",126578,132029,258607
"15682",1991,"30",123165,129180,252345
"15683",1991,"31",123545,128802,252347
"15684",1991,"32",120507,125419,245926
"15685",1991,"33",118877,123351,242228
"15686",1991,"34",117169,122241,239410
"15687",1991,"35",115823,119007,234830
"15688",1991,"36",114097,118774,232871
"15689",1991,"37",113188,117512,230700
"15690",1991,"38",113426,118255,231681
"15691",1991,"39",110008,115059,225067
"15692",1991,"40",111040,116122,227162
"15693",1991,"41",112860,118345,231205
"15694",1991,"42",116637,122985,239622
"15695",1991,"43",123659,129440,253099
"15696",1991,"44",127363,134521,261884
"15697",1991,"45",92083,96911,188994
"15698",1991,"46",96613,101532,198145
"15699",1991,"47",91530,96863,188393
"15700",1991,"48",84470,89506,173976
"15701",1991,"49",80865,85334,166199
"15702",1991,"50",83329,87146,170475
"15703",1991,"51",80906,83418,164324
"15704",1991,"52",79143,81806,160949
"15705",1991,"53",74993,76679,151672
"15706",1991,"54",74622,76115,150737
"15707",1991,"55",73414,74163,147577
"15708",1991,"56",73242,72944,146186
"15709",1991,"57",71988,71036,143024
"15710",1991,"58",74113,72209,146322
"15711",1991,"59",72809,69798,142607
"15712",1991,"60",73924,70480,144404
"15713",1991,"61",71114,66267,137381
"15714",1991,"62",71268,64843,136111
"15715",1991,"63",68623,61876,130499
"15716",1991,"64",68834,60835,129669
"15717",1991,"65",68614,59085,127699
"15718",1991,"66",69298,57936,127234
"15719",1991,"67",69740,57952,127692
"15720",1991,"68",67179,54869,122048
"15721",1991,"69",67033,53086,120119
"15722",1991,"70",67023,52068,119091
"15723",1991,"71",55337,42284,97621
"15724",1991,"72",52922,38757,91679
"15725",1991,"73",53343,38079,91422
"15726",1991,"74",52377,35854,88231
"15727",1991,"75",50065,33395,83460
"15728",1991,"76",50921,32864,83785
"15729",1991,"77",48448,30020,78468
"15730",1991,"78",45981,27313,73294
"15731",1991,"79",41461,23090,64551
"15732",1991,"80",39373.32,20960.02,60333.34
"15733",1991,"81",37588.23,19014.26,56602.49
"15734",1991,"82",34357.13,16589.39,50946.52
"15735",1991,"83",31144.96,14426.66,45571.62
"15736",1991,"84",27632.37,12119.07,39751.44
"15737",1991,"85",24584.2,10389.68,34973.88
"15738",1991,"86",21491.89,8894.98,30386.87
"15739",1991,"87",18127.58,7130.31,25257.89
"15740",1991,"88",15506.32,5871.52,21377.84
"15741",1991,"89",12762.23,4624.44,17386.67
"15742",1991,"90",10007.65,3518.18,13525.83
"15743",1991,"91",7950.58,2799.37,10749.95
"15744",1991,"92",6137.49,2016.29,8153.78
"15745",1991,"93",4670.29,1565.85,6236.14
"15746",1991,"94",3484.51,1164.07,4648.58
"15747",1991,"95",2376.3,795.58,3171.88
"15748",1991,"96",1711.3,529.84,2241.14
"15749",1991,"97",1180.37,410.48,1590.85
"15750",1991,"98",733.35,255.41,988.76
"15751",1991,"99",483.01,135.01,618.02
"15752",1991,"100",273.99,71.43,345.42
"15753",1991,"101",157.45,48,205.45
"15754",1991,"102",102.1,35,137.1
"15755",1991,"103",61.34,14,75.34
"15756",1991,"104",28.29,6,34.29
"15757",1991,"105",9.78,3,12.78
"15758",1991,"106",6.09,4.63,10.72
"15759",1991,"107",2,0.37,2.37
"15760",1991,"108",1.63,0,1.63
"15761",1991,"109",0.76,0,0.76
"15762",1991,"110+",0,0,0
"15763",1992,"0",96651,101127,197778
"15764",1992,"1",96497,101472,197969
"15765",1992,"2",92969,96669,189638
"15766",1992,"3",91872,96030,187902
"15767",1992,"4",91977,96775,188752
"15768",1992,"5",91998,95154,187152
"15769",1992,"6",89008,92743,181751
"15770",1992,"7",86936,91237,178173
"15771",1992,"8",84985,88711,173696
"15772",1992,"9",85721,89842,175563
"15773",1992,"10",89195,92537,181732
"15774",1992,"11",90300,94747,185047
"15775",1992,"12",87913,91885,179798
"15776",1992,"13",88336,92573,180909
"15777",1992,"14",87417,91637,179054
"15778",1992,"15",88831,94163,182994
"15779",1992,"16",90705,94898,185603
"15780",1992,"17",95788,100134,195922
"15781",1992,"18",101185,104812,205997
"15782",1992,"19",111817,114992,226809
"15783",1992,"20",118489,123203,241692
"15784",1992,"21",124635,129257,253892
"15785",1992,"22",128645,134072,262717
"15786",1992,"23",123831,128656,252487
"15787",1992,"24",123080,129358,252438
"15788",1992,"25",124365,130872,255237
"15789",1992,"26",126841,134251,261092
"15790",1992,"27",129896,137403,267299
"15791",1992,"28",128526,135676,264202
"15792",1992,"29",127266,133301,260567
"15793",1992,"30",127029,132551,259580
"15794",1992,"31",123589,129905,253494
"15795",1992,"32",123948,129180,253128
"15796",1992,"33",120876,125773,246649
"15797",1992,"34",119169,123662,242831
"15798",1992,"35",117433,122524,239957
"15799",1992,"36",116069,119255,235324
"15800",1992,"37",114261,118844,233105
"15801",1992,"38",113362,117621,230983
"15802",1992,"39",113549,118340,231889
"15803",1992,"40",110202,115020,225222
"15804",1992,"41",111128,116178,227306
"15805",1992,"42",112973,118216,231189
"15806",1992,"43",116629,122904,239533
"15807",1992,"44",123648,129262,252910
"15808",1992,"45",127307,134188,261495
"15809",1992,"46",92023,96690,188713
"15810",1992,"47",96502,101271,197773
"15811",1992,"48",91473,96645,188118
"15812",1992,"49",84331,89185,173516
"15813",1992,"50",80737,84996,165733
"15814",1992,"51",83178,86604,169782
"15815",1992,"52",80688,82989,163677
"15816",1992,"53",78968,81321,160289
"15817",1992,"54",74802,76155,150957
"15818",1992,"55",74412,75631,150043
"15819",1992,"56",73152,73544,146696
"15820",1992,"57",72907,72366,145273
"15821",1992,"58",71675,70353,142028
"15822",1992,"59",73750,71376,145126
"15823",1992,"60",72383,68958,141341
"15824",1992,"61",73455,69485,142940
"15825",1992,"62",70620,65214,135834
"15826",1992,"63",70726,63751,134477
"15827",1992,"64",68026,60655,128681
"15828",1992,"65",68242,59643,127885
"15829",1992,"66",67861,57674,125535
"15830",1992,"67",68515,56447,124962
"15831",1992,"68",68884,56341,125225
"15832",1992,"69",66204,53155,119359
"15833",1992,"70",66002,51269,117271
"15834",1992,"71",65789,50067,115856
"15835",1992,"72",54311,40494,94805
"15836",1992,"73",51749,36900,88649
"15837",1992,"74",52032,36113,88145
"15838",1992,"75",50974,33909,84883
"15839",1992,"76",48546,31239,79785
"15840",1992,"77",49193,30588,79781
"15841",1992,"78",46530,27751,74281
"15842",1992,"79",43905,25081,68986
"15843",1992,"80",39475.65,20883.56,60359.21
"15844",1992,"81",37101.32,18892.02,55993.34
"15845",1992,"82",35164.23,16937.26,52101.49
"15846",1992,"83",31883.13,14652.39,46535.52
"15847",1992,"84",28619.96,12536.66,41156.62
"15848",1992,"85",25071.37,10390.07,35461.44
"15849",1992,"86",22122.2,8823.68,30945.88
"15850",1992,"87",18934.89,7424.98,26359.87
"15851",1992,"88",15771.58,5853.31,21624.89
"15852",1992,"89",13239.32,4736.52,17975.84
"15853",1992,"90",10769.23,3707.44,14476.67
"15854",1992,"91",8263.65,2740.18,11003.83
"15855",1992,"92",6401.58,2122.37,8523.95
"15856",1992,"93",4864.49,1504.29,6368.78
"15857",1992,"94",3603.29,1123.85,4727.14
"15858",1992,"95",2570.51,781.07,3351.58
"15859",1992,"96",1775.3,538.58,2313.88
"15860",1992,"97",1190.3,355.84,1546.14
"15861",1992,"98",823.37,253.48,1076.85
"15862",1992,"99",484.35,166.41,650.76
"15863",1992,"100",324.01,83.01,407.02
"15864",1992,"101",154.99,46.43,201.42
"15865",1992,"102",100.45,31,131.45
"15866",1992,"103",56.1,18,74.1
"15867",1992,"104",33.34,6,39.34
"15868",1992,"105",14.29,3,17.29
"15869",1992,"106",6.78,1,7.78
"15870",1992,"107",2.09,3.63,5.72
"15871",1992,"108",0.4,0.37,0.77
"15872",1992,"109",0,0,0
"15873",1992,"110+",0,0,0
"15874",1993,"0",95589,100392,195981
"15875",1993,"1",96979,101481,198460
"15876",1993,"2",96838,101852,198690
"15877",1993,"3",93301,97034,190335
"15878",1993,"4",92244,96377,188621
"15879",1993,"5",92320,97119,189439
"15880",1993,"6",92276,95506,187782
"15881",1993,"7",89287,93046,182333
"15882",1993,"8",87212,91571,178783
"15883",1993,"9",85363,89026,174389
"15884",1993,"10",86032,90161,176193
"15885",1993,"11",89483,92881,182364
"15886",1993,"12",90595,95097,185692
"15887",1993,"13",88240,92210,180450
"15888",1993,"14",88611,92938,181549
"15889",1993,"15",87795,91992,179787
"15890",1993,"16",89353,94537,183890
"15891",1993,"17",91364,95287,186651
"15892",1993,"18",96709,100633,197342
"15893",1993,"19",102357,105382,207739
"15894",1993,"20",112794,115627,228421
"15895",1993,"21",119456,123798,243254
"15896",1993,"22",125588,130186,255774
"15897",1993,"23",129564,135316,264880
"15898",1993,"24",124772,129705,254477
"15899",1993,"25",123895,130304,254199
"15900",1993,"26",125016,131849,256865
"15901",1993,"27",127483,135151,262634
"15902",1993,"28",130582,138106,268688
"15903",1993,"29",129236,136362,265598
"15904",1993,"30",127722,133767,261489
"15905",1993,"31",127518,132765,260283
"15906",1993,"32",123994,130198,254192
"15907",1993,"33",124181,129333,253514
"15908",1993,"34",121193,125955,247148
"15909",1993,"35",119424,123818,243242
"15910",1993,"36",117684,122590,240274
"15911",1993,"37",116195,119277,235472
"15912",1993,"38",114391,118781,233172
"15913",1993,"39",113484,117602,231086
"15914",1993,"40",113631,118285,231916
"15915",1993,"41",110239,114880,225119
"15916",1993,"42",111200,115978,227178
"15917",1993,"43",112940,118082,231022
"15918",1993,"44",116595,122641,239236
"15919",1993,"45",123540,129040,252580
"15920",1993,"46",127176,133908,261084
"15921",1993,"47",91924,96415,188339
"15922",1993,"48",96356,100936,197292
"15923",1993,"49",91231,96324,187555
"15924",1993,"50",84151,88770,172921
"15925",1993,"51",80518,84504,165022
"15926",1993,"52",82968,86092,169060
"15927",1993,"53",80422,82452,162874
"15928",1993,"54",78674,80806,159480
"15929",1993,"55",74502,75631,150133
"15930",1993,"56",74125,75013,149138
"15931",1993,"57",72870,72865,145735
"15932",1993,"58",72548,71630,144178
"15933",1993,"59",71298,69586,140884
"15934",1993,"60",73265,70448,143713
"15935",1993,"61",71844,68045,139889
"15936",1993,"62",72923,68438,141361
"15937",1993,"63",70051,64081,134132
"15938",1993,"64",70146,62536,132682
"15939",1993,"65",67365,59395,126760
"15940",1993,"66",67498,58296,125794
"15941",1993,"67",67106,56256,123362
"15942",1993,"68",67610,54876,122486
"15943",1993,"69",67957,54634,122591
"15944",1993,"70",65189,51316,116505
"15945",1993,"71",64826,49322,114148
"15946",1993,"72",64529,47966,112495
"15947",1993,"73",53184,38631,91815
"15948",1993,"74",50514,34943,85457
"15949",1993,"75",50660,34159,84819
"15950",1993,"76",49406,31719,81125
"15951",1993,"77",46840,29155,75995
"15952",1993,"78",47367,28329,75696
"15953",1993,"79",44582,25506,70088
"15954",1993,"80",41324.45,22773.52,64097.97
"15955",1993,"81",37195.65,18848.56,56044.21
"15956",1993,"82",34695.32,16932.02,51627.34
"15957",1993,"83",32648.23,14961.26,47609.49
"15958",1993,"84",29362.13,12798.39,42160.52
"15959",1993,"85",26035.96,10802.66,36838.62
"15960",1993,"86",22518.37,8775.07,31293.44
"15961",1993,"87",19654.2,7400.68,27054.88
"15962",1993,"88",16499.89,6107.98,22607.87
"15963",1993,"89",13517.58,4776.31,18293.89
"15964",1993,"90",11214.32,3776.52,14990.84
"15965",1993,"91",8893.23,2923.44,11816.67
"15966",1993,"92",6636.65,2104.18,8740.83
"15967",1993,"93",5076.58,1580.37,6656.95
"15968",1993,"94",3763.49,1076.29,4839.78
"15969",1993,"95",2712.29,793.85,3506.14
"15970",1993,"96",1908.51,545.07,2453.58
"15971",1993,"97",1259.3,370.58,1629.88
"15972",1993,"98",809.3,224.84,1034.14
"15973",1993,"99",538.37,161.48,699.85
"15974",1993,"100",323.35,92.41,415.76
"15975",1993,"101",183.01,47.01,230.02
"15976",1993,"102",91.99,24.43,116.42
"15977",1993,"103",62.45,17,79.45
"15978",1993,"104",25.1,10,35.1
"15979",1993,"105",18.34,2,20.34
"15980",1993,"106",7.29,3,10.29
"15981",1993,"107",3.78,0,3.78
"15982",1993,"108",0.49,0,0.49
"15983",1993,"109",0,0,0
"15984",1993,"110+",0,0,0
"15985",1994,"0",95318,99656,194974
"15986",1994,"1",95941,100738,196679
"15987",1994,"2",97492,101893,199385
"15988",1994,"3",97221,102275,199496
"15989",1994,"4",93764,97518,191282
"15990",1994,"5",92544,96815,189359
"15991",1994,"6",92672,97460,190132
"15992",1994,"7",92625,95876,188501
"15993",1994,"8",89656,93497,183153
"15994",1994,"9",87601,91959,179560
"15995",1994,"10",85725,89534,175259
"15996",1994,"11",86416,90592,177008
"15997",1994,"12",89885,93313,183198
"15998",1994,"13",90998,95516,186514
"15999",1994,"14",88624,92608,181232
"16000",1994,"15",89039,93361,182400
"16001",1994,"16",88314,92467,180781
"16002",1994,"17",89989,95063,185052
"16003",1994,"18",92291,95892,188183
"16004",1994,"19",97763,101243,199006
"16005",1994,"20",103451,105939,209390
"16006",1994,"21",113872,116395,230267
"16007",1994,"22",120353,124652,245005
"16008",1994,"23",126537,131309,257846
"16009",1994,"24",130345,136381,266726
"16010",1994,"25",125534,130605,256139
"16011",1994,"26",124514,130997,255511
"16012",1994,"27",125671,132566,258237
"16013",1994,"28",128129,135868,263997
"16014",1994,"29",131228,138578,269806
"16015",1994,"30",129688,136567,266255
"16016",1994,"31",128143,134064,262207
"16017",1994,"32",127786,133025,260811
"16018",1994,"33",124437,130391,254828
"16019",1994,"34",124501,129317,253818
"16020",1994,"35",121514,126118,247632
"16021",1994,"36",119762,123884,243646
"16022",1994,"37",117868,122569,240437
"16023",1994,"38",116313,119336,235649
"16024",1994,"39",114553,118670,233223
"16025",1994,"40",113565,117453,231018
"16026",1994,"41",113782,118143,231925
"16027",1994,"42",110257,114776,225033
"16028",1994,"43",111201,115756,226957
"16029",1994,"44",112928,117945,230873
"16030",1994,"45",116529,122385,238914
"16031",1994,"46",123451,128651,252102
"16032",1994,"47",126938,133516,260454
"16033",1994,"48",91774,96077,187851
"16034",1994,"49",96170,100536,196706
"16035",1994,"50",90987,95812,186799
"16036",1994,"51",83984,88307,172291
"16037",1994,"52",80287,84047,164334
"16038",1994,"53",82719,85561,168280
"16039",1994,"54",80200,81906,162106
"16040",1994,"55",78381,80255,158636
"16041",1994,"56",74188,75013,149201
"16042",1994,"57",73772,74305,148077
"16043",1994,"58",72485,72091,144576
"16044",1994,"59",72103,70780,142883
"16045",1994,"60",70876,68649,139525
"16046",1994,"61",72778,69509,142287
"16047",1994,"62",71275,67027,138302
"16048",1994,"63",72317,67226,139543
"16049",1994,"64",69451,62851,132302
"16050",1994,"65",69486,61198,130684
"16051",1994,"66",66659,57984,124643
"16052",1994,"67",66678,56775,123453
"16053",1994,"68",66230,54563,120793
"16054",1994,"69",66637,53212,119849
"16055",1994,"70",66886,52769,119655
"16056",1994,"71",64008,49343,113351
"16057",1994,"72",63579,47164,110743
"16058",1994,"73",63044,45682,108726
"16059",1994,"74",51877,36594,88471
"16060",1994,"75",49151,32919,82070
"16061",1994,"76",49067,31977,81044
"16062",1994,"77",47689,29465,77154
"16063",1994,"78",44959,26923,71882
"16064",1994,"79",45284,25897,71181
"16065",1994,"80",42147.41,23073.1,65220.51
"16066",1994,"81",38911.45,20388.52,59299.97
"16067",1994,"82",34636.65,16723.56,51360.21
"16068",1994,"83",32170.32,14906.02,47076.34
"16069",1994,"84",29878.23,12894.26,42772.49
"16070",1994,"85",26489.13,10947.39,37436.52
"16071",1994,"86",23274.96,9058.66,32333.62
"16072",1994,"87",19770.37,7320.07,27090.44
"16073",1994,"88",16954.2,6037.68,22991.88
"16074",1994,"89",14029.89,4818.98,18848.87
"16075",1994,"90",11255.58,3667.31,14922.89
"16076",1994,"91",9087.32,2871.52,11958.84
"16077",1994,"92",7021.23,2182.44,9203.67
"16078",1994,"93",5147.65,1517.18,6664.83
"16079",1994,"94",3818.58,1126.37,4944.95
"16080",1994,"95",2744.49,739.29,3483.78
"16081",1994,"96",1930.29,540.85,2471.14
"16082",1994,"97",1318.51,365.07,1683.58
"16083",1994,"98",836.3,241.58,1077.88
"16084",1994,"99",510.3,129.84,640.14
"16085",1994,"100",324.37,92.48,416.85
"16086",1994,"101",187.35,48.41,235.76
"16087",1994,"102",108.01,24.01,132.02
"16088",1994,"103",44.99,14.43,59.42
"16089",1994,"104",27.45,12,39.45
"16090",1994,"105",12.1,2,14.1
"16091",1994,"106",8.34,0,8.34
"16092",1994,"107",4.29,3,7.29
"16093",1994,"108",1.27,0,1.27
"16094",1994,"109",0,0,0
"16095",1994,"110+",0,0,0
"16096",1995,"0",95635,100285,195920
"16097",1995,"1",95603,99816,195419
"16098",1995,"2",96145,101088,197233
"16099",1995,"3",97836,102201,200037
"16100",1995,"4",97529,102571,200100
"16101",1995,"5",94062,97835,191897
"16102",1995,"6",92790,97068,189858
"16103",1995,"7",92948,97776,190724
"16104",1995,"8",92879,96207,189086
"16105",1995,"9",90002,93721,183723
"16106",1995,"10",87876,92223,180099
"16107",1995,"11",85985,89843,175828
"16108",1995,"12",86695,90876,177571
"16109",1995,"13",90147,93644,183791
"16110",1995,"14",91285,95796,187081
"16111",1995,"15",88876,92874,181750
"16112",1995,"16",89401,93755,183156
"16113",1995,"17",88756,92952,181708
"16114",1995,"18",90565,95454,186019
"16115",1995,"19",93025,96130,189155
"16116",1995,"20",98410,101499,199909
"16117",1995,"21",103940,106215,210155
"16118",1995,"22",114256,116786,231042
"16119",1995,"23",120705,124974,245679
"16120",1995,"24",126762,131643,258405
"16121",1995,"25",130653,136607,267260
"16122",1995,"26",125667,130897,256564
"16123",1995,"27",124585,131060,255645
"16124",1995,"28",125753,132559,258312
"16125",1995,"29",128236,135916,264152
"16126",1995,"30",131302,138591,269893
"16127",1995,"31",129766,136543,266309
"16128",1995,"32",128194,133929,262123
"16129",1995,"33",127850,132986,260836
"16130",1995,"34",124488,130087,254575
"16131",1995,"35",124534,129103,253637
"16132",1995,"36",121529,125945,247474
"16133",1995,"37",119768,123651,243419
"16134",1995,"38",117911,122373,240284
"16135",1995,"39",116301,119179,235480
"16136",1995,"40",114518,118389,232907
"16137",1995,"41",113485,117254,230739
"16138",1995,"42",113711,117938,231649
"16139",1995,"43",110087,114492,224579
"16140",1995,"44",111085,115434,226519
"16141",1995,"45",112755,117620,230375
"16142",1995,"46",116290,122023,238313
"16143",1995,"47",123173,128228,251401
"16144",1995,"48",126648,133012,259660
"16145",1995,"49",91524,95737,187261
"16146",1995,"50",95851,100072,195923
"16147",1995,"51",90706,95259,185965
"16148",1995,"52",83659,87883,171542
"16149",1995,"53",80034,83455,163489
"16150",1995,"54",82326,85020,167346
"16151",1995,"55",79846,81331,161177
"16152",1995,"56",77978,79626,157604
"16153",1995,"57",73796,74308,148104
"16154",1995,"58",73343,73516,146859
"16155",1995,"59",72058,71321,143379
"16156",1995,"60",71610,69927,141537
"16157",1995,"61",70362,67697,138059
"16158",1995,"62",72219,68444,140663
"16159",1995,"63",70685,65885,136570
"16160",1995,"64",71658,65960,137618
"16161",1995,"65",68762,61551,130313
"16162",1995,"66",68729,59849,128578
"16163",1995,"67",65867,56563,122430
"16164",1995,"68",65820,55175,120995
"16165",1995,"69",65302,52909,118211
"16166",1995,"70",65618,51398,117016
"16167",1995,"71",65695,50848,116543
"16168",1995,"72",62758,47304,110062
"16169",1995,"73",62225,45020,107245
"16170",1995,"74",61440,43392,104832
"16171",1995,"75",50451,34527,84978
"16172",1995,"76",47618,30885,78503
"16173",1995,"77",47389,29874,77263
"16174",1995,"78",45833,27331,73164
"16175",1995,"79",42974,24712,67686
"16176",1995,"80",42862.81,23456.37,66319.18
"16177",1995,"81",39840.41,20846.1,60686.51
"16178",1995,"82",36393.45,18201.52,54594.97
"16179",1995,"83",32158.65,14784.56,46943.21
"16180",1995,"84",29665.32,12942.02,42607.34
"16181",1995,"85",27036.23,11098.26,38134.49
"16182",1995,"86",23767.13,9340.39,33107.52
"16183",1995,"87",20638.96,7595.66,28234.62
"16184",1995,"88",17222.37,6023.07,23245.44
"16185",1995,"89",14483.2,4899.68,19382.88
"16186",1995,"90",11758.89,3766.98,15525.87
"16187",1995,"91",9280.58,2859.31,12139.89
"16188",1995,"92",7238.32,2175.52,9413.84
"16189",1995,"93",5542.23,1615.44,7157.67
"16190",1995,"94",3899.65,1100.18,4999.83
"16191",1995,"95",2846.58,788.37,3634.95
"16192",1995,"96",1952.49,488.29,2440.78
"16193",1995,"97",1357.29,335.85,1693.14
"16194",1995,"98",904.51,231.07,1135.58
"16195",1995,"99",540.3,152.58,692.88
"16196",1995,"100",325.3,84.84,410.14
"16197",1995,"101",209.37,64.48,273.85
"16198",1995,"102",123.35,23.41,146.76
"16199",1995,"103",54.01,18.01,72.02
"16200",1995,"104",28.99,5.43,34.42
"16201",1995,"105",13.45,7,20.45
"16202",1995,"106",7.1,0,7.1
"16203",1995,"107",3.34,0,3.34
"16204",1995,"108",3.27,0,3.27
"16205",1995,"109",0.29,0,0.29
"16206",1995,"110+",0,0,0
"16207",1996,"0",93122,97614,190736
"16208",1996,"1",95882,100437,196319
"16209",1996,"2",95775,100043,195818
"16210",1996,"3",96329,101225,197554
"16211",1996,"4",98063,102416,200479
"16212",1996,"5",97652,102800,200452
"16213",1996,"6",94273,98061,192334
"16214",1996,"7",92998,97276,190274
"16215",1996,"8",93116,98060,191176
"16216",1996,"9",93077,96474,189551
"16217",1996,"10",90210,93931,184141
"16218",1996,"11",88065,92436,180501
"16219",1996,"12",86216,90096,176312
"16220",1996,"13",86852,91129,177981
"16221",1996,"14",90353,93839,184192
"16222",1996,"15",91477,96130,187607
"16223",1996,"16",89166,93254,182420
"16224",1996,"17",89677,94336,184013
"16225",1996,"18",89245,93496,182741
"16226",1996,"19",91218,95790,187008
"16227",1996,"20",93616,96334,189950
"16228",1996,"21",99014,101810,200824
"16229",1996,"22",104369,106568,210937
"16230",1996,"23",114676,117235,231911
"16231",1996,"24",121067,125270,246337
"16232",1996,"25",126975,131959,258934
"16233",1996,"26",130821,136719,267540
"16234",1996,"27",125824,131059,256883
"16235",1996,"28",124790,131043,255833
"16236",1996,"29",125835,132625,258460
"16237",1996,"30",128250,135815,264065
"16238",1996,"31",131346,138437,269783
"16239",1996,"32",129733,136367,266100
"16240",1996,"33",128210,133700,261910
"16241",1996,"34",127796,132675,260471
"16242",1996,"35",124569,129859,254428
"16243",1996,"36",124551,128832,253383
"16244",1996,"37",121571,125620,247191
"16245",1996,"38",119711,123411,243122
"16246",1996,"39",117858,122119,239977
"16247",1996,"40",116241,118797,235038
"16248",1996,"41",114452,118109,232561
"16249",1996,"42",113319,117009,230328
"16250",1996,"43",113592,117490,231082
"16251",1996,"44",109955,114188,224143
"16252",1996,"45",110901,115095,225996
"16253",1996,"46",112541,117259,229800
"16254",1996,"47",116067,121508,237575
"16255",1996,"48",122898,127680,250578
"16256",1996,"49",126283,132434,258717
"16257",1996,"50",91222,95269,186491
"16258",1996,"51",95488,99451,194939
"16259",1996,"52",90375,94644,185019
"16260",1996,"53",83346,87307,170653
"16261",1996,"54",79697,82874,162571
"16262",1996,"55",82026,84442,166468
"16263",1996,"56",79509,80641,160150
"16264",1996,"57",77614,78882,156496
"16265",1996,"58",73397,73541,146938
"16266",1996,"59",72884,72731,145615
"16267",1996,"60",71552,70457,142009
"16268",1996,"61",71114,68921,140035
"16269",1996,"62",69840,66705,136545
"16270",1996,"63",71616,67289,138905
"16271",1996,"64",70049,64667,134716
"16272",1996,"65",70921,64528,135449
"16273",1996,"66",67972,60065,128037
"16274",1996,"67",67882,58313,126195
"16275",1996,"68",64920,54999,119919
"16276",1996,"69",64823,53493,118316
"16277",1996,"70",64235,51084,115319
"16278",1996,"71",64522,49496,114018
"16279",1996,"72",64395,48738,113133
"16280",1996,"73",61450,45196,106646
"16281",1996,"74",60769,42752,103521
"16282",1996,"75",59770,41008,100778
"16283",1996,"76",48852,32388,81240
"16284",1996,"77",45975,28784,74759
"16285",1996,"78",45535,27611,73146
"16286",1996,"79",43849,25072,68921
"16287",1996,"80",40805.39,22495.17,63300.56
"16288",1996,"81",40485.81,21168.37,61654.18
"16289",1996,"82",37328.41,18551.1,55879.51
"16290",1996,"83",33731.45,15962.52,49693.97
"16291",1996,"84",29558.65,12888.56,42447.21
"16292",1996,"85",26966.32,11172.02,38138.34
"16293",1996,"86",24222.23,9415.26,33637.49
"16294",1996,"87",21011.13,7778.39,28789.52
"16295",1996,"88",17903.96,6188.66,24092.62
"16296",1996,"89",14797.37,4856.07,19653.44
"16297",1996,"90",12106.2,3891.68,15997.88
"16298",1996,"91",9674.89,2895.98,12570.87
"16299",1996,"92",7412.58,2170.31,9582.89
"16300",1996,"93",5699.32,1642.52,7341.84
"16301",1996,"94",4279.23,1169.44,5448.67
"16302",1996,"95",2861.65,768.18,3629.83
"16303",1996,"96",2065.58,538.37,2603.95
"16304",1996,"97",1377.49,303.29,1680.78
"16305",1996,"98",924.29,201.85,1126.14
"16306",1996,"99",588.51,140.07,728.58
"16307",1996,"100",350.3,84.58,434.88
"16308",1996,"101",195.3,47.84,243.14
"16309",1996,"102",104.37,29.48,133.85
"16310",1996,"103",56.35,13.41,69.76
"16311",1996,"104",28.01,11.01,39.02
"16312",1996,"105",16.99,2.43,19.42
"16313",1996,"106",7.45,2,9.45
"16314",1996,"107",5.1,0,5.1
"16315",1996,"108",1.9,0,1.9
"16316",1996,"109",2,0,2
"16317",1996,"110+",0,0,0
"16318",1997,"0",92351,97867,190218
"16319",1997,"1",93588,97879,191467
"16320",1997,"2",96112,100674,196786
"16321",1997,"3",95979,100243,196222
"16322",1997,"4",96562,101508,198070
"16323",1997,"5",98281,102606,200887
"16324",1997,"6",97935,103031,200966
"16325",1997,"7",94550,98342,192892
"16326",1997,"8",93244,97554,190798
"16327",1997,"9",93372,98306,191678
"16328",1997,"10",93348,96822,190170
"16329",1997,"11",90500,94245,184745
"16330",1997,"12",88307,92783,181090
"16331",1997,"13",86424,90368,176792
"16332",1997,"14",87138,91434,178572
"16333",1997,"15",90577,94228,184805
"16334",1997,"16",91782,96643,188425
"16335",1997,"17",89467,93828,183295
"16336",1997,"18",90398,94772,185170
"16337",1997,"19",90447,93869,184316
"16338",1997,"20",92101,96097,188198
"16339",1997,"21",94489,96672,191161
"16340",1997,"22",99926,102315,202241
"16341",1997,"23",105221,107128,212349
"16342",1997,"24",115518,117841,233359
"16343",1997,"25",121725,125622,247347
"16344",1997,"26",127546,132392,259938
"16345",1997,"27",131308,137051,268359
"16346",1997,"28",126143,131260,257403
"16347",1997,"29",125065,131068,256133
"16348",1997,"30",126006,132597,258603
"16349",1997,"31",128328,135551,263879
"16350",1997,"32",131484,138277,269761
"16351",1997,"33",129876,136139,266015
"16352",1997,"34",128290,133380,261670
"16353",1997,"35",127900,132290,260190
"16354",1997,"36",124639,129551,254190
"16355",1997,"37",124515,128351,252866
"16356",1997,"38",121523,125272,246795
"16357",1997,"39",119672,123066,242738
"16358",1997,"40",117771,121755,239526
"16359",1997,"41",116180,118354,234534
"16360",1997,"42",114323,117703,232026
"16361",1997,"43",113121,116515,229636
"16362",1997,"44",113419,117098,230517
"16363",1997,"45",109727,113809,223536
"16364",1997,"46",110705,114661,225366
"16365",1997,"47",112285,116678,228963
"16366",1997,"48",115778,120860,236638
"16367",1997,"49",122497,127085,249582
"16368",1997,"50",125850,131750,257600
"16369",1997,"51",90968,94545,185513
"16370",1997,"52",95101,98789,193890
"16371",1997,"53",89999,93933,183932
"16372",1997,"54",83028,86648,169676
"16373",1997,"55",79300,82255,161555
"16374",1997,"56",81687,83681,165368
"16375",1997,"57",79099,79878,158977
"16376",1997,"58",77174,78003,155177
"16377",1997,"59",72950,72751,145701
"16378",1997,"60",72428,71738,144166
"16379",1997,"61",71022,69441,140463
"16380",1997,"62",70616,67958,138574
"16381",1997,"63",69208,65571,134779
"16382",1997,"64",70998,66016,137014
"16383",1997,"65",69387,63299,132686
"16384",1997,"66",70143,63089,133232
"16385",1997,"67",67109,58484,125593
"16386",1997,"68",66921,56703,123624
"16387",1997,"69",63946,53334,117280
"16388",1997,"70",63773,51805,115578
"16389",1997,"71",63066,49155,112221
"16390",1997,"72",63260,47490,110750
"16391",1997,"73",63007,46494,109501
"16392",1997,"74",59930,42955,102885
"16393",1997,"75",59144,40445,99589
"16394",1997,"76",57886,38476,96362
"16395",1997,"77",47202,30187,77389
"16396",1997,"78",44203,26601,70804
"16397",1997,"79",43634,25292,68926
"16398",1997,"80",41350.4,22805.88,64156.28
"16399",1997,"81",38544.39,20370.17,58914.56
"16400",1997,"82",37960.81,18917.37,56878.18
"16401",1997,"83",34574.41,16316.1,50890.51
"16402",1997,"84",30978.45,13866.52,44844.97
"16403",1997,"85",26915.65,11062.56,37978.21
"16404",1997,"86",24185.32,9475.02,33660.34
"16405",1997,"87",21463.23,7819.26,29282.49
"16406",1997,"88",18288.13,6362.39,24650.52
"16407",1997,"89",15274.96,4988.66,20263.62
"16408",1997,"90",12399.37,3828.07,16227.44
"16409",1997,"91",9986.2,3005.68,12991.88
"16410",1997,"92",7744.89,2157.98,9902.87
"16411",1997,"93",5801.58,1636.31,7437.89
"16412",1997,"94",4330.32,1173.52,5503.84
"16413",1997,"95",3225.23,806.44,4031.67
"16414",1997,"96",2038.65,546.18,2584.83
"16415",1997,"97",1421.58,356.37,1777.95
"16416",1997,"98",940.49,199.29,1139.78
"16417",1997,"99",622.29,129.85,752.14
"16418",1997,"100",366.51,76.07,442.58
"16419",1997,"101",214.3,46.58,260.88
"16420",1997,"102",113.3,21.84,135.14
"16421",1997,"103",68.37,10.48,78.85
"16422",1997,"104",34.35,6.41,40.76
"16423",1997,"105",14.01,6.01,20.02
"16424",1997,"106",9.99,1.43,11.42
"16425",1997,"107",2.45,2,4.45
"16426",1997,"108",3.1,0,3.1
"16427",1997,"109",1.9,0,1.9
"16428",1997,"110+",0,0,0
"16429",1998,"0",94162,98146,192308
"16430",1998,"1",92870,98321,191191
"16431",1998,"2",93767,98123,191890
"16432",1998,"3",96339,100907,197246
"16433",1998,"4",96266,100466,196732
"16434",1998,"5",96787,101813,198600
"16435",1998,"6",98434,102743,201177
"16436",1998,"7",98208,103312,201520
"16437",1998,"8",94821,98589,193410
"16438",1998,"9",93536,97867,191403
"16439",1998,"10",93653,98602,192255
"16440",1998,"11",93674,97122,190796
"16441",1998,"12",90779,94572,185351
"16442",1998,"13",88625,93056,181681
"16443",1998,"14",86677,90693,177370
"16444",1998,"15",87542,91860,179402
"16445",1998,"16",90954,94938,185892
"16446",1998,"17",92256,97322,189578
"16447",1998,"18",90287,94334,184621
"16448",1998,"19",91565,95182,186747
"16449",1998,"20",91384,94291,185675
"16450",1998,"21",93161,96429,189590
"16451",1998,"22",95477,97235,192712
"16452",1998,"23",100884,102917,203801
"16453",1998,"24",105971,107784,213755
"16454",1998,"25",116239,118423,234662
"16455",1998,"26",122216,126155,248371
"16456",1998,"27",128142,132871,261013
"16457",1998,"28",131792,137473,269265
"16458",1998,"29",126494,131689,258183
"16459",1998,"30",125484,131285,256769
"16460",1998,"31",126274,132724,258998
"16461",1998,"32",128594,135650,264244
"16462",1998,"33",131704,138246,269950
"16463",1998,"34",130095,136147,266242
"16464",1998,"35",128451,133326,261777
"16465",1998,"36",127938,132141,260079
"16466",1998,"37",124757,129410,254167
"16467",1998,"38",124572,128162,252734
"16468",1998,"39",121543,125095,246638
"16469",1998,"40",119654,122799,242453
"16470",1998,"41",117732,121506,239238
"16471",1998,"42",116108,118148,234256
"16472",1998,"43",114296,117497,231793
"16473",1998,"44",112977,116220,229197
"16474",1998,"45",113276,116873,230149
"16475",1998,"46",109528,113469,222997
"16476",1998,"47",110499,114261,224760
"16477",1998,"48",112064,116306,228370
"16478",1998,"49",115496,120400,235896
"16479",1998,"50",122163,126521,248684
"16480",1998,"51",125496,131120,256616
"16481",1998,"52",90680,94065,184745
"16482",1998,"53",94791,98206,192997
"16483",1998,"54",89652,93360,183012
"16484",1998,"55",82731,86050,168781
"16485",1998,"56",78962,81669,160631
"16486",1998,"57",81298,82915,164213
"16487",1998,"58",78661,79145,157806
"16488",1998,"59",76691,77151,153842
"16489",1998,"60",72502,71932,144434
"16490",1998,"61",71907,70817,142724
"16491",1998,"62",70526,68485,139011
"16492",1998,"63",70095,66904,136999
"16493",1998,"64",68612,64462,133074
"16494",1998,"65",70268,64599,134867
"16495",1998,"66",68665,61925,130590
"16496",1998,"67",69344,61564,130908
"16497",1998,"68",66230,56935,123165
"16498",1998,"69",66010,55038,121048
"16499",1998,"70",62900,51631,114531
"16500",1998,"71",62664,49995,112659
"16501",1998,"72",61829,47219,109048
"16502",1998,"73",61959,45405,107364
"16503",1998,"74",61529,44192,105721
"16504",1998,"75",58294,40694,98988
"16505",1998,"76",57344,38067,95411
"16506",1998,"77",56015,36088,92103
"16507",1998,"78",45416,27956,73372
"16508",1998,"79",42263,24489,66752
"16509",1998,"80",41367.29,22817.09,64184.38
"16510",1998,"81",39027.4,20561.88,59589.28
"16511",1998,"82",36158.39,18268.17,54426.56
"16512",1998,"83",35297.81,16769.37,52067.18
"16513",1998,"84",31823.41,14256.1,46079.51
"16514",1998,"85",28172.45,11955.52,40127.97
"16515",1998,"86",24272.65,9497.56,33770.21
"16516",1998,"87",21453.32,7943.02,29396.34
"16517",1998,"88",18668.23,6415.26,25083.49
"16518",1998,"89",15645.13,5103.39,20748.52
"16519",1998,"90",12884.96,3971.66,16856.62
"16520",1998,"91",10158.37,2968.07,13126.44
"16521",1998,"92",8094.2,2310.68,10404.88
"16522",1998,"93",6023.89,1621.98,7645.87
"16523",1998,"94",4421.58,1181.31,5602.89
"16524",1998,"95",3210.32,832.52,4042.84
"16525",1998,"96",2317.23,528.44,2845.67
"16526",1998,"97",1444.65,362.18,1806.83
"16527",1998,"98",960.58,227.37,1187.95
"16528",1998,"99",617.49,125.29,742.78
"16529",1998,"100",393.29,82.85,476.14
"16530",1998,"101",230.51,38.07,268.58
"16531",1998,"102",119.3,25.58,144.88
"16532",1998,"103",66.3,11.84,78.14
"16533",1998,"104",39.37,4.48,43.85
"16534",1998,"105",19.35,3.41,22.76
"16535",1998,"106",7.01,3.01,10.02
"16536",1998,"107",6.99,0.43,7.42
"16537",1998,"108",0.45,1,1.45
"16538",1998,"109",2.1,0,2.1
"16539",1998,"110+",0.9,0,0.9
"16540",1999,"0",97514,102214,199728
"16541",1999,"1",94917,98860,193777
"16542",1999,"2",93339,98724,192063
"16543",1999,"3",94120,98489,192609
"16544",1999,"4",96708,101290,197998
"16545",1999,"5",96595,100808,197403
"16546",1999,"6",97076,102102,199178
"16547",1999,"7",98739,103044,201783
"16548",1999,"8",98518,103637,202155
"16549",1999,"9",95125,98908,194033
"16550",1999,"10",93922,98227,192149
"16551",1999,"11",94007,98978,192985
"16552",1999,"12",94054,97483,191537
"16553",1999,"13",91143,94910,186053
"16554",1999,"14",89014,93446,182460
"16555",1999,"15",87067,91174,178241
"16556",1999,"16",88107,92871,180978
"16557",1999,"17",91525,95891,187416
"16558",1999,"18",93176,97837,191013
"16559",1999,"19",91571,94712,186283
"16560",1999,"20",92582,95547,188129
"16561",1999,"21",92562,94738,187300
"16562",1999,"22",94259,97059,191318
"16563",1999,"23",96636,98187,194823
"16564",1999,"24",101999,103878,205877
"16565",1999,"25",106909,108618,215527
"16566",1999,"26",117111,119125,236236
"16567",1999,"27",122904,126899,249803
"16568",1999,"28",128895,133428,262323
"16569",1999,"29",132293,138040,270333
"16570",1999,"30",127040,132151,259191
"16571",1999,"31",125980,131660,257640
"16572",1999,"32",126687,132993,259680
"16573",1999,"33",129015,135807,264822
"16574",1999,"34",132107,138365,270472
"16575",1999,"35",130300,136322,266622
"16576",1999,"36",128775,133355,262130
"16577",1999,"37",128106,132150,260256
"16578",1999,"38",124965,129442,254407
"16579",1999,"39",124657,128098,252755
"16580",1999,"40",121634,125044,246678
"16581",1999,"41",119697,122716,242413
"16582",1999,"42",117739,121351,239090
"16583",1999,"43",116098,117972,234070
"16584",1999,"44",114167,117318,231485
"16585",1999,"45",112870,115942,228812
"16586",1999,"46",113176,116569,229745
"16587",1999,"47",109340,113147,222487
"16588",1999,"48",110294,113904,224198
"16589",1999,"49",111746,115865,227611
"16590",1999,"50",115260,119915,235175
"16591",1999,"51",121859,125879,247738
"16592",1999,"52",125059,130484,255543
"16593",1999,"53",90347,93564,183911
"16594",1999,"54",94449,97615,192064
"16595",1999,"55",89333,92745,182078
"16596",1999,"56",82425,85401,167826
"16597",1999,"57",78574,81046,159620
"16598",1999,"58",80921,82223,163144
"16599",1999,"59",78246,78373,156619
"16600",1999,"60",76264,76294,152558
"16601",1999,"61",72090,71038,143128
"16602",1999,"62",71384,69793,141177
"16603",1999,"63",69965,67447,137412
"16604",1999,"64",69485,65738,135223
"16605",1999,"65",68010,63180,131190
"16606",1999,"66",69514,63222,132736
"16607",1999,"67",67927,60380,128307
"16608",1999,"68",68395,59913,128308
"16609",1999,"69",65318,55289,120607
"16610",1999,"70",65016,53401,118417
"16611",1999,"71",61833,49811,111644
"16612",1999,"72",61473,48118,109591
"16613",1999,"73",60484,45185,105669
"16614",1999,"74",60496,43157,103653
"16615",1999,"75",59859,41915,101774
"16616",1999,"76",56620,38355,94975
"16617",1999,"77",55467,35653,91120
"16618",1999,"78",53840,33624,87464
"16619",1999,"79",43575,25752,69327
"16620",1999,"80",40200.22,22343.43,62543.65
"16621",1999,"81",39070.29,20649.09,59719.38
"16622",1999,"82",36587.4,18421.88,55009.28
"16623",1999,"83",33619.39,16166.17,49785.56
"16624",1999,"84",32479.81,14666.37,47146.18
"16625",1999,"85",28986.41,12290.1,41276.51
"16626",1999,"86",25315.45,10143.52,35458.97
"16627",1999,"87",21453.65,7972.56,29426.21
"16628",1999,"88",18733.32,6543.02,25276.34
"16629",1999,"89",15940.23,5176.26,21116.49
"16630",1999,"90",13128.13,4012.39,17140.52
"16631",1999,"91",10587.96,3003.66,13591.62
"16632",1999,"92",8213.37,2251.07,10464.44
"16633",1999,"93",6353.2,1708.68,8061.88
"16634",1999,"94",4624.89,1200.98,5825.87
"16635",1999,"95",3290.58,841.31,4131.89
"16636",1999,"96",2284.32,569.52,2853.84
"16637",1999,"97",1638.23,358.44,1996.67
"16638",1999,"98",981.65,238.18,1219.83
"16639",1999,"99",615.58,144.37,759.95
"16640",1999,"100",392.49,75.29,467.78
"16641",1999,"101",240.29,34.85,275.14
"16642",1999,"102",132.51,15.07,147.58
"16643",1999,"103",69.3,11.58,80.88
"16644",1999,"104",41.3,4.84,46.14
"16645",1999,"105",19.37,4.48,23.85
"16646",1999,"106",6.35,1.41,7.76
"16647",1999,"107",3.01,3.01,6.02
"16648",1999,"108",2.99,0.43,3.42
"16649",1999,"109",0.45,0,0.45
"16650",1999,"110+",2,0,2
"16651",2000,"0",98199,103549,201748
"16652",2000,"1",98163,102854,201017
"16653",2000,"2",95356,99191,194547
"16654",2000,"3",93733,99112,192845
"16655",2000,"4",94470,98864,193334
"16656",2000,"5",96998,101584,198582
"16657",2000,"6",96876,101104,197980
"16658",2000,"7",97438,102363,199801
"16659",2000,"8",99065,103404,202469
"16660",2000,"9",98823,104015,202838
"16661",2000,"10",95500,99249,194749
"16662",2000,"11",94254,98575,192829
"16663",2000,"12",94333,99354,193687
"16664",2000,"13",94410,97856,192266
"16665",2000,"14",91542,95309,186851
"16666",2000,"15",89467,94177,183644
"16667",2000,"16",87603,92163,179766
"16668",2000,"17",88633,93812,182445
"16669",2000,"18",92394,96486,188880
"16670",2000,"19",94457,98273,192730
"16671",2000,"20",92550,95015,187565
"16672",2000,"21",93699,96009,189708
"16673",2000,"22",93690,95320,189010
"16674",2000,"23",95193,97853,193046
"16675",2000,"24",97512,99045,196557
"16676",2000,"25",102866,104633,207499
"16677",2000,"26",107763,109257,217020
"16678",2000,"27",117878,119776,237654
"16679",2000,"28",123553,127293,250846
"16680",2000,"29",129436,133816,263252
"16681",2000,"30",132734,138227,270961
"16682",2000,"31",127459,132352,259811
"16683",2000,"32",126336,131793,258129
"16684",2000,"33",127061,133179,260240
"16685",2000,"34",129286,135977,265263
"16686",2000,"35",132347,138409,270756
"16687",2000,"36",130544,136368,266912
"16688",2000,"37",128986,133389,262375
"16689",2000,"38",128263,132162,260425
"16690",2000,"39",125129,129346,254475
"16691",2000,"40",124739,127960,252699
"16692",2000,"41",121682,124882,246564
"16693",2000,"42",119709,122573,242282
"16694",2000,"43",117732,121164,238896
"16695",2000,"44",116079,117821,233900
"16696",2000,"45",114074,117103,231177
"16697",2000,"46",112739,115663,228402
"16698",2000,"47",113043,116274,229317
"16699",2000,"48",109149,112788,221937
"16700",2000,"49",110036,113562,223598
"16701",2000,"50",111486,115379,226865
"16702",2000,"51",114979,119301,234280
"16703",2000,"52",121539,125225,246764
"16704",2000,"53",124620,129775,254395
"16705",2000,"54",90005,93017,183022
"16706",2000,"55",94050,96976,191026
"16707",2000,"56",88935,92118,181053
"16708",2000,"57",82069,84736,166805
"16709",2000,"58",78179,80363,158542
"16710",2000,"59",80521,81499,162020
"16711",2000,"60",77782,77499,155281
"16712",2000,"61",75778,75345,151123
"16713",2000,"62",71556,70100,141656
"16714",2000,"63",70830,68843,139673
"16715",2000,"64",69388,66331,135719
"16716",2000,"65",68791,64468,133259
"16717",2000,"66",67319,61842,129161
"16718",2000,"67",68746,61800,130546
"16719",2000,"68",67048,58852,125900
"16720",2000,"69",67422,58192,125614
"16721",2000,"70",64291,53600,117891
"16722",2000,"71",63876,51614,115490
"16723",2000,"72",60603,47993,108596
"16724",2000,"73",60172,46117,106289
"16725",2000,"74",59043,43062,102105
"16726",2000,"75",58958,40871,99829
"16727",2000,"76",58092,39599,97691
"16728",2000,"77",54666,35960,90626
"16729",2000,"78",53393,33145,86538
"16730",2000,"79",51530,31038,82568
"16731",2000,"80",41660.58,23863.61,65524.19
"16732",2000,"81",37997.22,20251.43,58248.65
"16733",2000,"82",36528.29,18503.09,55031.38
"16734",2000,"83",33992.4,16337.88,50330.28
"16735",2000,"84",30980.39,14094.17,45074.56
"16736",2000,"85",29528.81,12633.37,42162.18
"16737",2000,"86",26044.41,10498.1,36542.51
"16738",2000,"87",22307.45,8471.52,30778.97
"16739",2000,"88",18694.65,6570.56,25265.21
"16740",2000,"89",15994.32,5239.02,21233.34
"16741",2000,"90",13364.23,4062.26,17426.49
"16742",2000,"91",10736.13,3057.39,13793.52
"16743",2000,"92",8459.96,2218.66,10678.62
"16744",2000,"93",6423.37,1629.07,8052.44
"16745",2000,"94",4800.2,1214.68,6014.88
"16746",2000,"95",3432.89,836.98,4269.87
"16747",2000,"96",2320.58,566.31,2886.89
"16748",2000,"97",1590.32,361.52,1951.84
"16749",2000,"98",1049.23,225.44,1274.67
"16750",2000,"99",623.65,145.18,768.83
"16751",2000,"100",387.58,83.37,470.95
"16752",2000,"101",237.49,40.29,277.78
"16753",2000,"102",138.29,15.85,154.14
"16754",2000,"103",73.51,7.07,80.58
"16755",2000,"104",33.3,4.58,37.88
"16756",2000,"105",18.3,3.84,22.14
"16757",2000,"106",14.37,2.48,16.85
"16758",2000,"107",5.35,1.41,6.76
"16759",2000,"108",1.01,1.01,2.02
"16760",2000,"109",0.99,0.43,1.42
"16761",2000,"110+",2.45,0,2.45
"16762",2001,"0",101241,105856,207097
"16763",2001,"1",99002,104153,203155
"16764",2001,"2",98552,103235,201787
"16765",2001,"3",95786,99549,195335
"16766",2001,"4",94113,99598,193711
"16767",2001,"5",94823,99219,194042
"16768",2001,"6",97325,101945,199270
"16769",2001,"7",97188,101497,198685
"16770",2001,"8",97841,102750,200591
"16771",2001,"9",99401,103839,203240
"16772",2001,"10",99250,104455,203705
"16773",2001,"11",95887,99702,195589
"16774",2001,"12",94678,99037,193715
"16775",2001,"13",94716,99777,194493
"16776",2001,"14",94792,98331,193123
"16777",2001,"15",92029,96093,188122
"16778",2001,"16",90157,95315,185472
"16779",2001,"17",88241,93329,181570
"16780",2001,"18",89650,94794,184444
"16781",2001,"19",93852,97055,190907
"16782",2001,"20",95688,98858,194546
"16783",2001,"21",93775,95716,189491
"16784",2001,"22",95104,96908,192012
"16785",2001,"23",94933,96281,191214
"16786",2001,"24",96450,98978,195428
"16787",2001,"25",98641,100070,198711
"16788",2001,"26",103937,105577,209514
"16789",2001,"27",108795,110157,218952
"16790",2001,"28",118787,120559,239346
"16791",2001,"29",124359,127939,252298
"16792",2001,"30",130243,134466,264709
"16793",2001,"31",133356,138661,272017
"16794",2001,"32",128026,132842,260868
"16795",2001,"33",126815,132252,259067
"16796",2001,"34",127476,133442,260918
"16797",2001,"35",129780,136256,266036
"16798",2001,"36",132677,138503,271180
"16799",2001,"37",130743,136561,267304
"16800",2001,"38",129153,133536,262689
"16801",2001,"39",128481,132323,260804
"16802",2001,"40",125331,129403,254734
"16803",2001,"41",124931,128017,252948
"16804",2001,"42",121746,124795,246541
"16805",2001,"43",119788,122528,242316
"16806",2001,"44",117763,121026,238789
"16807",2001,"45",115969,117632,233601
"16808",2001,"46",114002,116866,230868
"16809",2001,"47",112568,115437,228005
"16810",2001,"48",112871,115905,228776
"16811",2001,"49",108986,112431,221417
"16812",2001,"50",109822,113230,223052
"16813",2001,"51",111249,114929,226178
"16814",2001,"52",114625,118847,233472
"16815",2001,"53",121182,124530,245712
"16816",2001,"54",124235,129093,253328
"16817",2001,"55",89681,92415,182096
"16818",2001,"56",93657,96301,189958
"16819",2001,"57",88590,91393,179983
"16820",2001,"58",81678,84060,165738
"16821",2001,"59",77748,79606,157354
"16822",2001,"60",80050,80705,160755
"16823",2001,"61",77319,76637,153956
"16824",2001,"62",75269,74406,149675
"16825",2001,"63",71050,69063,140113
"16826",2001,"64",70231,67821,138052
"16827",2001,"65",68770,65158,133928
"16828",2001,"66",68074,63125,131199
"16829",2001,"67",66579,60451,127030
"16830",2001,"68",67925,60284,128209
"16831",2001,"69",66108,57361,123469
"16832",2001,"70",66400,56492,122892
"16833",2001,"71",63236,51823,115059
"16834",2001,"72",62645,49756,112401
"16835",2001,"73",59303,46020,105323
"16836",2001,"74",58796,44065,102861
"16837",2001,"75",57494,40876,98370
"16838",2001,"76",57215,38603,95818
"16839",2001,"77",56238,37157,93395
"16840",2001,"78",52663,33516,86179
"16841",2001,"79",51112,30619,81731
"16842",2001,"80",49095.9,28474.64,77570.54
"16843",2001,"81",39365.8,21627.98,60993.78
"16844",2001,"82",35626.2,18151.16,53777.36
"16845",2001,"83",33899.08,16413.53,50312.61
"16846",2001,"84",31194.71,14258.42,45453.13
"16847",2001,"85",28122.16,12153.49,40275.65
"16848",2001,"86",26501.55,10789.43,37290.98
"16849",2001,"87",23023.16,8800.79,31823.95
"16850",2001,"88",19417.32,6965.82,26383.14
"16851",2001,"89",16025.57,5334.35,21359.92
"16852",2001,"90",13418.1,4165.75,17583.85
"16853",2001,"91",10995.26,3135,14130.26
"16854",2001,"92",8609.48,2298.7,10908.18
"16855",2001,"93",6622.85,1651.68,8274.53
"16856",2001,"94",4914.08,1181.18,6095.26
"16857",2001,"95",3557.4,841.89,4399.29
"16858",2001,"96",2492.6,571.43,3064.03
"16859",2001,"97",1633.73,376.61,2010.34
"16860",2001,"98",1086.15,232.86,1319.01
"16861",2001,"99",700.16,136.04,836.2
"16862",2001,"100",390.68,85.17,475.85
"16863",2001,"101",228.19,49.79,277.98
"16864",2001,"102",137.06,21.46,158.52
"16865",2001,"103",73.85,7.08,80.93
"16866",2001,"104",34.24,2.88,37.12
"16867",2001,"105",16.36,2.01,18.37
"16868",2001,"106",8.18,1.98,10.16
"16869",2001,"107",6.1,1.46,7.56
"16870",2001,"108",2.62,0.43,3.05
"16871",2001,"109",0.56,0.57,1.13
"16872",2001,"110+",3.44,0.43,3.87
"16873",2002,"0",99537,104502,204039
"16874",2002,"1",102042,106511,208553
"16875",2002,"2",99351,104465,203816
"16876",2002,"3",98795,103510,202305
"16877",2002,"4",96060,99849,195909
"16878",2002,"5",94360,99877,194237
"16879",2002,"6",95155,99469,194624
"16880",2002,"7",97608,102240,199848
"16881",2002,"8",97478,101826,199304
"16882",2002,"9",98147,103078,201225
"16883",2002,"10",99726,104224,203950
"16884",2002,"11",99585,104801,204386
"16885",2002,"12",96275,100145,196420
"16886",2002,"13",94996,99391,194387
"16887",2002,"14",95074,100171,195245
"16888",2002,"15",95238,98978,194216
"16889",2002,"16",92664,97093,189757
"16890",2002,"17",90942,96700,187642
"16891",2002,"18",89361,94527,183888
"16892",2002,"19",91162,95723,186885
"16893",2002,"20",95154,97860,193014
"16894",2002,"21",97078,99720,196798
"16895",2002,"22",95171,96792,191963
"16896",2002,"23",96511,98197,194708
"16897",2002,"24",96289,97584,193873
"16898",2002,"25",97709,100123,197832
"16899",2002,"26",99818,101256,201074
"16900",2002,"27",104968,106579,211547
"16901",2002,"28",109718,111092,220810
"16902",2002,"29",119594,121237,240831
"16903",2002,"30",125089,128554,253643
"16904",2002,"31",130855,135021,265876
"16905",2002,"32",133846,138975,272821
"16906",2002,"33",128446,133205,261651
"16907",2002,"34",127185,132469,259654
"16908",2002,"35",127835,133546,261381
"16909",2002,"36",130133,136444,266577
"16910",2002,"37",132819,138500,271319
"16911",2002,"38",130966,136612,267578
"16912",2002,"39",129283,133494,262777
"16913",2002,"40",128578,132274,260852
"16914",2002,"41",125390,129383,254773
"16915",2002,"42",124992,128010,253002
"16916",2002,"43",121772,124664,246436
"16917",2002,"44",119762,122371,242133
"16918",2002,"45",117689,120792,238481
"16919",2002,"46",115814,117397,233211
"16920",2002,"47",113839,116543,230382
"16921",2002,"48",112356,115077,227433
"16922",2002,"49",112656,115583,228239
"16923",2002,"50",108715,112002,220717
"16924",2002,"51",109560,112740,222300
"16925",2002,"52",110882,114458,225340
"16926",2002,"53",114242,118225,232467
"16927",2002,"54",120717,123901,244618
"16928",2002,"55",123787,128329,252116
"16929",2002,"56",89289,91762,181051
"16930",2002,"57",93199,95625,188824
"16931",2002,"58",88089,90555,178644
"16932",2002,"59",81214,83292,164506
"16933",2002,"60",77306,78742,156048
"16934",2002,"61",79595,79818,159413
"16935",2002,"62",76773,75693,152466
"16936",2002,"63",74708,73543,148251
"16937",2002,"64",70498,68007,138505
"16938",2002,"65",69623,66629,136252
"16939",2002,"66",68114,63921,132035
"16940",2002,"67",67309,61740,129049
"16941",2002,"68",65800,59004,124804
"16942",2002,"69",66974,58727,125701
"16943",2002,"70",65113,55694,120807
"16944",2002,"71",65315,54645,119960
"16945",2002,"72",62040,49986,112026
"16946",2002,"73",61292,47750,109042
"16947",2002,"74",57929,43948,101877
"16948",2002,"75",57297,41896,99193
"16949",2002,"76",55875,38639,94514
"16950",2002,"77",55295,36272,91567
"16951",2002,"78",54028,34712,88740
"16952",2002,"79",50445,31095,81540
"16953",2002,"80",48594.06,28301.96,76896.02
"16954",2002,"81",46446.3,25911.49,72357.79
"16955",2002,"82",36940.62,19471.85,56412.47
"16956",2002,"83",33135.7,16127.95,49263.65
"16957",2002,"84",31214.78,14392.35,45607.13
"16958",2002,"85",28399.53,12361.26,40760.79
"16959",2002,"86",25274.32,10420.27,35694.59
"16960",2002,"87",23468.58,9124.81,32593.39
"16961",2002,"88",20089.71,7277.58,27367.29
"16962",2002,"89",16649.63,5623.48,22273.11
"16963",2002,"90",13433.82,4207.1,17640.92
"16964",2002,"91",11044.42,3212.89,14257.31
"16965",2002,"92",8898.96,2375.58,11274.54
"16966",2002,"93",6773.1,1705.22,8478.32
"16967",2002,"94",5026.19,1185.62,6211.81
"16968",2002,"95",3608.98,812.24,4421.22
"16969",2002,"96",2514.27,564.26,3078.53
"16970",2002,"97",1728.37,378.77,2107.14
"16971",2002,"98",1117.21,235.99,1353.2
"16972",2002,"99",717.56,139.04,856.6
"16973",2002,"100",461.44,83.49,544.93
"16974",2002,"101",249.2,50.1,299.3
"16975",2002,"102",134.32,26.49,160.81
"16976",2002,"103",75.23,10.66,85.89
"16977",2002,"104",38.03,3.88,41.91
"16978",2002,"105",17.94,1.88,19.82
"16979",2002,"106",6.9,1,7.9
"16980",2002,"107",1.98,0.99,2.97
"16981",2002,"108",2.04,0.44,2.48
"16982",2002,"109",0.87,0,0.87
"16983",2002,"110+",2,1,3
"16984",2003,"0",98568,103818,202386
"16985",2003,"1",100200,104951,205151
"16986",2003,"2",102289,106544,208833
"16987",2003,"3",99431,104488,203919
"16988",2003,"4",98827,103497,202324
"16989",2003,"5",96106,99862,195968
"16990",2003,"6",94451,99870,194321
"16991",2003,"7",95208,99555,194763
"16992",2003,"8",97765,102318,200083
"16993",2003,"9",97606,101977,199583
"16994",2003,"10",98292,103278,201570
"16995",2003,"11",99924,104438,204362
"16996",2003,"12",99821,105023,204844
"16997",2003,"13",96491,100455,196946
"16998",2003,"14",95274,99761,195035
"16999",2003,"15",95463,100732,196195
"17000",2003,"16",95822,99851,195673
"17001",2003,"17",93285,98222,191507
"17002",2003,"18",91851,97733,189584
"17003",2003,"19",90727,95225,185952
"17004",2003,"20",92227,96257,188484
"17005",2003,"21",96443,98423,194866
"17006",2003,"22",98444,100499,198943
"17007",2003,"23",96346,97670,194016
"17008",2003,"24",97549,98970,196519
"17009",2003,"25",97372,98206,195578
"17010",2003,"26",98547,100775,199322
"17011",2003,"27",100469,101670,202139
"17012",2003,"28",105640,106920,212560
"17013",2003,"29",110223,111357,221580
"17014",2003,"30",119983,121208,241191
"17015",2003,"31",125328,128478,253806
"17016",2003,"32",131049,134892,265941
"17017",2003,"33",133947,138756,272703
"17018",2003,"34",128574,133005,261579
"17019",2003,"35",127320,132219,259539
"17020",2003,"36",127937,133301,261238
"17021",2003,"37",130153,136022,266175
"17022",2003,"38",132840,138058,270898
"17023",2003,"39",130912,136181,267093
"17024",2003,"40",129371,133134,262505
"17025",2003,"41",128540,131913,260453
"17026",2003,"42",125292,128985,254277
"17027",2003,"43",124911,127607,252518
"17028",2003,"44",121658,124268,245926
"17029",2003,"45",119582,121929,241511
"17030",2003,"46",117474,120354,237828
"17031",2003,"47",115614,116994,232608
"17032",2003,"48",113509,116139,229648
"17033",2003,"49",112082,114583,226665
"17034",2003,"50",112284,115067,227351
"17035",2003,"51",108372,111372,219744
"17036",2003,"52",109183,112120,221303
"17037",2003,"53",110441,113799,224240
"17038",2003,"54",113704,117478,231182
"17039",2003,"55",120176,123029,243205
"17040",2003,"56",123185,127375,250560
"17041",2003,"57",88789,91019,179808
"17042",2003,"58",92723,94751,187474
"17043",2003,"59",87629,89705,177334
"17044",2003,"60",80695,82399,163094
"17045",2003,"61",76743,77841,154584
"17046",2003,"62",79059,78824,157883
"17047",2003,"63",76135,74668,150803
"17048",2003,"64",74032,72411,146443
"17049",2003,"65",69829,66782,136611
"17050",2003,"66",68925,65360,134285
"17051",2003,"67",67341,62525,129866
"17052",2003,"68",66456,60277,126733
"17053",2003,"69",64919,57450,122369
"17054",2003,"70",65936,57026,122962
"17055",2003,"71",64010,53966,117976
"17056",2003,"72",64121,52706,116827
"17057",2003,"73",60685,47972,108657
"17058",2003,"74",59817,45618,105435
"17059",2003,"75",56450,41800,98250
"17060",2003,"76",55600,39668,95268
"17061",2003,"77",53992,36357,90349
"17062",2003,"78",53229,33810,87039
"17063",2003,"79",51708,32151,83859
"17064",2003,"80",48159.27,28445.72,76604.99
"17065",2003,"81",45943.66,25748.63,71692.29
"17066",2003,"82",43618.01,23380.62,66998.63
"17067",2003,"83",34339.96,17365.47,51705.43
"17068",2003,"84",30423.19,14144.5,44567.69
"17069",2003,"85",28388.51,12434.03,40822.54
"17070",2003,"86",25600.33,10551.55,36151.88
"17071",2003,"87",22424.54,8731.69,31156.23
"17072",2003,"88",20457.57,7495.72,27953.29
"17073",2003,"89",17208.67,5903.8,23112.47
"17074",2003,"90",13967.54,4470.15,18437.69
"17075",2003,"91",11000.12,3264.73,14264.85
"17076",2003,"92",8756.62,2449.96,11206.58
"17077",2003,"93",6903.22,1775.09,8678.31
"17078",2003,"94",5152.14,1221.7,6373.84
"17079",2003,"95",3712.9,811.22,4524.12
"17080",2003,"96",2600.93,555.47,3156.4
"17081",2003,"97",1756.02,373.65,2129.67
"17082",2003,"98",1168.47,240.06,1408.53
"17083",2003,"99",744.14,151.13,895.27
"17084",2003,"100",457.23,83.27,540.5
"17085",2003,"101",278.32,45.93,324.25
"17086",2003,"102",137.15,28.18,165.33
"17087",2003,"103",70.27,14.35,84.62
"17088",2003,"104",42.76,6.17,48.93
"17089",2003,"105",21.24,2.88,24.12
"17090",2003,"106",10.14,1.44,11.58
"17091",2003,"107",3.67,0.44,4.11
"17092",2003,"108",0.44,0,0.44
"17093",2003,"109",0.56,0,0.56
"17094",2003,"110+",1.44,0,1.44
"17095",2004,"0",97670,103111,200781
"17096",2004,"1",98996,104067,203063
"17097",2004,"2",100249,104803,205052
"17098",2004,"3",102204,106402,208606
"17099",2004,"4",99302,104412,203714
"17100",2004,"5",98652,103353,202005
"17101",2004,"6",95995,99777,195772
"17102",2004,"7",94296,99817,194113
"17103",2004,"8",95122,99507,194629
"17104",2004,"9",97726,102244,199970
"17105",2004,"10",97631,101984,199615
"17106",2004,"11",98349,103317,201666
"17107",2004,"12",99977,104508,204485
"17108",2004,"13",99933,105123,205056
"17109",2004,"14",96586,100591,197177
"17110",2004,"15",95389,99921,195310
"17111",2004,"16",95600,100917,196517
"17112",2004,"17",96025,100111,196136
"17113",2004,"18",94021,98737,192758
"17114",2004,"19",93100,98032,191132
"17115",2004,"20",91750,95322,187072
"17116",2004,"21",93336,96510,189846
"17117",2004,"22",97588,98776,196364
"17118",2004,"23",99349,100950,200299
"17119",2004,"24",97243,98039,195282
"17120",2004,"25",98269,99382,197651
"17121",2004,"26",97924,98560,196484
"17122",2004,"27",98931,100856,199787
"17123",2004,"28",100858,101641,202499
"17124",2004,"29",105933,106847,212780
"17125",2004,"30",110458,111106,221564
"17126",2004,"31",120196,120806,241002
"17127",2004,"32",125410,128044,253454
"17128",2004,"33",131075,134500,265575
"17129",2004,"34",133900,138269,272169
"17130",2004,"35",128595,132447,261042
"17131",2004,"36",127271,131760,259031
"17132",2004,"37",127847,132781,260628
"17133",2004,"38",130137,135552,265689
"17134",2004,"39",132767,137581,270348
"17135",2004,"40",130830,135642,266472
"17136",2004,"41",129191,132705,261896
"17137",2004,"42",128387,131401,259788
"17138",2004,"43",125049,128465,253514
"17139",2004,"44",124691,127107,251798
"17140",2004,"45",121434,123791,245225
"17141",2004,"46",119297,121262,240559
"17142",2004,"47",117201,119849,237050
"17143",2004,"48",115341,116477,231818
"17144",2004,"49",113153,115520,228673
"17145",2004,"50",111654,113977,225631
"17146",2004,"51",111864,114412,226276
"17147",2004,"52",107947,110746,218693
"17148",2004,"53",108695,111342,220037
"17149",2004,"54",109951,113035,222986
"17150",2004,"55",113149,116617,229766
"17151",2004,"56",119601,122124,241725
"17152",2004,"57",122569,126315,248884
"17153",2004,"58",88297,90136,178433
"17154",2004,"59",92131,93814,185945
"17155",2004,"60",86967,88771,175738
"17156",2004,"61",80111,81388,161499
"17157",2004,"62",76176,76847,153023
"17158",2004,"63",78417,77791,156208
"17159",2004,"64",75514,73604,149118
"17160",2004,"65",73367,71149,144516
"17161",2004,"66",69031,65473,134504
"17162",2004,"67",68204,64023,132227
"17163",2004,"68",66497,61143,127640
"17164",2004,"69",65578,58743,124321
"17165",2004,"70",63984,55954,119938
"17166",2004,"71",64788,55263,120051
"17167",2004,"72",62879,52087,114966
"17168",2004,"73",62790,50614,113404
"17169",2004,"74",59284,45998,105282
"17170",2004,"75",58303,43595,101898
"17171",2004,"76",54881,39576,94457
"17172",2004,"77",53806,37430,91236
"17173",2004,"78",51967,34009,85976
"17174",2004,"79",51065,31375,82440
"17175",2004,"80",49266.06,29410.3,78676.36
"17176",2004,"81",45644.21,25921.52,71565.73
"17177",2004,"82",43211.43,23188.08,66399.51
"17178",2004,"83",40703.49,20845.18,61548.67
"17179",2004,"84",31724.99,15298.63,47023.62
"17180",2004,"85",27744.74,12265.97,40010.71
"17181",2004,"86",25541.41,10612.05,36153.46
"17182",2004,"87",22638.46,8853.65,31492.11
"17183",2004,"88",19504.3,7187.95,26692.25
"17184",2004,"89",17481.55,6032.75,23514.3
"17185",2004,"90",14385.13,4647.04,19032.17
"17186",2004,"91",11487.82,3448.33,14936.15
"17187",2004,"92",8857.9,2453.98,11311.88
"17188",2004,"93",6846.21,1780.95,8627.16
"17189",2004,"94",5261.3,1262.61,6523.91
"17190",2004,"95",3799.37,839.15,4638.52
"17191",2004,"96",2623.37,539.88,3163.25
"17192",2004,"97",1762.2,369.49,2131.69
"17193",2004,"98",1172.8,238.05,1410.85
"17194",2004,"99",771.32,141.43,912.75
"17195",2004,"100",465.48,83.84,549.32
"17196",2004,"101",279.65,46.92,326.57
"17197",2004,"102",169.22,28.24,197.46
"17198",2004,"103",77.82,16.66,94.48
"17199",2004,"104",36.55,7.55,44.1
"17200",2004,"105",22.14,2.87,25.01
"17201",2004,"106",10.51,1.44,11.95
"17202",2004,"107",3.79,0.44,4.23
"17203",2004,"108",1.44,0,1.44
"17204",2004,"109",0.44,0,0.44
"17205",2004,"110+",1,0,1
"17206",2005,"0",94687,99076,193763
"17207",2005,"1",98124,103198,201322
"17208",2005,"2",98945,103889,202834
"17209",2005,"3",100083,104573,204656
"17210",2005,"4",101951,106100,208051
"17211",2005,"5",98997,104081,203078
"17212",2005,"6",98398,103150,201548
"17213",2005,"7",95779,99504,195283
"17214",2005,"8",94096,99667,193763
"17215",2005,"9",94933,99311,194244
"17216",2005,"10",97641,102155,199796
"17217",2005,"11",97489,101848,199337
"17218",2005,"12",98326,103271,201597
"17219",2005,"13",99889,104460,204349
"17220",2005,"14",99857,105096,204953
"17221",2005,"15",96586,100578,197164
"17222",2005,"16",95346,99899,195245
"17223",2005,"17",95719,100889,196608
"17224",2005,"18",96529,100304,196833
"17225",2005,"19",94923,98610,193533
"17226",2005,"20",93859,97880,191739
"17227",2005,"21",92700,95324,188024
"17228",2005,"22",94338,96560,190898
"17229",2005,"23",98385,99097,197482
"17230",2005,"24",100011,101198,201209
"17231",2005,"25",97776,98253,196029
"17232",2005,"26",98827,99375,198202
"17233",2005,"27",98176,98523,196699
"17234",2005,"28",99135,100591,199726
"17235",2005,"29",101011,101260,202271
"17236",2005,"30",105926,106444,212370
"17237",2005,"31",110411,110716,221127
"17238",2005,"32",120158,120204,240362
"17239",2005,"33",125282,127457,252739
"17240",2005,"34",130889,133912,264801
"17241",2005,"35",133733,137629,271362
"17242",2005,"36",128378,131735,260113
"17243",2005,"37",127009,131105,258114
"17244",2005,"38",127653,132103,259756
"17245",2005,"39",129895,134865,264760
"17246",2005,"40",132521,137003,269524
"17247",2005,"41",130579,134946,265525
"17248",2005,"42",129023,132100,261123
"17249",2005,"43",128098,130852,258950
"17250",2005,"44",124789,127854,252643
"17251",2005,"45",124355,126499,250854
"17252",2005,"46",121082,123224,244306
"17253",2005,"47",118965,120723,239688
"17254",2005,"48",116814,119232,236046
"17255",2005,"49",114908,115877,230785
"17256",2005,"50",112820,114892,227712
"17257",2005,"51",111228,113245,224473
"17258",2005,"52",111373,113730,225103
"17259",2005,"53",107481,109995,217476
"17260",2005,"54",108143,110594,218737
"17261",2005,"55",109450,112206,221656
"17262",2005,"56",112581,115714,228295
"17263",2005,"57",118955,121125,240080
"17264",2005,"58",121888,125128,247016
"17265",2005,"59",87731,89300,177031
"17266",2005,"60",91489,92773,184262
"17267",2005,"61",86366,87717,174083
"17268",2005,"62",79497,80374,159871
"17269",2005,"63",75632,75836,151468
"17270",2005,"64",77723,76686,154409
"17271",2005,"65",74829,72324,147153
"17272",2005,"66",72640,69850,142490
"17273",2005,"67",68301,64178,132479
"17274",2005,"68",67448,62628,130076
"17275",2005,"69",65627,59681,125308
"17276",2005,"70",64646,57155,121801
"17277",2005,"71",62938,54341,117279
"17278",2005,"72",63638,53498,117136
"17279",2005,"73",61644,50181,111825
"17280",2005,"74",61431,48520,109951
"17281",2005,"75",57862,44004,101866
"17282",2005,"76",56739,41478,98217
"17283",2005,"77",53204,37522,90726
"17284",2005,"78",51962,35141,87103
"17285",2005,"79",49921,31766,81687
"17286",2005,"80",48525.95,29129.23,77655.18
"17287",2005,"81",46803.88,26938.06,73741.94
"17288",2005,"82",43010.35,23563.02,66573.37
"17289",2005,"83",40332.69,20894.68,61227.37
"17290",2005,"84",37663.13,18536.35,56199.48
"17291",2005,"85",29034.86,13393.32,42428.18
"17292",2005,"86",25077.8,10592.05,35669.85
"17293",2005,"87",22831,9025.68,31856.68
"17294",2005,"88",19947.94,7362.42,27310.36
"17295",2005,"89",16875.57,5859.64,22735.21
"17296",2005,"90",14819.6,4832.38,19651.98
"17297",2005,"91",11970.55,3649.42,15619.97
"17298",2005,"92",9350.33,2664.14,12014.47
"17299",2005,"93",7013.57,1853.47,8867.04
"17300",2005,"94",5304.17,1302.42,6606.59
"17301",2005,"95",3964.46,897.35,4861.81
"17302",2005,"96",2779.61,582.42,3362.03
"17303",2005,"97",1874.33,353.27,2227.6
"17304",2005,"98",1202.69,232.26,1434.95
"17305",2005,"99",778.33,146.8,925.13
"17306",2005,"100",498.7,80.46,579.16
"17307",2005,"101",295.1,49.8,344.9
"17308",2005,"102",174.76,30.23,204.99
"17309",2005,"103",96.45,18.32,114.77
"17310",2005,"104",39.1,7.73,46.83
"17311",2005,"105",16.82,2.45,19.27
"17312",2005,"106",11.73,1.43,13.16
"17313",2005,"107",5.6,0.44,6.04
"17314",2005,"108",0.89,0,0.89
"17315",2005,"109",0.56,0,0.56
"17316",2005,"110+",1.44,0,1.44
"17317",2006,"0",91268,95904,187172
"17318",2006,"1",94909,99050,193959
"17319",2006,"2",98037,102865,200902
"17320",2006,"3",98665,103536,202201
"17321",2006,"4",99703,104215,203918
"17322",2006,"5",101506,105694,207200
"17323",2006,"6",98623,103707,202330
"17324",2006,"7",98095,102810,200905
"17325",2006,"8",95526,99230,194756
"17326",2006,"9",93910,99476,193386
"17327",2006,"10",94708,99078,193786
"17328",2006,"11",97439,102004,199443
"17329",2006,"12",97397,101710,199107
"17330",2006,"13",98211,103121,201332
"17331",2006,"14",99834,104353,204187
"17332",2006,"15",99784,104990,204774
"17333",2006,"16",96582,100500,197082
"17334",2006,"17",95461,99856,195317
"17335",2006,"18",95930,100905,196835
"17336",2006,"19",96913,100121,197034
"17337",2006,"20",95426,98421,193847
"17338",2006,"21",94590,97718,192308
"17339",2006,"22",93398,95416,188814
"17340",2006,"23",94990,96773,191763
"17341",2006,"24",98882,99130,198012
"17342",2006,"25",100366,101274,201640
"17343",2006,"26",98017,98154,196171
"17344",2006,"27",99050,99141,198191
"17345",2006,"28",98137,98385,196522
"17346",2006,"29",99061,100290,199351
"17347",2006,"30",100910,100855,201765
"17348",2006,"31",105749,105968,211717
"17349",2006,"32",110211,110143,220354
"17350",2006,"33",119831,119604,239435
"17351",2006,"34",124951,126724,251675
"17352",2006,"35",130581,133022,263603
"17353",2006,"36",133369,136716,270085
"17354",2006,"37",127991,130917,258908
"17355",2006,"38",126669,130361,257030
"17356",2006,"39",127314,131335,258649
"17357",2006,"40",129516,134125,263641
"17358",2006,"41",132235,136243,268478
"17359",2006,"42",130242,134322,264564
"17360",2006,"43",128711,131386,260097
"17361",2006,"44",127751,130166,257917
"17362",2006,"45",124438,127175,251613
"17363",2006,"46",123963,125824,249787
"17364",2006,"47",120657,122597,243254
"17365",2006,"48",118558,120070,238628
"17366",2006,"49",116359,118515,234874
"17367",2006,"50",114428,115128,229556
"17368",2006,"51",112372,114194,226566
"17369",2006,"52",110761,112524,223285
"17370",2006,"53",110855,113040,223895
"17371",2006,"54",106985,109238,216223
"17372",2006,"55",107576,109768,217344
"17373",2006,"56",108904,111301,220205
"17374",2006,"57",111884,114811,226695
"17375",2006,"58",118220,120042,238262
"17376",2006,"59",121101,124005,245106
"17377",2006,"60",87128,88321,175449
"17378",2006,"61",90857,91722,182579
"17379",2006,"62",85730,86555,172285
"17380",2006,"63",78884,79322,158206
"17381",2006,"64",75001,74775,149776
"17382",2006,"65",76961,75363,152324
"17383",2006,"66",74110,70920,145030
"17384",2006,"67",71888,68502,140390
"17385",2006,"68",67514,62848,130362
"17386",2006,"69",66628,61212,127840
"17387",2006,"70",64760,58183,122943
"17388",2006,"71",63652,55508,119160
"17389",2006,"72",61845,52642,114487
"17390",2006,"73",62458,51629,114087
"17391",2006,"74",60311,48276,108587
"17392",2006,"75",59905,46396,106301
"17393",2006,"76",56383,41956,98339
"17394",2006,"77",54986,39225,94211
"17395",2006,"78",51338,35315,86653
"17396",2006,"79",49961,32768,82729
"17397",2006,"80",47810.44,29499.81,77310.25
"17398",2006,"81",46162.26,26683.7,72845.96
"17399",2006,"82",44206.89,24446.92,68653.81
"17400",2006,"83",40304.6,21181.98,61486.58
"17401",2006,"84",37454.59,18561.84,56016.43
"17402",2006,"85",34593.51,16306.82,50900.33
"17403",2006,"86",26339.22,11608.55,37947.77
"17404",2006,"87",22420.17,8998.58,31418.75
"17405",2006,"88",20135.46,7561.15,27696.61
"17406",2006,"89",17261.98,6025.81,23287.79
"17407",2006,"90",14310.39,4674.62,18985.01
"17408",2006,"91",12316.97,3798.11,16115.08
"17409",2006,"92",9719.1,2806.41,12525.51
"17410",2006,"93",7447.63,1973.01,9420.64
"17411",2006,"94",5451.48,1322.88,6774.36
"17412",2006,"95",4011.13,906.2,4917.33
"17413",2006,"96",2914.01,612.19,3526.2
"17414",2006,"97",1977.86,384.59,2362.45
"17415",2006,"98",1300.16,222.06,1522.22
"17416",2006,"99",785.71,142.01,927.72
"17417",2006,"100",485.87,90.59,576.46
"17418",2006,"101",312.94,48.46,361.4
"17419",2006,"102",172.47,27.43,199.9
"17420",2006,"103",94.48,15.6,110.08
"17421",2006,"104",50.81,6.84,57.65
"17422",2006,"105",19.36,2.41,21.77
"17423",2006,"106",10.18,0.88,11.06
"17424",2006,"107",8.19,0,8.19
"17425",2006,"108",3.25,0,3.25
"17426",2006,"109",0.45,0,0.45
"17427",2006,"110+",1,0,1
"17428",2007,"0",89797,94628,184425
"17429",2007,"1",91358,95879,187237
"17430",2007,"2",94691,98795,193486
"17431",2007,"3",97790,102502,200292
"17432",2007,"4",98331,103110,201441
"17433",2007,"5",99284,103786,203070
"17434",2007,"6",101149,105293,206442
"17435",2007,"7",98317,103411,201728
"17436",2007,"8",97821,102511,200332
"17437",2007,"9",95368,99057,194425
"17438",2007,"10",93753,99300,193053
"17439",2007,"11",94595,98962,193557
"17440",2007,"12",97300,101862,199162
"17441",2007,"13",97251,101592,198843
"17442",2007,"14",98090,103032,201122
"17443",2007,"15",99775,104244,204019
"17444",2007,"16",99766,104964,204730
"17445",2007,"17",96587,100501,197088
"17446",2007,"18",95598,99876,195474
"17447",2007,"19",96329,100848,197177
"17448",2007,"20",97310,100087,197397
"17449",2007,"21",95834,98256,194090
"17450",2007,"22",95224,97756,192980
"17451",2007,"23",93994,95531,189525
"17452",2007,"24",95285,96758,192043
"17453",2007,"25",99005,99011,198016
"17454",2007,"26",100358,101185,201543
"17455",2007,"27",98056,98066,196122
"17456",2007,"28",98973,98929,197902
"17457",2007,"29",97939,97955,195894
"17458",2007,"30",98851,99831,198682
"17459",2007,"31",100640,100439,201079
"17460",2007,"32",105415,105391,210806
"17461",2007,"33",109817,109403,219220
"17462",2007,"34",119402,118959,238361
"17463",2007,"35",124572,126059,250631
"17464",2007,"36",130215,132235,262450
"17465",2007,"37",132940,135864,268804
"17466",2007,"38",127520,130123,257643
"17467",2007,"39",126292,129656,255948
"17468",2007,"40",126904,130545,257449
"17469",2007,"41",129150,133354,262504
"17470",2007,"42",131866,135432,267298
"17471",2007,"43",129926,133575,263501
"17472",2007,"44",128315,130757,259072
"17473",2007,"45",127404,129562,256966
"17474",2007,"46",124049,126424,250473
"17475",2007,"47",123536,125088,248624
"17476",2007,"48",120267,121941,242208
"17477",2007,"49",118109,119389,237498
"17478",2007,"50",115944,117826,233770
"17479",2007,"51",113979,114457,228436
"17480",2007,"52",111886,113404,225290
"17481",2007,"53",110218,111856,222074
"17482",2007,"54",110362,112296,222658
"17483",2007,"55",106394,108488,214882
"17484",2007,"56",107012,108904,215916
"17485",2007,"57",108284,110398,218682
"17486",2007,"58",111207,113840,225047
"17487",2007,"59",117519,118996,236515
"17488",2007,"60",120302,122767,243069
"17489",2007,"61",86492,87335,173827
"17490",2007,"62",90199,90574,180773
"17491",2007,"63",85010,85380,170390
"17492",2007,"64",78260,78219,156479
"17493",2007,"65",74335,73599,147934
"17494",2007,"66",76211,74069,150280
"17495",2007,"67",73331,69635,142966
"17496",2007,"68",71084,67084,138168
"17497",2007,"69",66679,61465,128144
"17498",2007,"70",65815,59709,125524
"17499",2007,"71",63791,56592,120383
"17500",2007,"72",62625,53868,116493
"17501",2007,"73",60736,50928,111664
"17502",2007,"74",61166,49735,110901
"17503",2007,"75",58891,46368,105259
"17504",2007,"76",58361,44358,102719
"17505",2007,"77",54700,39800,94500
"17506",2007,"78",53143,36968,90111
"17507",2007,"79",49425,33039,82464
"17508",2007,"80",47761.27,30385.46,78146.73
"17509",2007,"81",45517.17,27179.02,72696.19
"17510",2007,"82",43633.27,24387.44,68020.71
"17511",2007,"83",41467.17,22075.88,63543.05
"17512",2007,"84",37455.14,18934.04,56389.18
"17513",2007,"85",34363.14,16407.52,50770.66
"17514",2007,"86",31398.39,14134.58,45532.97
"17515",2007,"87",23587.95,9881.15,33469.1
"17516",2007,"88",19769.13,7554.09,27323.22
"17517",2007,"89",17490.42,6247.88,23738.3
"17518",2007,"90",14666.5,4882.69,19549.19
"17519",2007,"91",11945.55,3679.57,15625.12
"17520",2007,"92",10092.29,2906.32,12998.61
"17521",2007,"93",7744.36,2098.97,9843.33
"17522",2007,"94",5748.48,1418.46,7166.94
"17523",2007,"95",4062.92,922.12,4985.04
"17524",2007,"96",2932.43,628.35,3560.78
"17525",2007,"97",2090.85,426.06,2516.91
"17526",2007,"98",1359.27,254.91,1614.18
"17527",2007,"99",858.27,135.29,993.56
"17528",2007,"100",491.76,80.87,572.63
"17529",2007,"101",292.06,49.18,341.24
"17530",2007,"102",190.83,22.9,213.73
"17531",2007,"103",100.31,12.18,112.49
"17532",2007,"104",45.78,10.1,55.88
"17533",2007,"105",23.26,5.97,29.23
"17534",2007,"106",7.04,1.86,8.9
"17535",2007,"107",2.68,0.44,3.12
"17536",2007,"108",3.43,0,3.43
"17537",2007,"109",1.9,0,1.9
"17538",2007,"110+",0.45,0,0.45
"17539",2008,"0",88550,92212,180762
"17540",2008,"1",89960,94737,184697
"17541",2008,"2",91385,95788,187173
"17542",2008,"3",94592,98583,193175
"17543",2008,"4",97617,102303,199920
"17544",2008,"5",98035,102861,200896
"17545",2008,"6",99042,103559,202601
"17546",2008,"7",100946,105151,206097
"17547",2008,"8",98210,103248,201458
"17548",2008,"9",97712,102381,200093
"17549",2008,"10",95270,98999,194269
"17550",2008,"11",93720,99306,193026
"17551",2008,"12",94537,98971,193508
"17552",2008,"13",97282,101850,199132
"17553",2008,"14",97264,101653,198917
"17554",2008,"15",98101,103066,201167
"17555",2008,"16",99928,104322,204250
"17556",2008,"17",99894,105077,204971
"17557",2008,"18",96920,100773,197693
"17558",2008,"19",96397,100248,196645
"17559",2008,"20",97311,101223,198534
"17560",2008,"21",98390,100443,198833
"17561",2008,"22",96791,98582,195373
"17562",2008,"23",96056,98327,194383
"17563",2008,"24",94612,96022,190634
"17564",2008,"25",95979,97285,193264
"17565",2008,"26",99537,99556,199093
"17566",2008,"27",100846,101405,202251
"17567",2008,"28",98289,98308,196597
"17568",2008,"29",99334,99167,198501
"17569",2008,"30",98019,97877,195896
"17570",2008,"31",98937,99708,198645
"17571",2008,"32",100595,100453,201048
"17572",2008,"33",105330,105216,210546
"17573",2008,"34",109631,109215,218846
"17574",2008,"35",119247,118639,237886
"17575",2008,"36",124310,125709,250019
"17576",2008,"37",129991,131718,261709
"17577",2008,"38",132608,135385,267993
"17578",2008,"39",127330,129682,257012
"17579",2008,"40",126038,129122,255160
"17580",2008,"41",126652,130096,256748
"17581",2008,"42",128859,132863,261722
"17582",2008,"43",131551,134974,266525
"17583",2008,"44",129608,133141,262749
"17584",2008,"45",128047,130223,258270
"17585",2008,"46",127103,128944,256047
"17586",2008,"47",123751,125925,249676
"17587",2008,"48",123184,124556,247740
"17588",2008,"49",119887,121393,241280
"17589",2008,"50",117723,118863,236586
"17590",2008,"51",115536,117285,232821
"17591",2008,"52",113514,113852,227366
"17592",2008,"53",111395,112782,224177
"17593",2008,"54",109795,111108,220903
"17594",2008,"55",109816,111554,221370
"17595",2008,"56",105890,107754,213644
"17596",2008,"57",106436,108072,214508
"17597",2008,"58",107672,109458,217130
"17598",2008,"59",110558,112801,223359
"17599",2008,"60",116767,117800,234567
"17600",2008,"61",119437,121477,240914
"17601",2008,"62",85866,86318,172184
"17602",2008,"63",89507,89427,178934
"17603",2008,"64",84362,84318,168680
"17604",2008,"65",77569,77022,154591
"17605",2008,"66",73611,72305,145916
"17606",2008,"67",75479,72748,148227
"17607",2008,"68",72508,68325,140833
"17608",2008,"69",70217,65675,135892
"17609",2008,"70",65802,60003,125805
"17610",2008,"71",64934,58170,123104
"17611",2008,"72",62781,55007,117788
"17612",2008,"73",61480,52190,113670
"17613",2008,"74",59521,49147,108668
"17614",2008,"75",59816,47800,107616
"17615",2008,"76",57476,44305,101781
"17616",2008,"77",56746,42183,98929
"17617",2008,"78",52957,37624,90581
"17618",2008,"79",51276,34660,85936
"17619",2008,"80",47921.36,30998.49,78919.85
"17620",2008,"81",45608.87,28138.15,73747.02
"17621",2008,"82",43159.7,24893.95,68053.65
"17622",2008,"83",41040.41,22087.75,63128.16
"17623",2008,"84",38647.24,19765.81,58413.05
"17624",2008,"85",34532.45,16733.18,51265.63
"17625",2008,"86",31303.1,14315.8,45618.9
"17626",2008,"87",28261.04,12128.86,40389.9
"17627",2008,"88",20977.53,8348.63,29326.16
"17628",2008,"89",17296.51,6247.62,23544.13
"17629",2008,"90",15010.76,5017.55,20028.31
"17630",2008,"91",12329.52,3829.71,16159.23
"17631",2008,"92",9847.74,2846.27,12694.01
"17632",2008,"93",8168.33,2215.95,10384.28
"17633",2008,"94",6093.29,1550.59,7643.88
"17634",2008,"95",4362.9,1008.86,5371.76
"17635",2008,"96",3011.34,635.62,3646.96
"17636",2008,"97",2129.22,426.05,2555.27
"17637",2008,"98",1484.34,284.59,1768.93
"17638",2008,"99",935.96,159.89,1095.85
"17639",2008,"100",556.48,79.8,636.28
"17640",2008,"101",296.81,51.62,348.43
"17641",2008,"102",172.2,30.43,202.63
"17642",2008,"103",118.04,8.69,126.73
"17643",2008,"104",56.08,4.69,60.77
"17644",2008,"105",23.49,4.97,28.46
"17645",2008,"106",13.53,2.21,15.74
"17646",2008,"107",3.97,0.99,4.96
"17647",2008,"108",1.56,0.44,2
"17648",2008,"109",2.54,0,2.54
"17649",2008,"110+",2.35,0,2.35
"17650",2009,"0",89717,94691,184408
"17651",2009,"1",88963,92606,181569
"17652",2009,"2",90196,94857,185053
"17653",2009,"3",91436,95888,187324
"17654",2009,"4",94572,98630,193202
"17655",2009,"5",97540,102276,199816
"17656",2009,"6",97950,102762,200712
"17657",2009,"7",99013,103510,202523
"17658",2009,"8",100944,105166,206110
"17659",2009,"9",98191,103282,201473
"17660",2009,"10",97743,102407,200150
"17661",2009,"11",95345,99103,194448
"17662",2009,"12",93813,99403,193216
"17663",2009,"13",94637,99109,193746
"17664",2009,"14",97357,101951,199308
"17665",2009,"15",97350,101718,199068
"17666",2009,"16",98224,103270,201494
"17667",2009,"17",100129,104492,204621
"17668",2009,"18",100471,105437,205908
"17669",2009,"19",98101,101335,199436
"17670",2009,"20",97902,101018,198920
"17671",2009,"21",98901,102211,201112
"17672",2009,"22",100052,101445,201497
"17673",2009,"23",98303,99895,198198
"17674",2009,"24",97384,99748,197132
"17675",2009,"25",95874,97342,193216
"17676",2009,"26",96922,98461,195383
"17677",2009,"27",100265,100717,200982
"17678",2009,"28",101690,102466,204156
"17679",2009,"29",98846,99390,198236
"17680",2009,"30",99722,99655,199377
"17681",2009,"31",98445,98512,196957
"17682",2009,"32",99260,100067,199327
"17683",2009,"33",100887,100852,201739
"17684",2009,"34",105542,105478,211020
"17685",2009,"35",109791,109448,219239
"17686",2009,"36",119286,118714,238000
"17687",2009,"37",124347,125675,250022
"17688",2009,"38",129964,131637,261601
"17689",2009,"39",132559,135188,267747
"17690",2009,"40",127249,129541,256790
"17691",2009,"41",125871,128903,254774
"17692",2009,"42",126602,129949,256551
"17693",2009,"43",128739,132603,261342
"17694",2009,"44",131387,134725,266112
"17695",2009,"45",129418,132771,262189
"17696",2009,"46",127859,129940,257799
"17697",2009,"47",126908,128554,255462
"17698",2009,"48",123515,125587,249102
"17699",2009,"49",122845,124151,246996
"17700",2009,"50",119570,120953,240523
"17701",2009,"51",117398,118345,235743
"17702",2009,"52",115167,116704,231871
"17703",2009,"53",113085,113275,226360
"17704",2009,"54",110951,112232,223183
"17705",2009,"55",109378,110536,219914
"17706",2009,"56",109294,110811,220105
"17707",2009,"57",105359,106995,212354
"17708",2009,"58",105872,107273,213145
"17709",2009,"59",107034,108580,215614
"17710",2009,"60",109824,111739,221563
"17711",2009,"61",115954,116600,232554
"17712",2009,"62",118586,120170,238756
"17713",2009,"63",85221,85339,170560
"17714",2009,"64",88811,88353,177164
"17715",2009,"65",83516,83025,166541
"17716",2009,"66",76829,75730,152559
"17717",2009,"67",72907,71083,143990
"17718",2009,"68",74642,71374,146016
"17719",2009,"69",71695,66958,138653
"17720",2009,"70",69357,64235,133592
"17721",2009,"71",64890,58567,123457
"17722",2009,"72",63898,56630,120528
"17723",2009,"73",61709,53359,115068
"17724",2009,"74",60340,50525,110865
"17725",2009,"75",58216,47308,105524
"17726",2009,"76",58443,45827,104270
"17727",2009,"77",55931,42222,98153
"17728",2009,"78",54928,39912,94840
"17729",2009,"79",51158,35393,86551
"17730",2009,"80",49103.91,32402.84,81506.75
"17731",2009,"81",45694.36,28750.22,74444.58
"17732",2009,"82",43229.97,25844.61,69074.58
"17733",2009,"83",40577.01,22608.2,63185.21
"17734",2009,"84",38259.54,19833.82,58093.36
"17735",2009,"85",35682.38,17530.62,53213
"17736",2009,"86",31500.83,14682.34,46183.17
"17737",2009,"87",28202.84,12384.5,40587.34
"17738",2009,"88",25074.83,10272.84,35347.67
"17739",2009,"89",18300.99,6919.94,25220.93
"17740",2009,"90",14783.12,5082.91,19866.03
"17741",2009,"91",12578.64,3997.08,16575.72
"17742",2009,"92",10130.25,2955.28,13085.53
"17743",2009,"93",7900.43,2136.21,10036.64
"17744",2009,"94",6360.25,1615.41,7975.66
"17745",2009,"95",4588.82,1100.37,5689.19
"17746",2009,"96",3198.18,689.35,3887.53
"17747",2009,"97",2148.99,423.82,2572.81
"17748",2009,"98",1465.39,279.75,1745.14
"17749",2009,"99",979.97,181.03,1161
"17750",2009,"100",599.57,95.44,695.01
"17751",2009,"101",353.93,43.78,397.71
"17752",2009,"102",179.94,27.36,207.3
"17753",2009,"103",98.41,15.87,114.28
"17754",2009,"104",63.41,4.63,68.04
"17755",2009,"105",30.05,2.56,32.61
"17756",2009,"106",12.42,2.53,14.95
"17757",2009,"107",4.8,0.77,5.57
"17758",2009,"108",0.78,0,0.78
"17759",2009,"109",0.56,0,0.56
"17760",2009,"110+",2.45,0,2.45
"17761",2010,"0",90186,94400,184586
"17762",2010,"1",90191,95024,185215
"17763",2010,"2",89211,92895,182106
"17764",2010,"3",90395,95057,185452
"17765",2010,"4",91524,95998,187522
"17766",2010,"5",94651,98694,193345
"17767",2010,"6",97569,102325,199894
"17768",2010,"7",97974,102843,200817
"17769",2010,"8",99080,103609,202689
"17770",2010,"9",101167,105337,206504
"17771",2010,"10",98392,103381,201773
"17772",2010,"11",97917,102594,200511
"17773",2010,"12",95549,99277,194826
"17774",2010,"13",93992,99576,193568
"17775",2010,"14",94805,99298,194103
"17776",2010,"15",97580,102235,199815
"17777",2010,"16",97587,102041,199628
"17778",2010,"17",98488,103636,202124
"17779",2010,"18",100731,105120,205851
"17780",2010,"19",101715,106290,208005
"17781",2010,"20",99762,102284,202046
"17782",2010,"21",99743,102229,201972
"17783",2010,"22",100464,103411,203875
"17784",2010,"23",101473,102871,204344
"17785",2010,"24",99552,101121,200673
"17786",2010,"25",98516,100842,199358
"17787",2010,"26",96808,98330,195138
"17788",2010,"27",97758,99358,197116
"17789",2010,"28",100968,101361,202329
"17790",2010,"29",102293,103121,205414
"17791",2010,"30",99245,99997,199242
"17792",2010,"31",100158,100187,200345
"17793",2010,"32",98810,98924,197734
"17794",2010,"33",99509,100497,200006
"17795",2010,"34",101123,101108,202231
"17796",2010,"35",105754,105666,211420
"17797",2010,"36",109887,109664,219551
"17798",2010,"37",119436,118799,238235
"17799",2010,"38",124469,125616,250085
"17800",2010,"39",129997,131661,261658
"17801",2010,"40",132610,135172,267782
"17802",2010,"41",127274,129528,256802
"17803",2010,"42",125866,128787,254653
"17804",2010,"43",126575,129819,256394
"17805",2010,"44",128703,132446,261149
"17806",2010,"45",131356,134485,265841
"17807",2010,"46",129325,132465,261790
"17808",2010,"47",127697,129670,257367
"17809",2010,"48",126711,128270,254981
"17810",2010,"49",123342,125236,248578
"17811",2010,"50",122533,123764,246297
"17812",2010,"51",119257,120485,239742
"17813",2010,"52",117054,117885,234939
"17814",2010,"53",114803,116198,231001
"17815",2010,"54",112681,112707,225388
"17816",2010,"55",110480,111675,222155
"17817",2010,"56",108924,109787,218711
"17818",2010,"57",108833,110111,218944
"17819",2010,"58",104948,106267,211215
"17820",2010,"59",105336,106483,211819
"17821",2010,"60",106427,107700,214127
"17822",2010,"61",109151,110689,219840
"17823",2010,"62",115160,115351,230511
"17824",2010,"63",117723,118848,236571
"17825",2010,"64",84636,84322,168958
"17826",2010,"65",87996,87032,175028
"17827",2010,"66",82768,81738,164506
"17828",2010,"67",76106,74518,150624
"17829",2010,"68",72202,69792,141994
"17830",2010,"69",73825,69972,143797
"17831",2010,"70",70843,65559,136402
"17832",2010,"71",68429,62729,131158
"17833",2010,"72",63971,57093,121064
"17834",2010,"73",62849,54920,117769
"17835",2010,"74",60592,51573,112165
"17836",2010,"75",59174,48634,107808
"17837",2010,"76",56856,45298,102154
"17838",2010,"77",56911,43729,100640
"17839",2010,"78",54282,40189,94471
"17840",2010,"79",53137,37617,90754
"17841",2010,"80",49232.74,33143.27,82376.01
"17842",2010,"81",46914.86,30045.74,76960.6
"17843",2010,"82",43357.25,26454.67,69811.92
"17844",2010,"83",40745.83,23562.29,64308.12
"17845",2010,"84",37947.02,20396.62,58343.64
"17846",2010,"85",35464.86,17656.59,53121.45
"17847",2010,"86",32689.74,15417.23,48106.97
"17848",2010,"87",28475.55,12751.71,41227.26
"17849",2010,"88",25178.09,10566.16,35744.25
"17850",2010,"89",21984.46,8607.62,30592.08
"17851",2010,"90",15703.91,5680.65,21384.56
"17852",2010,"91",12449.7,4070.26,16519.96
"17853",2010,"92",10437.67,3120.08,13557.75
"17854",2010,"93",8223.17,2236.01,10459.18
"17855",2010,"94",6220.22,1580.84,7801.06
"17856",2010,"95",4864.45,1163.45,6027.9
"17857",2010,"96",3415.04,775.59,4190.63
"17858",2010,"97",2313.48,477.2,2790.68
"17859",2010,"98",1498.57,287.07,1785.64
"17860",2010,"99",986.33,180.61,1166.94
"17861",2010,"100",636.91,111.65,748.56
"17862",2010,"101",370.65,57.08,427.73
"17863",2010,"102",205.51,26.24,231.75
"17864",2010,"103",97.82,15.82,113.64
"17865",2010,"104",55.46,9.5,64.96
"17866",2010,"105",35.54,3.75,39.29
"17867",2010,"106",16.94,2,18.94
"17868",2010,"107",6.99,2.1,9.09
"17869",2010,"108",2,0.77,2.77
"17870",2010,"109",0.34,0,0.34
"17871",2010,"110+",0,0,0
"17872",2011,"0",90115,93892,184007
"17873",2011,"1",90504,94784,185288
"17874",2011,"2",90376,95310,185686
"17875",2011,"3",89333,93062,182395
"17876",2011,"4",90470,95260,185730
"17877",2011,"5",91626,96038,187664
"17878",2011,"6",94696,98753,193449
"17879",2011,"7",97719,102453,200172
"17880",2011,"8",98082,102900,200982
"17881",2011,"9",99224,103738,202962
"17882",2011,"10",101263,105472,206735
"17883",2011,"11",98557,103486,202043
"17884",2011,"12",98119,102780,200899
"17885",2011,"13",95672,99476,195148
"17886",2011,"14",94155,99760,193915
"17887",2011,"15",94993,99464,194457
"17888",2011,"16",97778,102507,200285
"17889",2011,"17",97814,102452,200266
"17890",2011,"18",99231,104378,203609
"17891",2011,"19",102098,106029,208127
"17892",2011,"20",103631,107240,210871
"17893",2011,"21",101766,103544,205310
"17894",2011,"22",101576,103381,204957
"17895",2011,"23",102132,104609,206741
"17896",2011,"24",102957,103893,206850
"17897",2011,"25",100747,102254,203001
"17898",2011,"26",99453,101566,201019
"17899",2011,"27",97477,98912,196389
"17900",2011,"28",98357,99677,198034
"17901",2011,"29",101387,101708,203095
"17902",2011,"30",102761,103456,206217
"17903",2011,"31",99559,100183,199742
"17904",2011,"32",100378,100285,200663
"17905",2011,"33",99029,98961,197990
"17906",2011,"34",99714,100438,200152
"17907",2011,"35",101215,101072,202287
"17908",2011,"36",105961,105604,211565
"17909",2011,"37",110069,109541,219610
"17910",2011,"38",119515,118642,238157
"17911",2011,"39",124519,125430,249949
"17912",2011,"40",129990,131482,261472
"17913",2011,"41",132605,134992,267597
"17914",2011,"42",127318,129231,256549
"17915",2011,"43",125814,128451,254265
"17916",2011,"44",126534,129508,256042
"17917",2011,"45",128588,132059,260647
"17918",2011,"46",131220,134182,265402
"17919",2011,"47",129137,132068,261205
"17920",2011,"48",127546,129163,256709
"17921",2011,"49",126499,127830,254329
"17922",2011,"50",123088,124776,247864
"17923",2011,"51",122169,123295,245464
"17924",2011,"52",118923,119999,238922
"17925",2011,"53",116702,117371,234073
"17926",2011,"54",114397,115599,229996
"17927",2011,"55",112221,112045,224266
"17928",2011,"56",109977,110973,220950
"17929",2011,"57",108405,109081,217486
"17930",2011,"58",108318,109389,217707
"17931",2011,"59",104374,105464,209838
"17932",2011,"60",104763,105578,210341
"17933",2011,"61",105769,106770,212539
"17934",2011,"62",108425,109595,218020
"17935",2011,"63",114333,114074,228407
"17936",2011,"64",116916,117429,234345
"17937",2011,"65",83894,83060,166954
"17938",2011,"66",87232,85649,172881
"17939",2011,"67",81927,80381,162308
"17940",2011,"68",75400,73201,148601
"17941",2011,"69",71382,68434,139816
"17942",2011,"70",72944,68501,141445
"17943",2011,"71",69970,64100,134070
"17944",2011,"72",67469,61177,128646
"17945",2011,"73",62930,55484,118414
"17946",2011,"74",61663,53280,114943
"17947",2011,"75",59316,49701,109017
"17948",2011,"76",57814,46736,104550
"17949",2011,"77",55341,43236,98577
"17950",2011,"78",55274,41441,96715
"17951",2011,"79",52468,37994,90462
"17952",2011,"80",50965.99,35124.42,86090.41
"17953",2011,"81",47075.07,30862.37,77937.44
"17954",2011,"82",44580.47,27748.35,72328.82
"17955",2011,"83",40871.88,24195.88,65067.76
"17956",2011,"84",38152.7,21336.69,59489.39
"17957",2011,"85",35233.4,18263.26,53496.66
"17958",2011,"86",32568.78,15580.22,48149
"17959",2011,"87",29576.79,13378.14,42954.93
"17960",2011,"88",25392.54,10906.07,36298.61
"17961",2011,"89",22113.59,8848.98,30962.57
"17962",2011,"90",18901.13,7057.01,25958.14
"17963",2011,"91",13278.78,4551.77,17830.55
"17964",2011,"92",10288.91,3178.13,13467.04
"17965",2011,"93",8410.26,2389.82,10800.08
"17966",2011,"94",6482.77,1642.65,8125.42
"17967",2011,"95",4774.39,1126.93,5901.32
"17968",2011,"96",3620.12,812.23,4432.35
"17969",2011,"97",2465.13,535.75,3000.88
"17970",2011,"98",1629.29,315.15,1944.44
"17971",2011,"99",1017.1,173.22,1190.32
"17972",2011,"100",627.42,107.25,734.67
"17973",2011,"101",387.86,66.18,454.04
"17974",2011,"102",216.02,30.45,246.47
"17975",2011,"103",116.67,11.89,128.56
"17976",2011,"104",56.25,8.66,64.91
"17977",2011,"105",29.41,5.62,35.03
"17978",2011,"106",18.46,1.88,20.34
"17979",2011,"107",10.15,1,11.15
"17980",2011,"108",3.66,1.1,4.76
"17981",2011,"109",1.11,0.34,1.45
"17982",2011,"110+",0.34,0,0.34
"17983",2012,"0",87558,92095,179653
"17984",2012,"1",90464,94277,184741
"17985",2012,"2",90634,95056,185690
"17986",2012,"3",90478,95484,185962
"17987",2012,"4",89435,93255,182690
"17988",2012,"5",90482,95326,185808
"17989",2012,"6",91692,96080,187772
"17990",2012,"7",94756,98819,193575
"17991",2012,"8",97778,102511,200289
"17992",2012,"9",98259,102989,201248
"17993",2012,"10",99379,103855,203234
"17994",2012,"11",101411,105577,206988
"17995",2012,"12",98763,103677,202440
"17996",2012,"13",98225,102939,201164
"17997",2012,"14",95781,99624,195405
"17998",2012,"15",94320,99957,194277
"17999",2012,"16",95224,99707,194931
"18000",2012,"17",98048,102855,200903
"18001",2012,"18",98645,103172,201817
"18002",2012,"19",100774,105393,206167
"18003",2012,"20",103952,107151,211103
"18004",2012,"21",105529,108555,214084
"18005",2012,"22",103279,104690,207969
"18006",2012,"23",102941,104609,207550
"18007",2012,"24",103208,105623,208831
"18008",2012,"25",103792,104823,208615
"18009",2012,"26",101569,103034,204603
"18010",2012,"27",99959,102265,202224
"18011",2012,"28",97917,99383,197300
"18012",2012,"29",98691,99878,198569
"18013",2012,"30",101723,101858,203581
"18014",2012,"31",102949,103730,206679
"18015",2012,"32",99694,100265,199959
"18016",2012,"33",100462,100315,200777
"18017",2012,"34",99263,99000,198263
"18018",2012,"35",99766,100518,200284
"18019",2012,"36",101337,101006,202343
"18020",2012,"37",106110,105472,211582
"18021",2012,"38",110115,109500,219615
"18022",2012,"39",119487,118475,237962
"18023",2012,"40",124449,125365,249814
"18024",2012,"41",130048,131261,261309
"18025",2012,"42",132556,134636,267192
"18026",2012,"43",127289,129064,256353
"18027",2012,"44",125723,128162,253885
"18028",2012,"45",126510,129258,255768
"18029",2012,"46",128501,131562,260063
"18030",2012,"47",131053,133800,264853
"18031",2012,"48",128935,131623,260558
"18032",2012,"49",127335,128728,256063
"18033",2012,"50",126239,127390,253629
"18034",2012,"51",122795,124228,247023
"18035",2012,"52",121841,122834,244675
"18036",2012,"53",118520,119535,238055
"18037",2012,"54",116305,116756,233061
"18038",2012,"55",113951,115097,229048
"18039",2012,"56",111744,111433,223177
"18040",2012,"57",109542,110310,219852
"18041",2012,"58",107855,108374,216229
"18042",2012,"59",107754,108482,216236
"18043",2012,"60",103759,104613,208372
"18044",2012,"61",104135,104685,208820
"18045",2012,"62",105090,105767,210857
"18046",2012,"63",107681,108475,216156
"18047",2012,"64",113496,112789,226285
"18048",2012,"65",115931,115864,231795
"18049",2012,"66",83094,81810,164904
"18050",2012,"67",86340,84379,170719
"18051",2012,"68",81114,79088,160202
"18052",2012,"69",74588,71848,146436
"18053",2012,"70",70490,67092,137582
"18054",2012,"71",71987,67066,139053
"18055",2012,"72",68972,62543,131515
"18056",2012,"73",66417,59566,125983
"18057",2012,"74",61772,53848,115620
"18058",2012,"75",60445,51481,111926
"18059",2012,"76",57932,47841,105773
"18060",2012,"77",56309,44758,101067
"18061",2012,"78",53788,41205,94993
"18062",2012,"79",53563,39222,92785
"18063",2012,"80",50431.2,35763.79,86194.99
"18064",2012,"81",48797.75,32700.78,81498.53
"18065",2012,"82",44744.97,28494.99,73239.96
"18066",2012,"83",42070.57,25438.66,67509.23
"18067",2012,"84",38277.39,21980.96,60258.35
"18068",2012,"85",35414.09,19159.91,54574
"18069",2012,"86",32359.72,16198.11,48557.83
"18070",2012,"87",29520.67,13623.42,43144.09
"18071",2012,"88",26472.96,11472.32,37945.28
"18072",2012,"89",22398.31,9177.92,31576.23
"18073",2012,"90",19152.55,7318.53,26471.08
"18074",2012,"91",16051.81,5721.36,21773.17
"18075",2012,"92",11021.68,3592.62,14614.3
"18076",2012,"93",8327.81,2434.04,10761.85
"18077",2012,"94",6672.67,1815.34,8488.01
"18078",2012,"95",5002.41,1206.22,6208.63
"18079",2012,"96",3589.59,794.66,4384.25
"18080",2012,"97",2653.88,557.87,3211.75
"18081",2012,"98",1749.35,361.53,2110.88
"18082",2012,"99",1111.77,201.89,1313.66
"18083",2012,"100",670.77,101.7,772.47
"18084",2012,"101",403.85,59.19,463.04
"18085",2012,"102",229.12,30.08,259.2
"18086",2012,"103",125.59,13.92,139.51
"18087",2012,"104",66.74,7.58,74.32
"18088",2012,"105",30.19,5.1,35.29
"18089",2012,"106",15.99,2.75,18.74
"18090",2012,"107",8.21,0.44,8.65
"18091",2012,"108",3.82,0,3.82
"18092",2012,"109",0.89,0.66,1.55
"18093",2012,"110+",0,0.34,0.34
"18094",2013,"0",85630,89957,175587
"18095",2013,"1",87698,92368,180066
"18096",2013,"2",90515,94354,184869
"18097",2013,"3",90608,95073,185681
"18098",2013,"4",90518,95481,185999
"18099",2013,"5",89355,93174,182529
"18100",2013,"6",90401,95340,185741
"18101",2013,"7",91690,96023,187713
"18102",2013,"8",94786,98820,193606
"18103",2013,"9",97855,102542,200397
"18104",2013,"10",98304,103043,201347
"18105",2013,"11",99384,103940,203324
"18106",2013,"12",101527,105641,207168
"18107",2013,"13",98825,103735,202560
"18108",2013,"14",98307,103028,201335
"18109",2013,"15",95862,99713,195575
"18110",2013,"16",94499,100132,194631
"18111",2013,"17",95422,99943,195365
"18112",2013,"18",98964,103691,202655
"18113",2013,"19",100345,104280,204625
"18114",2013,"20",102547,106387,208934
"18115",2013,"21",105456,107995,213451
"18116",2013,"22",106717,109307,216024
"18117",2013,"23",104234,105380,209614
"18118",2013,"24",103516,105148,208664
"18119",2013,"25",103575,105838,209413
"18120",2013,"26",104055,104966,209021
"18121",2013,"27",101785,103180,204965
"18122",2013,"28",100224,102220,202444
"18123",2013,"29",98125,99422,197547
"18124",2013,"30",98967,99902,198869
"18125",2013,"31",101728,101634,203362
"18126",2013,"32",103045,103548,206593
"18127",2013,"33",99859,100086,199945
"18128",2013,"34",100471,100229,200700
"18129",2013,"35",99277,98749,198026
"18130",2013,"36",99853,100321,200174
"18131",2013,"37",101303,100718,202021
"18132",2013,"38",106059,105195,211254
"18133",2013,"39",110121,109216,219337
"18134",2013,"40",119378,118099,237477
"18135",2013,"41",124415,124925,249340
"18136",2013,"42",129903,130799,260702
"18137",2013,"43",132439,134322,266761
"18138",2013,"44",127225,128685,255910
"18139",2013,"45",125609,127853,253462
"18140",2013,"46",126367,128808,255175
"18141",2013,"47",128228,131137,259365
"18142",2013,"48",130820,133360,264180
"18143",2013,"49",128770,131072,259842
"18144",2013,"50",127073,128243,255316
"18145",2013,"51",125878,126805,252683
"18146",2013,"52",122504,123630,246134
"18147",2013,"53",121482,122331,243813
"18148",2013,"54",118097,118868,236965
"18149",2013,"55",115819,116095,231914
"18150",2013,"56",113525,114411,227936
"18151",2013,"57",111279,110650,221929
"18152",2013,"58",108995,109542,218537
"18153",2013,"59",107288,107573,214861
"18154",2013,"60",107167,107642,214809
"18155",2013,"61",103094,103739,206833
"18156",2013,"62",103464,103659,207123
"18157",2013,"63",104314,104605,208919
"18158",2013,"64",106882,107231,214113
"18159",2013,"65",112434,111268,223702
"18160",2013,"66",114873,114195,229068
"18161",2013,"67",82281,80549,162830
"18162",2013,"68",85427,82945,168372
"18163",2013,"69",80208,77634,157842
"18164",2013,"70",73701,70353,144054
"18165",2013,"71",69534,65649,135183
"18166",2013,"72",70892,65490,136382
"18167",2013,"73",67943,60877,128820
"18168",2013,"74",65303,57838,123141
"18169",2013,"75",60545,52097,112642
"18170",2013,"76",59070,49610,108680
"18171",2013,"77",56508,45900,102408
"18172",2013,"78",54722,42634,97356
"18173",2013,"79",52050,38995,91045
"18174",2013,"80",51582,36876,88458
"18175",2013,"81",48247.57,33365.54,81613.11
"18176",2013,"82",46423.38,30210.58,76633.96
"18177",2013,"83",42296.04,26081.82,68377.86
"18178",2013,"84",39410.83,23044.36,62455.19
"18179",2013,"85",35485.59,19636.73,55122.32
"18180",2013,"86",32455.55,16919.02,49374.57
"18181",2013,"87",29262.36,14089.91,43352.27
"18182",2013,"88",26369.62,11668.96,38038.58
"18183",2013,"89",23331.51,9688.66,33020.17
"18184",2013,"90",19313.48,7534.28,26847.76
"18185",2013,"91",16142.23,5836.48,21978.71
"18186",2013,"92",13192.22,4488.44,17680.66
"18187",2013,"93",8877.12,2748.26,11625.38
"18188",2013,"94",6567.55,1781.16,8348.71
"18189",2013,"95",5087.58,1284.58,6372.16
"18190",2013,"96",3710.94,842.23,4553.17
"18191",2013,"97",2571.23,540.95,3112.18
"18192",2013,"98",1847.12,363.11,2210.23
"18193",2013,"99",1183.96,225.99,1409.95
"18194",2013,"100",705.54,123.32,828.86
"18195",2013,"101",408.06,64.32,472.38
"18196",2013,"102",232.02,32.75,264.77
"18197",2013,"103",126.58,15.97,142.55
"18198",2013,"104",63.9,7.02,70.92
"18199",2013,"105",31.67,3.28,34.95
"18200",2013,"106",15.05,0.98,16.03
"18201",2013,"107",6.78,0,6.78
"18202",2013,"108",2.86,0,2.86
"18203",2013,"109",0.93,0,0.93
"18204",2013,"110+",0,0,0
"18205",2014,"0",83190,87763,170953
"18206",2014,"1",85798,90184,175982
"18207",2014,"2",87734,92438,180172
"18208",2014,"3",90515,94351,184866
"18209",2014,"4",90638,95058,185696
"18210",2014,"5",90506,95374,185880
"18211",2014,"6",89370,93242,182612
"18212",2014,"7",90485,95470,185955
"18213",2014,"8",91791,96103,187894
"18214",2014,"9",94875,98946,193821
"18215",2014,"10",97995,102717,200712
"18216",2014,"11",98419,103155,201574
"18217",2014,"12",99469,104107,203576
"18218",2014,"13",101659,105841,207500
"18219",2014,"14",98975,103906,202881
"18220",2014,"15",98447,103223,201670
"18221",2014,"16",96056,99934,195990
"18222",2014,"17",94711,100357,195068
"18223",2014,"18",96576,100920,197496
"18224",2014,"19",100707,105035,205742
"18225",2014,"20",101980,105405,207385
"18226",2014,"21",103950,107317,211267
"18227",2014,"22",106538,108916,215454
"18228",2014,"23",107410,110062,217472
"18229",2014,"24",104752,105979,210731
"18230",2014,"25",103725,105371,209096
"18231",2014,"26",103709,106168,209877
"18232",2014,"27",104316,105274,209590
"18233",2014,"28",102082,103378,205460
"18234",2014,"29",100426,102329,202755
"18235",2014,"30",98207,99539,197746
"18236",2014,"31",99017,100065,199082
"18237",2014,"32",101842,101631,203473
"18238",2014,"33",103056,103460,206516
"18239",2014,"34",99965,100095,200060
"18240",2014,"35",100506,100148,200654
"18241",2014,"36",99347,98600,197947
"18242",2014,"37",99822,100250,200072
"18243",2014,"38",101287,100678,201965
"18244",2014,"39",106032,105018,211050
"18245",2014,"40",110070,109017,219087
"18246",2014,"41",119410,117813,237223
"18247",2014,"42",124446,124804,249250
"18248",2014,"43",129869,130567,260436
"18249",2014,"44",132329,133990,266319
"18250",2014,"45",127095,128325,255420
"18251",2014,"46",125458,127537,252995
"18252",2014,"47",126244,128479,254723
"18253",2014,"48",128042,130798,258840
"18254",2014,"49",130574,132926,263500
"18255",2014,"50",128472,130522,258994
"18256",2014,"51",126798,127708,254506
"18257",2014,"52",125579,126236,251815
"18258",2014,"53",122148,123027,245175
"18259",2014,"54",121072,121705,242777
"18260",2014,"55",117688,118220,235908
"18261",2014,"56",115388,115440,230828
"18262",2014,"57",113072,113652,226724
"18263",2014,"58",110803,109876,220679
"18264",2014,"59",108460,108710,217170
"18265",2014,"60",106685,106712,213397
"18266",2014,"61",106516,106729,213245
"18267",2014,"62",102365,102818,205183
"18268",2014,"63",102717,102636,205353
"18269",2014,"64",103575,103451,207026
"18270",2014,"65",105960,105864,211824
"18271",2014,"66",111406,109724,221130
"18272",2014,"67",113842,112462,226304
"18273",2014,"68",81419,79192,160611
"18274",2014,"69",84445,81446,165891
"18275",2014,"70",79239,76102,155341
"18276",2014,"71",72759,68798,141557
"18277",2014,"72",68587,64114,132701
"18278",2014,"73",69807,63789,133596
"18279",2014,"74",66731,59021,125752
"18280",2014,"75",64067,56032,120099
"18281",2014,"76",59217,50254,109471
"18282",2014,"77",57639,47653,105292
"18283",2014,"78",54970,43860,98830
"18284",2014,"79",53027,40509,93536
"18285",2014,"80",50086,36752,86838
"18286",2014,"81",49360,34491,83851
"18287",2014,"82",45936.07,30920.78,76856.85
"18288",2014,"83",43927.8,27758.19,71685.99
"18289",2014,"84",39703.15,23717.57,63420.72
"18290",2014,"85",36608.69,20662.05,57270.74
"18291",2014,"86",32582.84,17391.25,49974.09
"18292",2014,"87",29394.4,14786.44,44180.84
"18293",2014,"88",26141.29,12062,38203.29
"18294",2014,"89",23237.52,9818.34,33055.86
"18295",2014,"90",20157.81,8002.8,28160.61
"18296",2014,"91",16346.55,6058.57,22405.12
"18297",2014,"92",13370.72,4571.26,17941.98
"18298",2014,"93",10668.49,3438.43,14106.92
"18299",2014,"94",7012.96,2047.24,9060.2
"18300",2014,"95",5001.6,1276.78,6278.38
"18301",2014,"96",3773.43,908.74,4682.17
"18302",2014,"97",2678.17,570.68,3248.85
"18303",2014,"98",1755.81,348.05,2103.86
"18304",2014,"99",1214.49,230.02,1444.51
"18305",2014,"100",750.4,130.03,880.43
"18306",2014,"101",430.18,68.21,498.39
"18307",2014,"102",241,36.28,277.28
"18308",2014,"103",133.3,18.7,152
"18309",2014,"104",70.75,9.24,79.99
"18310",2014,"105",34.75,3.97,38.72
"18311",2014,"106",16.75,1.93,18.68
"18312",2014,"107",7.66,0.63,8.29
"18313",2014,"108",3.28,0,3.28
"18314",2014,"109",1.27,0,1.27
"18315",2014,"110+",0.25,0,0.25
"18316",2015,"0",85481,89200,174681
"18317",2015,"1",83519,88068,171587
"18318",2015,"2",85999,90389,176388
"18319",2015,"3",87862,92624,180486
"18320",2015,"4",90733,94447,185180
"18321",2015,"5",90701,95173,185874
"18322",2015,"6",90654,95467,186121
"18323",2015,"7",89543,93376,182919
"18324",2015,"8",90753,95697,186450
"18325",2015,"9",91956,96335,188291
"18326",2015,"10",95085,99111,194196
"18327",2015,"11",98126,102917,201043
"18328",2015,"12",98646,103363,202009
"18329",2015,"13",99696,104224,203920
"18330",2015,"14",101861,106060,207921
"18331",2015,"15",99158,104076,203234
"18332",2015,"16",98647,103488,202135
"18333",2015,"17",96333,100425,196758
"18334",2015,"18",95963,101698,197661
"18335",2015,"19",98609,102596,201205
"18336",2015,"20",102705,106496,209201
"18337",2015,"21",103336,106527,209863
"18338",2015,"22",105105,108394,213499
"18339",2015,"23",107392,109987,217379
"18340",2015,"24",108172,110918,219090
"18341",2015,"25",105343,106761,212104
"18342",2015,"26",104283,106050,210333
"18343",2015,"27",104232,106765,210997
"18344",2015,"28",104815,105884,210699
"18345",2015,"29",102601,103940,206541
"18346",2015,"30",100877,102760,203637
"18347",2015,"31",98563,99834,198397
"18348",2015,"32",99363,100368,199731
"18349",2015,"33",102145,101862,204007
"18350",2015,"34",103290,103679,206969
"18351",2015,"35",100206,100201,200407
"18352",2015,"36",100732,100342,201074
"18353",2015,"37",99508,98632,198140
"18354",2015,"38",99977,100324,200301
"18355",2015,"39",101434,100644,202078
"18356",2015,"40",106162,105095,211257
"18357",2015,"41",110109,108965,219074
"18358",2015,"42",119449,117802,237251
"18359",2015,"43",124500,124640,249140
"18360",2015,"44",129826,130316,260142
"18361",2015,"45",132285,133718,266003
"18362",2015,"46",127041,127958,254999
"18363",2015,"47",125296,127215,252511
"18364",2015,"48",126139,128025,254164
"18365",2015,"49",127838,130402,258240
"18366",2015,"50",130396,132572,262968
"18367",2015,"51",128185,130119,258304
"18368",2015,"52",126492,127207,253699
"18369",2015,"53",125247,125787,251034
"18370",2015,"54",121780,122399,244179
"18371",2015,"55",120678,121097,241775
"18372",2015,"56",117306,117653,234959
"18373",2015,"57",114933,114782,229715
"18374",2015,"58",112602,112953,225555
"18375",2015,"59",110236,109146,219382
"18376",2015,"60",107831,107846,215677
"18377",2015,"61",106031,105798,211829
"18378",2015,"62",105859,105751,211610
"18379",2015,"63",101625,101844,203469
"18380",2015,"64",102012,101587,203599
"18381",2015,"65",102677,102156,204833
"18382",2015,"66",104991,104450,209441
"18383",2015,"67",110358,108141,218499
"18384",2015,"68",112692,110680,223372
"18385",2015,"69",80505,77782,158287
"18386",2015,"70",83422,79867,163289
"18387",2015,"71",78212,74569,152781
"18388",2015,"72",71677,67255,138932
"18389",2015,"73",67539,62558,130097
"18390",2015,"74",68618,62026,130644
"18391",2015,"75",65456,57272,122728
"18392",2015,"76",62715,54156,116871
"18393",2015,"77",57792,48338,106130
"18394",2015,"78",56105,45662,101767
"18395",2015,"79",53295,41743,95038
"18396",2015,"80",51258,38266,89524
"18397",2015,"81",48171,34516,82687
"18398",2015,"82",47131,32091,79222
"18399",2015,"83",43469.71,28539.29,72009
"18400",2015,"84",41272.01,25307.03,66579.04
"18401",2015,"85",37030.59,21342.55,58373.14
"18402",2015,"86",33749.74,18431.7,52181.44
"18403",2015,"87",29674.22,15292.45,44966.67
"18404",2015,"88",26435.49,12753.5,39188.99
"18405",2015,"89",23149.57,10224.73,33374.3
"18406",2015,"90",20151.99,8192.39,28344.38
"18407",2015,"91",17095.89,6556.12,23652.01
"18408",2015,"92",13619.38,4806.65,18426.03
"18409",2015,"93",10907.93,3510.91,14418.84
"18410",2015,"94",8432.01,2582.06,11014.07
"18411",2015,"95",5389.29,1503.44,6892.73
"18412",2015,"96",3762.35,907.63,4669.98
"18413",2015,"97",2748.61,630.66,3379.27
"18414",2015,"98",1851.95,381.96,2233.91
"18415",2015,"99",1180.96,220.28,1401.24
"18416",2015,"100",775.94,137.62,913.56
"18417",2015,"101",442.82,75.03,517.85
"18418",2015,"102",242.75,37.63,280.38
"18419",2015,"103",130.2,19.04,149.24
"18420",2015,"104",69.3,9.08,78.38
"18421",2015,"105",35.26,4.1,39.36
"18422",2015,"106",16.53,1.37,17.9
"18423",2015,"107",7.55,0.65,8.2
"18424",2015,"108",3.15,0,3.15
"18425",2015,"109",1.17,0,1.17
"18426",2015,"110+",0.32,0,0.32
"18427",2016,"0",83003,87338,170341
"18428",2016,"1",85997,89724,175721
"18429",2016,"2",83887,88508,172395
"18430",2016,"3",86398,90806,177204
"18431",2016,"4",88257,92936,181193
"18432",2016,"5",90957,94838,185795
"18433",2016,"6",91023,95504,186527
"18434",2016,"7",91044,95910,186954
"18435",2016,"8",89914,93744,183658
"18436",2016,"9",91089,96015,187104
"18437",2016,"10",92279,96718,188997
"18438",2016,"11",95450,99493,194943
"18439",2016,"12",98436,103231,201667
"18440",2016,"13",98990,103749,202739
"18441",2016,"14",99961,104573,204534
"18442",2016,"15",102191,106513,208704
"18443",2016,"16",99569,104867,204436
"18444",2016,"17",99152,104517,203669
"18445",2016,"18",97903,102098,200001
"18446",2016,"19",98187,103730,201917
"18447",2016,"20",100716,104103,204819
"18448",2016,"21",104401,107864,212265
"18449",2016,"22",104871,107947,212818
"18450",2016,"23",106518,109870,216388
"18451",2016,"24",108420,111236,219656
"18452",2016,"25",108847,111992,220839
"18453",2016,"26",105977,107783,213760
"18454",2016,"27",104992,106795,211787
"18455",2016,"28",104853,107521,212374
"18456",2016,"29",105543,106699,212242
"18457",2016,"30",103194,104634,207828
"18458",2016,"31",101364,103321,204685
"18459",2016,"32",99186,100339,199525
"18460",2016,"33",99700,100839,200539
"18461",2016,"34",102566,102198,204764
"18462",2016,"35",103610,104115,207725
"18463",2016,"36",100514,100507,201021
"18464",2016,"37",100947,100484,201431
"18465",2016,"38",99755,98833,198588
"18466",2016,"39",100237,100411,200648
"18467",2016,"40",101724,100718,202442
"18468",2016,"41",106293,105256,211549
"18469",2016,"42",110261,109025,219286
"18470",2016,"43",119507,117940,237447
"18471",2016,"44",124579,124679,249258
"18472",2016,"45",129863,130208,260071
"18473",2016,"46",132303,133565,265868
"18474",2016,"47",126987,127834,254821
"18475",2016,"48",125225,127011,252236
"18476",2016,"49",126017,127731,253748
"18477",2016,"50",127577,129999,257576
"18478",2016,"51",130154,132171,262325
"18479",2016,"52",127946,129718,257664
"18480",2016,"53",126131,126695,252826
"18481",2016,"54",124867,125261,250128
"18482",2016,"55",121327,121886,243213
"18483",2016,"56",120230,120499,240729
"18484",2016,"57",116855,117111,233966
"18485",2016,"58",114428,114108,228536
"18486",2016,"59",112039,112131,224170
"18487",2016,"60",109680,108299,217979
"18488",2016,"61",107179,106954,214133
"18489",2016,"62",105299,104855,210154
"18490",2016,"63",105110,104721,209831
"18491",2016,"64",100869,100786,201655
"18492",2016,"65",101127,100254,201381
"18493",2016,"66",101724,100733,202457
"18494",2016,"67",103973,102945,206918
"18495",2016,"68",109194,106461,215655
"18496",2016,"69",111458,108834,220292
"18497",2016,"70",79524,76251,155775
"18498",2016,"71",82268,78123,160391
"18499",2016,"72",77081,72862,149943
"18500",2016,"73",70605,65632,136237
"18501",2016,"74",66388,60778,127166
"18502",2016,"75",67338,60036,127374
"18503",2016,"76",64077,55293,119370
"18504",2016,"77",61200,52191,113391
"18505",2016,"78",56178,46236,102414
"18506",2016,"79",54381,43415,97796
"18507",2016,"80",51361,39477,90838
"18508",2016,"81",49122,35838,84960
"18509",2016,"82",45903,32104,78007
"18510",2016,"83",44568,29567,74135
"18511",2016,"84",40806.72,25983.68,66790.4
"18512",2016,"85",38340.64,22731.48,61072.12
"18513",2016,"86",33952.43,18901.05,52853.48
"18514",2016,"87",30557.91,16091,46648.91
"18515",2016,"88",26483.8,13167.78,39651.58
"18516",2016,"89",23237.31,10798.61,34035.92
"18517",2016,"90",20014.49,8428.81,28443.3
"18518",2016,"91",17036.68,6592.09,23628.77
"18519",2016,"92",14057.75,5170.85,19228.6
"18520",2016,"93",10942.73,3660.35,14603.08
"18521",2016,"94",8543.66,2589.39,11133.05
"18522",2016,"95",6409.12,1853.07,8262.19
"18523",2016,"96",3994.62,1052.29,5046.91
"18524",2016,"97",2670.46,623.16,3293.62
"18525",2016,"98",1907.43,422.36,2329.79
"18526",2016,"99",1256.43,241.45,1497.88
"18527",2016,"100",748,129.99,877.99
"18528",2016,"101",456.83,74.76,531.59
"18529",2016,"102",246.47,38.62,285.09
"18530",2016,"103",127.18,18.33,145.51
"18531",2016,"104",63.87,8.66,72.53
"18532",2016,"105",31.92,3.55,35.47
"18533",2016,"106",14.94,1.28,16.22
"18534",2016,"107",6.26,0,6.26
"18535",2016,"108",2.42,0,2.42
"18536",2016,"109",0.65,0,0.65
"18537",2016,"110+",0,0,0
"18538",2017,"0",83861,88427,172288
"18539",2017,"1",83580,88014,171594
"18540",2017,"2",86520,90346,176866
"18541",2017,"3",84273,88997,173270
"18542",2017,"4",86903,91368,178271
"18543",2017,"5",88666,93425,182091
"18544",2017,"6",91440,95409,186849
"18545",2017,"7",91484,96029,187513
"18546",2017,"8",91588,96466,188054
"18547",2017,"9",90409,94264,184673
"18548",2017,"10",91563,96527,188090
"18549",2017,"11",92732,97279,190011
"18550",2017,"12",95882,100056,195938
"18551",2017,"13",98839,103722,202561
"18552",2017,"14",99438,104261,203699
"18553",2017,"15",100433,105217,205650
"18554",2017,"16",102711,107580,210291
"18555",2017,"17",100201,106188,206389
"18556",2017,"18",101093,106686,207779
"18557",2017,"19",100679,104617,205296
"18558",2017,"20",100853,105826,206679
"18559",2017,"21",102767,105752,208519
"18560",2017,"22",105896,109449,215345
"18561",2017,"23",106520,109858,216378
"18562",2017,"24",107803,111519,219322
"18563",2017,"25",109416,112770,222186
"18564",2017,"26",110033,113428,223461
"18565",2017,"27",106982,109076,216058
"18566",2017,"28",105930,108196,214126
"18567",2017,"29",105703,108553,214256
"18568",2017,"30",106394,107525,213919
"18569",2017,"31",103921,105536,209457
"18570",2017,"32",102098,104127,206225
"18571",2017,"33",99826,101071,200897
"18572",2017,"34",100219,101405,201624
"18573",2017,"35",103012,102822,205834
"18574",2017,"36",104139,104628,208767
"18575",2017,"37",100963,101010,201973
"18576",2017,"38",101324,100936,202260
"18577",2017,"39",100084,99269,199353
"18578",2017,"40",100580,100678,201258
"18579",2017,"41",102017,101006,203023
"18580",2017,"42",106646,105513,212159
"18581",2017,"43",110512,109175,219687
"18582",2017,"44",119736,118017,237753
"18583",2017,"45",124689,124681,249370
"18584",2017,"46",129931,130245,260176
"18585",2017,"47",132434,133554,265988
"18586",2017,"48",127024,127825,254849
"18587",2017,"49",125250,126958,252208
"18588",2017,"50",125954,127537,253491
"18589",2017,"51",127353,129765,257118
"18590",2017,"52",129918,131843,261761
"18591",2017,"53",127685,129462,257147
"18592",2017,"54",125802,126298,252100
"18593",2017,"55",124521,124873,249394
"18594",2017,"56",120996,121311,242307
"18595",2017,"57",119731,119893,239624
"18596",2017,"58",116340,116575,232915
"18597",2017,"59",113947,113418,227365
"18598",2017,"60",111450,111395,222845
"18599",2017,"61",109115,107459,216574
"18600",2017,"62",106452,106022,212474
"18601",2017,"63",104556,103897,208453
"18602",2017,"64",104403,103593,207996
"18603",2017,"65",99999,99562,199561
"18604",2017,"66",100218,98905,199123
"18605",2017,"67",100762,99271,200033
"18606",2017,"68",102900,101346,204246
"18607",2017,"69",108006,104672,212678
"18608",2017,"70",110159,106899,217058
"18609",2017,"71",78476,74626,153102
"18610",2017,"72",81078,76408,157486
"18611",2017,"73",75897,71077,146974
"18612",2017,"74",69384,63855,133239
"18613",2017,"75",65165,58946,124111
"18614",2017,"76",65863,58013,123876
"18615",2017,"77",62562,53238,115800
"18616",2017,"78",59530,50016,109546
"18617",2017,"79",54490,44062,98552
"18618",2017,"80",52466,41081,93547
"18619",2017,"81",49374,37084,86458
"18620",2017,"82",46797,33402,80199
"18621",2017,"83",43542,29496,73038
"18622",2017,"84",41889,26988,68877
"18623",2017,"85",37922.83,23350.51,61273.34
"18624",2017,"86",35245.87,20139.88,55385.75
"18625",2017,"87",30835.74,16525.48,47361.22
"18626",2017,"88",27345.16,13848.67,41193.83
"18627",2017,"89",23275.93,11128.12,34404.05
"18628",2017,"90",19968.26,8914.64,28882.9
"18629",2017,"91",16888.2,6795.03,23683.23
"18630",2017,"92",14059.33,5173.88,19233.21
"18631",2017,"93",11360.21,3979.31,15339.52
"18632",2017,"94",8621.67,2742.84,11364.51
"18633",2017,"95",6443.39,1849.73,8293.12
"18634",2017,"96",4692.14,1290.78,5982.92
"18635",2017,"97",2835.22,732.09,3567.31
"18636",2017,"98",1834.38,420.01,2254.39
"18637",2017,"99",1284.71,272.69,1557.4
"18638",2017,"100",796.36,149.87,946.23
"18639",2017,"101",460.48,80.85,541.33
"18640",2017,"102",274.05,45.26,319.31
"18641",2017,"103",144.6,22.78,167.38
"18642",2017,"104",73.18,10.55,83.73
"18643",2017,"105",36.07,4.78,40.85
"18644",2017,"106",17.89,1.63,19.52
"18645",2017,"107",8.11,0.36,8.47
"18646",2017,"108",3.16,0,3.16
"18647",2017,"109",1.03,0,1.03
"18648",2017,"110+",0.28,0,0.28
"18649",2018,"0",82565,87001,169566
"18650",2018,"1",84427,88938,173365
"18651",2018,"2",84218,88597,172815
"18652",2018,"3",87052,90861,177913
"18653",2018,"4",84817,89623,174440
"18654",2018,"5",87391,91870,179261
"18655",2018,"6",89130,93945,183075
"18656",2018,"7",91941,96038,187979
"18657",2018,"8",91964,96625,188589
"18658",2018,"9",92137,97025,189162
"18659",2018,"10",90935,94853,185788
"18660",2018,"11",92091,97078,189169
"18661",2018,"12",93260,97848,191108
"18662",2018,"13",96335,100540,196875
"18663",2018,"14",99327,104192,203519
"18664",2018,"15",99953,104821,204774
"18665",2018,"16",100903,105975,206878
"18666",2018,"17",103349,108471,211820
"18667",2018,"18",102502,108272,210774
"18668",2018,"19",104473,109313,213786
"18669",2018,"20",103471,106321,209792
"18670",2018,"21",102774,107118,209892
"18671",2018,"22",104180,107128,211308
"18672",2018,"23",107619,110938,218557
"18673",2018,"24",107920,111312,219232
"18674",2018,"25",108942,112701,221643
"18675",2018,"26",110637,113781,224418
"18676",2018,"27",111102,114517,225619
"18677",2018,"28",108149,110170,218319
"18678",2018,"29",107008,109150,216158
"18679",2018,"30",106647,109586,216233
"18680",2018,"31",107238,108265,215503
"18681",2018,"32",104773,106354,211127
"18682",2018,"33",102919,104707,207626
"18683",2018,"34",100658,101642,202300
"18684",2018,"35",100818,101988,202806
"18685",2018,"36",103591,103292,206883
"18686",2018,"37",104709,105060,209769
"18687",2018,"38",101546,101381,202927
"18688",2018,"39",101767,101204,202971
"18689",2018,"40",100483,99545,200028
"18690",2018,"41",100978,100996,201974
"18691",2018,"42",102406,101216,203622
"18692",2018,"43",106984,105674,212658
"18693",2018,"44",110738,109292,220030
"18694",2018,"45",120012,118136,238148
"18695",2018,"46",124887,124791,249678
"18696",2018,"47",130097,130170,260267
"18697",2018,"48",132535,133439,265974
"18698",2018,"49",127104,127652,254756
"18699",2018,"50",125250,126801,252051
"18700",2018,"51",125932,127371,253303
"18701",2018,"52",127289,129522,256811
"18702",2018,"53",129693,131478,261171
"18703",2018,"54",127459,129051,256510
"18704",2018,"55",125455,125816,251271
"18705",2018,"56",124219,124384,248603
"18706",2018,"57",120592,120807,241399
"18707",2018,"58",119267,119283,238550
"18708",2018,"59",115847,115840,231687
"18709",2018,"60",113384,112657,226041
"18710",2018,"61",110839,110482,221321
"18711",2018,"62",108421,106593,215014
"18712",2018,"63",105740,105018,210758
"18713",2018,"64",103814,102790,206604
"18714",2018,"65",103650,102450,206100
"18715",2018,"66",99064,98253,197317
"18716",2018,"67",99286,97592,196878
"18717",2018,"68",99839,97833,197672
"18718",2018,"69",101823,99747,201570
"18719",2018,"70",106775,102841,209616
"18720",2018,"71",108801,104838,213639
"18721",2018,"72",77396,72987,150383
"18722",2018,"73",79856,74613,154469
"18723",2018,"74",74611,69207,143818
"18724",2018,"75",68107,61984,130091
"18725",2018,"76",63771,57047,120818
"18726",2018,"77",64265,55954,120219
"18727",2018,"78",60936,51169,112105
"18728",2018,"79",57759,47748,105507
"18729",2018,"80",52609,41706,94315
"18730",2018,"81",50391,38599,88990
"18731",2018,"82",47135,34630,81765
"18732",2018,"83",44331,30930,75261
"18733",2018,"84",40964,26960,67924
"18734",2018,"85",38925,24309,63234
"18735",2018,"86",34864.54,20731.56,55596.1
"18736",2018,"87",31948.76,17672.23,49620.99
"18737",2018,"88",27547.02,14243.8,41790.82
"18738",2018,"89",24027.08,11694.82,35721.9
"18739",2018,"90",20064.04,9187.22,29251.26
"18740",2018,"91",16911.39,7244.94,24156.33
"18741",2018,"92",13878.31,5399.97,19278.28
"18742",2018,"93",11196.7,3965.89,15162.59
"18743",2018,"94",8847.47,2980.84,11828.31
"18744",2018,"95",6540.89,1992.63,8533.52
"18745",2018,"96",4760.49,1284.5,6044.99
"18746",2018,"97",3315.5,860.85,4176.35
"18747",2018,"98",1920.21,466.61,2386.82
"18748",2018,"99",1212.87,259.1,1471.97
"18749",2018,"100",811.55,167.77,979.32
"18750",2018,"101",472.63,88.55,561.18
"18751",2018,"102",261.9,45.97,307.87
"18752",2018,"103",149.32,24.61,173.93
"18753",2018,"104",75.41,11.83,87.24
"18754",2018,"105",36.43,5.22,41.65
"18755",2018,"106",17,2.15,19.15
"18756",2018,"107",8.15,0.34,8.49
"18757",2018,"108",3.29,0,3.29
"18758",2018,"109",0.92,0,0.92
"18759",2018,"110+",0,0,0
"18760",2019,"0",82270,86173,168443
"18761",2019,"1",83170,87646,170816
"18762",2019,"2",84851,89405,174256
"18763",2019,"3",84620,89102,173722
"18764",2019,"4",87493,91332,178825
"18765",2019,"5",85223,89987,175210
"18766",2019,"6",87766,92277,180043
"18767",2019,"7",89450,94365,183815
"18768",2019,"8",92382,96472,188854
"18769",2019,"9",92388,97132,189520
"18770",2019,"10",92558,97532,190090
"18771",2019,"11",91341,95272,186613
"18772",2019,"12",92526,97500,190026
"18773",2019,"13",93660,98249,191909
"18774",2019,"14",96699,100978,197677
"18775",2019,"15",99652,104654,204306
"18776",2019,"16",100355,105283,205638
"18777",2019,"17",101393,106599,207992
"18778",2019,"18",106032,110582,216614
"18779",2019,"19",106283,111186,217469
"18780",2019,"20",107143,111172,218315
"18781",2019,"21",105340,107639,212979
"18782",2019,"22",104417,108437,212854
"18783",2019,"23",105833,108668,214501
"18784",2019,"24",108910,112366,221276
"18785",2019,"25",109076,112519,221595
"18786",2019,"26",110115,114023,224138
"18787",2019,"27",111930,115150,227080
"18788",2019,"28",112261,115895,228156
"18789",2019,"29",109410,111484,220894
"18790",2019,"30",108154,110475,218629
"18791",2019,"31",107756,110641,218397
"18792",2019,"32",108164,109358,217522
"18793",2019,"33",105682,107200,212882
"18794",2019,"34",103775,105701,209476
"18795",2019,"35",101374,102432,203806
"18796",2019,"36",101559,102842,204401
"18797",2019,"37",104181,103933,208114
"18798",2019,"38",105319,105652,210971
"18799",2019,"39",102125,101876,204001
"18800",2019,"40",102294,101698,203992
"18801",2019,"41",101063,99964,201027
"18802",2019,"42",101442,101409,202851
"18803",2019,"43",102780,101479,204259
"18804",2019,"44",107349,105910,213259
"18805",2019,"45",111095,109548,220643
"18806",2019,"46",120235,118352,238587
"18807",2019,"47",125015,124918,249933
"18808",2019,"48",130281,130255,260536
"18809",2019,"49",132553,133467,266020
"18810",2019,"50",127180,127729,254909
"18811",2019,"51",125233,126713,251946
"18812",2019,"52",125869,127228,253097
"18813",2019,"53",127121,129271,256392
"18814",2019,"54",129466,131046,260512
"18815",2019,"55",127174,128690,255864
"18816",2019,"56",125128,125429,250557
"18817",2019,"57",123747,123795,247542
"18818",2019,"58",120125,120078,240203
"18819",2019,"59",118757,118609,237366
"18820",2019,"60",115238,115023,230261
"18821",2019,"61",112724,111853,224577
"18822",2019,"62",110126,109561,219687
"18823",2019,"63",107723,105576,213299
"18824",2019,"64",105029,103986,209015
"18825",2019,"65",103000,101712,204712
"18826",2019,"66",102706,101055,203761
"18827",2019,"67",98136,96863,194999
"18828",2019,"68",98375,96136,194511
"18829",2019,"69",98851,96240,195091
"18830",2019,"70",100645,98005,198650
"18831",2019,"71",105427,100939,206366
"18832",2019,"72",107292,102579,209871
"18833",2019,"73",76153,71239,147392
"18834",2019,"74",78451,72654,151105
"18835",2019,"75",73244,67222,140466
"18836",2019,"76",66638,60011,126649
"18837",2019,"77",62279,54990,117269
"18838",2019,"78",62513,53804,116317
"18839",2019,"79",59132,48893,108025
"18840",2019,"80",55816,45279,101095
"18841",2019,"81",50593,39418,90011
"18842",2019,"82",48174,36003,84177
"18843",2019,"83",44646,32090,76736
"18844",2019,"84",41731,28364,70095
"18845",2019,"85",38116,24436,62552
"18846",2019,"86",35753,21614,57367
"18847",2019,"87",31577.36,18147.54,49724.9
"18848",2019,"88",28535.61,15176.36,43711.97
"18849",2019,"89",24197.89,11982.27,36180.16
"18850",2019,"90",20671.88,9620.55,30292.43
"18851",2019,"91",16922.36,7396.07,24318.43
"18852",2019,"92",13935.46,5706.88,19642.34
"18853",2019,"93",11131.41,4150.26,15281.67
"18854",2019,"94",8709.08,2942.64,11651.72
"18855",2019,"95",6686.1,2135.91,8822.01
"18856",2019,"96",4810.17,1396.46,6206.63
"18857",2019,"97",3359.57,878.3,4237.87
"18858",2019,"98",2273.01,583.3,2856.31
"18859",2019,"99",1293.64,313.36,1607
"18860",2019,"100",772.19,165.08,937.27
"18861",2019,"101",486.39,100.98,587.37
"18862",2019,"102",273.56,52.12,325.68
"18863",2019,"103",146.41,26.36,172.77
"18864",2019,"104",80.66,13.62,94.28
"18865",2019,"105",39.31,6.31,45.62
"18866",2019,"106",18.23,2.67,20.9
"18867",2019,"107",8.02,0.94,8.96
"18868",2019,"108",3.76,0,3.76
"18869",2019,"109",1.21,0,1.21
"18870",2019,"110+",0,0,0
"18871",2020,"0",82717,86780,169497
"18872",2020,"1",82982,86936,169918
"18873",2020,"2",83727,88224,171951
"18874",2020,"3",85442,89877,175319
"18875",2020,"4",85109,89678,174787
"18876",2020,"5",87866,91715,179581
"18877",2020,"6",85677,90538,176215
"18878",2020,"7",88212,92757,180969
"18879",2020,"8",89928,94859,184787
"18880",2020,"9",92871,97000,189871
"18881",2020,"10",92865,97716,190581
"18882",2020,"11",93080,98121,191201
"18883",2020,"12",91838,95795,187633
"18884",2020,"13",92965,97984,190949
"18885",2020,"14",94106,98734,192840
"18886",2020,"15",97121,101456,198577
"18887",2020,"16",100080,105340,205420
"18888",2020,"17",101054,106095,207149
"18889",2020,"18",104330,109193,213523
"18890",2020,"19",110345,114144,224489
"18891",2020,"20",109356,113176,222532
"18892",2020,"21",108989,112662,221651
"18893",2020,"22",106985,109312,216297
"18894",2020,"23",106212,110236,216448
"18895",2020,"24",107378,110279,217657
"18896",2020,"25",110507,114006,224513
"18897",2020,"26",110803,114184,224987
"18898",2020,"27",111847,115804,227651
"18899",2020,"28",113466,116870,230336
"18900",2020,"29",113743,117735,231478
"18901",2020,"30",111015,113052,224067
"18902",2020,"31",109417,112150,221567
"18903",2020,"32",108871,112141,221012
"18904",2020,"33",109414,110858,220272
"18905",2020,"34",106720,108465,215185
"18906",2020,"35",104792,106816,211608
"18907",2020,"36",102283,103411,205694
"18908",2020,"37",102457,103678,206135
"18909",2020,"38",104932,104855,209787
"18910",2020,"39",106167,106437,212604
"18911",2020,"40",102787,102613,205400
"18912",2020,"41",102998,102353,205351
"18913",2020,"42",101643,100590,202233
"18914",2020,"43",101926,101906,203832
"18915",2020,"44",103232,101960,205192
"18916",2020,"45",107835,106340,214175
"18917",2020,"46",111471,109926,221397
"18918",2020,"47",120512,118629,239141
"18919",2020,"48",125298,125116,250414
"18920",2020,"49",130511,130430,260941
"18921",2020,"50",132630,133557,266187
"18922",2020,"51",127180,127742,254922
"18923",2020,"52",125234,126700,251934
"18924",2020,"53",125793,127005,252798
"18925",2020,"54",126935,129050,255985
"18926",2020,"55",129248,130710,259958
"18927",2020,"56",126880,128205,255085
"18928",2020,"57",124789,124920,249709
"18929",2020,"58",123348,123328,246676
"18930",2020,"59",119644,119520,239164
"18931",2020,"60",118246,117917,236163
"18932",2020,"61",114647,114274,228921
"18933",2020,"62",112104,110971,223075
"18934",2020,"63",109425,108696,218121
"18935",2020,"64",106968,104550,211518
"18936",2020,"65",104287,102944,207231
"18937",2020,"66",102165,100458,202623
"18938",2020,"67",101779,99719,201498
"18939",2020,"68",97168,95529,192697
"18940",2020,"69",97395,94604,191999
"18941",2020,"70",97695,94637,192332
"18942",2020,"71",99419,96267,195686
"18943",2020,"72",104012,98898,202910
"18944",2020,"73",105706,100306,206012
"18945",2020,"74",74842,69437,144279
"18946",2020,"75",77014,70595,147609
"18947",2020,"76",71692,65129,136821
"18948",2020,"77",65098,57948,123046
"18949",2020,"78",60684,52936,113620
"18950",2020,"79",60667,51437,112104
"18951",2020,"80",57163,46393,103556
"18952",2020,"81",53698,42774,96472
"18953",2020,"82",48359,36940,85299
"18954",2020,"83",45766,33443,79209
"18955",2020,"84",42062,29458,71520
"18956",2020,"85",38993,25719,64712
"18957",2020,"86",35196,21808,57004
"18958",2020,"87",32630,19057,51687
"18959",2020,"88",28349.88,15637.78,43987.66
"18960",2020,"89",25209.18,12846.71,38055.89
"18961",2020,"90",20938,9930.27,30868.27
"18962",2020,"91",17523.26,7805.23,25328.49
"18963",2020,"92",14028.13,5869.36,19897.49
"18964",2020,"93",11248.15,4408.7,15656.85
"18965",2020,"94",8792.74,3104.14,11896.88
"18966",2020,"95",6709.15,2145.02,8854.17
"18967",2020,"96",4983.71,1520.18,6503.89
"18968",2020,"97",3441.29,957.56,4398.85
"18969",2020,"98",2348.76,574.72,2923.48
"18970",2020,"99",1549.24,367.87,1917.11
"18971",2020,"100",831.94,191.51,1023.45
"18972",2020,"101",487.89,101.15,589.04
"18973",2020,"102",298.94,59.88,358.82
"18974",2020,"103",164.07,30.03,194.1
"18975",2020,"104",85.72,14.63,100.35
"18976",2020,"105",46.14,7.12,53.26
"18977",2020,"106",21.9,3.07,24.97
"18978",2020,"107",9.79,1.18,10.97
"18979",2020,"108",3.99,0.25,4.24
"18980",2020,"109",1.86,0,1.86
"18981",2020,"110+",0.34,0,0.34
"18982",2021,"0",81983,86287,168270
"18983",2021,"1",83095,87259,170354
"18984",2021,"2",83269,87205,170474
"18985",2021,"3",84028,88536,172564
"18986",2021,"4",85735,90229,175964
"18987",2021,"5",85399,90004,175403
"18988",2021,"6",88118,92022,180140
"18989",2021,"7",86014,90893,176907
"18990",2021,"8",88600,93185,181785
"18991",2021,"9",90339,95253,185592
"18992",2021,"10",93230,97407,190637
"18993",2021,"11",93298,98186,191484
"18994",2021,"12",93451,98553,192004
"18995",2021,"13",92233,96205,188438
"18996",2021,"14",93320,98395,191715
"18997",2021,"15",94459,99111,193570
"18998",2021,"16",97437,101957,199394
"18999",2021,"17",100587,105940,206527
"19000",2021,"18",103684,108487,212171
"19001",2021,"19",107972,112101,220073
"19002",2021,"20",111718,115335,227053
"19003",2021,"21",109453,113688,223141
"19004",2021,"22",109145,113200,222345
"19005",2021,"23",107411,110170,217581
"19006",2021,"24",106448,110918,217366
"19007",2021,"25",107725,110943,218668
"19008",2021,"26",111081,114839,225920
"19009",2021,"27",111436,115147,226583
"19010",2021,"28",112675,116762,229437
"19011",2021,"29",114455,117879,232334
"19012",2021,"30",114564,118809,233373
"19013",2021,"31",111643,114124,225767
"19014",2021,"32",110132,112998,223130
"19015",2021,"33",109614,112897,222511
"19016",2021,"34",110109,111599,221708
"19017",2021,"35",107229,109176,216405
"19018",2021,"36",105305,107506,212811
"19019",2021,"37",102728,103992,206720
"19020",2021,"38",103031,104243,207274
"19021",2021,"39",105484,105392,210876
"19022",2021,"40",106584,106966,213550
"19023",2021,"41",103210,103052,206262
"19024",2021,"42",103357,102743,206100
"19025",2021,"43",102041,101032,203073
"19026",2021,"44",102262,102241,204503
"19027",2021,"45",103481,102220,205701
"19028",2021,"46",108140,106682,214822
"19029",2021,"47",111721,110067,221788
"19030",2021,"48",120696,118771,239467
"19031",2021,"49",125557,125239,250796
"19032",2021,"50",130622,130463,261085
"19033",2021,"51",132653,133531,266184
"19034",2021,"52",127179,127603,254782
"19035",2021,"53",125132,126482,251614
"19036",2021,"54",125665,126801,252466
"19037",2021,"55",126716,128770,255486
"19038",2021,"56",128951,130352,259303
"19039",2021,"57",126586,127812,254398
"19040",2021,"58",124421,124406,248827
"19041",2021,"59",122911,122632,245543
"19042",2021,"60",119163,118755,237918
"19043",2021,"61",117652,117035,234687
"19044",2021,"62",114008,113396,227404
"19045",2021,"63",111388,110016,221404
"19046",2021,"64",108680,107568,216248
"19047",2021,"65",106156,103447,209603
"19048",2021,"66",103418,101607,205025
"19049",2021,"67",101208,98952,200160
"19050",2021,"68",100730,98181,198911
"19051",2021,"69",96118,93961,190079
"19052",2021,"70",96286,92962,189248
"19053",2021,"71",96414,92722,189136
"19054",2021,"72",97974,94152,192126
"19055",2021,"73",102387,96517,198904
"19056",2021,"74",103917,97705,201622
"19057",2021,"75",73350,67247,140597
"19058",2021,"76",75245,68108,143353
"19059",2021,"77",69898,62623,132521
"19060",2021,"78",63226,55380,118606
"19061",2021,"79",58686,50297,108983
"19062",2021,"80",58488,48560,107048
"19063",2021,"81",54757,43442,98199
"19064",2021,"82",51143,39833,90976
"19065",2021,"83",45756,33923,79679
"19066",2021,"84",42864,30357,73221
"19067",2021,"85",39103,26509,65612
"19068",2021,"86",35681,22721,58402
"19069",2021,"87",31730,18867,50597
"19070",2021,"88",28981,16210,45191
"19071",2021,"89",24693.6,12918.38,37611.98
"19072",2021,"90",21507.18,10376.07,31883.25
"19073",2021,"91",17524.43,7845.09,25369.52
"19074",2021,"92",14333.78,6042.33,20376.11
"19075",2021,"93",11158.09,4414.53,15572.62
"19076",2021,"94",8706.38,3179.71,11886.09
"19077",2021,"95",6630.29,2151.26,8781.55
"19078",2021,"96",4912.76,1454.26,6367.02
"19079",2021,"97",3497.7,1002.25,4499.95
"19080",2021,"98",2352.66,616.28,2968.94
"19081",2021,"99",1548.69,366.8,1915.49
"19082",2021,"100",965.15,225.75,1190.9
"19083",2021,"101",502.17,109.5,611.67
"19084",2021,"102",280.86,55.01,335.87
"19085",2021,"103",165.65,31.18,196.83
"19086",2021,"104",87.83,15.08,102.91
"19087",2021,"105",44.23,6.92,51.15
"19088",2021,"106",22.89,2.96,25.85
"19089",2021,"107",10.33,1.04,11.37
"19090",2021,"108",4.23,0.27,4.5
"19091",2021,"109",1.37,0,1.37
"19092",2021,"110+",0.63,0,0.63
"19093",2022,"0",87477,91656,179133
"19094",2022,"1",82525,86798,169323
"19095",2022,"2",83549,87677,171226
"19096",2022,"3",83754,87661,171415
"19097",2022,"4",84516,89040,173556
"19098",2022,"5",86090,90651,176741
"19099",2022,"6",85777,90457,176234
"19100",2022,"7",88573,92530,181103
"19101",2022,"8",86447,91346,177793
"19102",2022,"9",89064,93685,182749
"19103",2022,"10",90793,95720,186513
"19104",2022,"11",93734,97865,191599
"19105",2022,"12",93819,98741,192560
"19106",2022,"13",93930,99107,193037
"19107",2022,"14",92725,96754,189479
"19108",2022,"15",93759,98966,192725
"19109",2022,"16",94925,99794,194719
"19110",2022,"17",98071,102868,200939
"19111",2022,"18",104650,109411,214061
"19112",2022,"19",109707,113205,222912
"19113",2022,"20",111413,114784,226197
"19114",2022,"21",114120,117373,231493
"19115",2022,"22",111616,115609,227225
"19116",2022,"23",111617,115379,226996
"19117",2022,"24",109167,111807,220974
"19118",2022,"25",108247,112571,220818
"19119",2022,"26",109365,112664,222029
"19120",2022,"27",112728,116533,229261
"19121",2022,"28",113120,116862,229982
"19122",2022,"29",114109,118307,232416
"19123",2022,"30",115729,119445,235174
"19124",2022,"31",115722,120095,235817
"19125",2022,"32",112552,115360,227912
"19126",2022,"33",111129,114170,225299
"19127",2022,"34",110394,113883,224277
"19128",2022,"35",110839,112544,223383
"19129",2022,"36",107916,109956,217872
"19130",2022,"37",105848,108266,214114
"19131",2022,"38",103471,104530,208001
"19132",2022,"39",103678,104923,208601
"19133",2022,"40",105961,105921,211882
"19134",2022,"41",106970,107546,214516
"19135",2022,"42",103643,103398,207041
"19136",2022,"43",103760,103095,206855
"19137",2022,"44",102403,101350,203753
"19138",2022,"45",102646,102577,205223
"19139",2022,"46",103758,102456,206214
"19140",2022,"47",108388,106783,215171
"19141",2022,"48",111945,110300,222245
"19142",2022,"49",120794,118807,239601
"19143",2022,"50",125578,125218,250796
"19144",2022,"51",130609,130303,260912
"19145",2022,"52",132606,133294,265900
"19146",2022,"53",127035,127319,254354
"19147",2022,"54",124957,126151,251108
"19148",2022,"55",125394,126368,251762
"19149",2022,"56",126368,128199,254567
"19150",2022,"57",128533,129792,258325
"19151",2022,"58",126119,127121,253240
"19152",2022,"59",123897,123702,247599
"19153",2022,"60",122231,121759,243990
"19154",2022,"61",118536,117924,236460
"19155",2022,"62",116928,116047,232975
"19156",2022,"63",113266,112317,225583
"19157",2022,"64",110571,108918,219489
"19158",2022,"65",107783,106331,214114
"19159",2022,"66",105125,102065,207190
"19160",2022,"67",102314,100090,202404
"19161",2022,"68",100154,97394,197548
"19162",2022,"69",99588,96472,196060
"19163",2022,"70",94872,92137,187009
"19164",2022,"71",95011,90982,185993
"19165",2022,"72",95014,90616,185630
"19166",2022,"73",96491,91848,188339
"19167",2022,"74",100538,93916,194454
"19168",2022,"75",101761,94829,196590
"19169",2022,"76",71673,64890,136563
"19170",2022,"77",73274,65454,138728
"19171",2022,"78",67925,59963,127888
"19172",2022,"79",61217,52619,113836
"19173",2022,"80",56549,47558,104107
"19174",2022,"81",56036,45517,101553
"19175",2022,"82",52197,40474,92671
"19176",2022,"83",48499,36738,85237
"19177",2022,"84",43004,30968,73972
"19178",2022,"85",39777,27290,67067
"19179",2022,"86",35968,23452,59420
"19180",2022,"87",32377,19778,52155
"19181",2022,"88",28358,16070,44428
"19182",2022,"89",25374,13574,38948
"19183",2022,"90",21147.56,10512.95,31660.51
"19184",2022,"91",18082.18,8233.47,26315.65
"19185",2022,"92",14394.03,6092.33,20486.36
"19186",2022,"93",11456.27,4569.15,16025.42
"19187",2022,"94",8671.69,3219.33,11891.02
"19188",2022,"95",6557.58,2226.86,8784.44
"19189",2022,"96",4845.16,1469.74,6314.9
"19190",2022,"97",3475.43,968.93,4444.36
"19191",2022,"98",2401.76,640.34,3042.1
"19192",2022,"99",1562.02,382.17,1944.19
"19193",2022,"100",979.23,222.65,1201.88
"19194",2022,"101",586.96,131.17,718.13
"19195",2022,"102",288.88,61.49,350.37
"19196",2022,"103",151.39,28.69,180.08
"19197",2022,"104",84.93,15.19,100.12
"19198",2022,"105",43.04,6.93,49.97
"19199",2022,"106",20.54,2.8,23.34
"19200",2022,"107",9.96,0.77,10.73
"19201",2022,"108",4.04,0,4.04
"19202",2022,"109",1.28,0,1.28
"19203",2022,"110+",0,0,0
