"","Year","Age","Female","Male","Total"
"1",1846,"0",17990,18382,36372
"2",1846,"1",16132,16699,32831
"3",1846,"2",16404,17089,33493
"4",1846,"3",17564,17337,34901
"5",1846,"4",16352,16367,32719
"6",1846,"5",14538,14412,28950
"7",1846,"6",13426,13563,26989
"8",1846,"7",13531,13824,27355
"9",1846,"8",13664,13985,27649
"10",1846,"9",13746,13956,27702
"11",1846,"10",14814,15139,29953
"12",1846,"11",14058,14367,28425
"13",1846,"12",13270,13702,26972
"14",1846,"13",12576,13403,25979
"15",1846,"14",12784,13423,26207
"16",1846,"15",13245,13592,26837
"17",1846,"16",13463,13974,27437
"18",1846,"17",12698,12862,25560
"19",1846,"18",12644,12756,25400
"20",1846,"19",13630,13669,27299
"21",1846,"20",13546,13064,26610
"22",1846,"21",12824,12105,24929
"23",1846,"22",13202,12586,25788
"24",1846,"23",12772,12031,24803
"25",1846,"24",13222,12347,25569
"26",1846,"25",12396,11613,24009
"27",1846,"26",11615,10849,22464
"28",1846,"27",10768,10257,21025
"29",1846,"28",11095,10488,21583
"30",1846,"29",11539,10963,22502
"31",1846,"30",9605,9208,18813
"32",1846,"31",7424,7251,14675
"33",1846,"32",7771,7528,15299
"34",1846,"33",8537,8388,16925
"35",1846,"34",7770,7673,15443
"36",1846,"35",7293,7374,14667
"37",1846,"36",6082,5968,12050
"38",1846,"37",7515,7315,14830
"39",1846,"38",7784,7699,15483
"40",1846,"39",7716,7759,15475
"41",1846,"40",7523,7341,14864
"42",1846,"41",6664,6512,13176
"43",1846,"42",7032,6685,13717
"44",1846,"43",6441,6069,12510
"45",1846,"44",7041,6754,13795
"46",1846,"45",7040,6690,13730
"47",1846,"46",6999,6607,13606
"48",1846,"47",6783,6386,13169
"49",1846,"48",6729,6305,13034
"50",1846,"49",6364,5928,12292
"51",1846,"50",6412,5946,12358
"52",1846,"51",6539,6029,12568
"53",1846,"52",6441,5930,12371
"54",1846,"53",6423,5868,12291
"55",1846,"54",5913,5371,11284
"56",1846,"55",5635,5095,10730
"57",1846,"56",5240,4709,9949
"58",1846,"57",5097,4571,9668
"59",1846,"58",4679,4151,8830
"60",1846,"59",4712,4143,8855
"61",1846,"60",4329,3699,8028
"62",1846,"61",4406,3731,8137
"63",1846,"62",3837,3214,7051
"64",1846,"63",4103,3413,7516
"65",1846,"64",3971,3277,7248
"66",1846,"65",3890,3182,7072
"67",1846,"66",3441,2777,6218
"68",1846,"67",3362,2687,6049
"69",1846,"68",3175,2501,5676
"70",1846,"69",2737,2125,4862
"71",1846,"70",3030,2362,5392
"72",1846,"71",2309,1830,4139
"73",1846,"72",1908,1507,3415
"74",1846,"73",1985,1568,3553
"75",1846,"74",2028,1580,3608
"76",1846,"75",1854,1423,3277
"77",1846,"76",1748,1307,3055
"78",1846,"77",1491,1109,2600
"79",1846,"78",1427,1040,2467
"80",1846,"79",1222,893,2115
"81",1846,"80",1289,879,2168
"82",1846,"81",1186,812,1998
"83",1846,"82",1064,719,1783
"84",1846,"83",925,629,1554
"85",1846,"84",794,520,1314
"86",1846,"85",682,424,1106
"87",1846,"86",574,335,909
"88",1846,"87",458,263,721
"89",1846,"88",372,197,569
"90",1846,"89",287,163,450
"91",1846,"90",210,115,325
"92",1846,"91",171,96,267
"93",1846,"92",144,74,218
"94",1846,"93",117,54,171
"95",1846,"94",90,45,135
"96",1846,"95",75,39,114
"97",1846,"96",55,20,75
"98",1846,"97",37,17,54
"99",1846,"98",31,13,44
"100",1846,"99",21,10,31
"101",1846,"100",10,4,14
"102",1846,"101",7,3,10
"103",1846,"102",5,1,6
"104",1846,"103",3,1,4
"105",1846,"104",2,0,2
"106",1846,"105",1,0,1
"107",1846,"106",0,0,0
"108",1846,"107",0,0,0
"109",1846,"108",0,0,0
"110",1846,"109",0,0,0
"111",1846,"110+",0,0,0
"112",1847,"0",18742,19544,38286
"113",1847,"1",16949,17265,34214
"114",1847,"2",15692,16232,31924
"115",1847,"3",15986,16677,32663
"116",1847,"4",17088,16958,34046
"117",1847,"5",16009,16110,32119
"118",1847,"6",14323,14227,28550
"119",1847,"7",13266,13430,26696
"120",1847,"8",13407,13706,27113
"121",1847,"9",13578,13880,27458
"122",1847,"10",13738,13871,27609
"123",1847,"11",14841,15044,29885
"124",1847,"12",14153,14281,28434
"125",1847,"13",13393,13628,27021
"126",1847,"14",12694,13327,26021
"127",1847,"15",12895,13372,26267
"128",1847,"16",13363,13547,26910
"129",1847,"17",13564,13920,27484
"130",1847,"18",12774,12802,25576
"131",1847,"19",12685,12690,25375
"132",1847,"20",13609,13552,27161
"133",1847,"21",13450,12945,26395
"134",1847,"22",12694,11989,24683
"135",1847,"23",13031,12463,25494
"136",1847,"24",12575,11899,24474
"137",1847,"25",12999,12201,25200
"138",1847,"26",12175,11466,23641
"139",1847,"27",11400,10718,22118
"140",1847,"28",10564,10125,20689
"141",1847,"29",10891,10339,21230
"142",1847,"30",11325,10789,22114
"143",1847,"31",9461,9079,18540
"144",1847,"32",7314,7151,14465
"145",1847,"33",7658,7421,15079
"146",1847,"34",8415,8267,16682
"147",1847,"35",7675,7561,15236
"148",1847,"36",7202,7265,14467
"149",1847,"37",6028,5883,11911
"150",1847,"38",7446,7221,14667
"151",1847,"39",7735,7609,15344
"152",1847,"40",7655,7648,15303
"153",1847,"41",7502,7269,14771
"154",1847,"42",6650,6441,13091
"155",1847,"43",7028,6624,13652
"156",1847,"44",6431,6007,12438
"157",1847,"45",7019,6670,13689
"158",1847,"46",6989,6611,13600
"159",1847,"47",6929,6510,13439
"160",1847,"48",6688,6272,12960
"161",1847,"49",6630,6197,12827
"162",1847,"50",6252,5798,12050
"163",1847,"51",6331,5852,12183
"164",1847,"52",6453,5907,12360
"165",1847,"53",6347,5817,12164
"166",1847,"54",6334,5753,12087
"167",1847,"55",5828,5262,11090
"168",1847,"56",5553,4996,10549
"169",1847,"57",5184,4619,9803
"170",1847,"58",5041,4486,9527
"171",1847,"59",4624,4069,8693
"172",1847,"60",4589,4024,8613
"173",1847,"61",4251,3614,7865
"174",1847,"62",4305,3614,7919
"175",1847,"63",3733,3104,6837
"176",1847,"64",3963,3264,7227
"177",1847,"65",3833,3131,6964
"178",1847,"66",3734,3025,6759
"179",1847,"67",3304,2638,5942
"180",1847,"68",3203,2545,5748
"181",1847,"69",3036,2368,5404
"182",1847,"70",2587,1988,4575
"183",1847,"71",2920,2258,5178
"184",1847,"72",2208,1733,3941
"185",1847,"73",1827,1425,3252
"186",1847,"74",1871,1474,3345
"187",1847,"75",1887,1463,3350
"188",1847,"76",1728,1311,3039
"189",1847,"77",1605,1186,2791
"190",1847,"78",1357,992,2349
"191",1847,"79",1310,936,2246
"192",1847,"80",1288,875,2163
"193",1847,"81",1178,796,1974
"194",1847,"82",1063,724,1787
"195",1847,"83",940,631,1571
"196",1847,"84",795,527,1322
"197",1847,"85",686,444,1130
"198",1847,"86",587,348,935
"199",1847,"87",487,275,762
"200",1847,"88",377,208,585
"201",1847,"89",312,160,472
"202",1847,"90",201,110,311
"203",1847,"91",167,89,256
"204",1847,"92",134,71,205
"205",1847,"93",113,52,165
"206",1847,"94",92,38,130
"207",1847,"95",68,32,100
"208",1847,"96",55,26,81
"209",1847,"97",37,15,52
"210",1847,"98",25,11,36
"211",1847,"99",26,10,36
"212",1847,"100",8,5,13
"213",1847,"101",6,2,8
"214",1847,"102",6,1,7
"215",1847,"103",3,1,4
"216",1847,"104",2,0,2
"217",1847,"105",1,0,1
"218",1847,"106",0,0,0
"219",1847,"107",0,0,0
"220",1847,"108",0,0,0
"221",1847,"109",0,0,0
"222",1847,"110+",0,0,0
"223",1848,"0",18786,19540,38326
"224",1848,"1",17386,18075,35461
"225",1848,"2",16431,16710,33141
"226",1848,"3",15287,15880,31167
"227",1848,"4",15607,16313,31920
"228",1848,"5",16672,16635,33307
"229",1848,"6",15659,15836,31495
"230",1848,"7",14095,14042,28137
"231",1848,"8",13092,13270,26362
"232",1848,"9",13264,13573,26837
"233",1848,"10",13505,13771,27276
"234",1848,"11",13708,13768,27476
"235",1848,"12",14854,14929,29783
"236",1848,"13",14223,14175,28398
"237",1848,"14",13487,13538,27025
"238",1848,"15",12786,13232,26018
"239",1848,"16",12973,13292,26265
"240",1848,"17",13457,13465,26922
"241",1848,"18",13641,13827,27468
"242",1848,"19",12815,12699,25514
"243",1848,"20",12693,12575,25268
"244",1848,"21",13582,13418,27000
"245",1848,"22",13348,12814,26162
"246",1848,"23",12558,11867,24425
"247",1848,"24",12848,12331,25179
"248",1848,"25",12372,11750,24122
"249",1848,"26",12771,12040,24811
"250",1848,"27",11948,11319,23267
"251",1848,"28",11176,10569,21745
"252",1848,"29",10358,9997,20355
"253",1848,"30",10666,10160,20826
"254",1848,"31",11114,10625,21739
"255",1848,"32",9299,8947,18246
"256",1848,"33",7196,7040,14236
"257",1848,"34",7533,7311,14844
"258",1848,"35",8292,8137,16429
"259",1848,"36",7561,7439,15000
"260",1848,"37",7113,7149,14262
"261",1848,"38",5956,5798,11754
"262",1848,"39",7379,7122,14501
"263",1848,"40",7647,7490,15137
"264",1848,"41",7598,7553,15151
"265",1848,"42",7457,7174,14631
"266",1848,"43",6624,6373,12997
"267",1848,"44",7006,6547,13553
"268",1848,"45",6409,5928,12337
"269",1848,"46",6983,6596,13579
"270",1848,"47",6925,6513,13438
"271",1848,"48",6839,6396,13235
"272",1848,"49",6585,6157,12742
"273",1848,"50",6489,6048,12537
"274",1848,"51",6143,5695,11838
"275",1848,"52",6223,5723,11946
"276",1848,"53",6337,5783,12120
"277",1848,"54",6241,5685,11926
"278",1848,"55",6219,5616,11835
"279",1848,"56",5722,5139,10861
"280",1848,"57",5467,4883,10350
"281",1848,"58",5107,4516,9623
"282",1848,"59",4967,4390,9357
"283",1848,"60",4486,3944,8430
"284",1848,"61",4492,3926,8418
"285",1848,"62",4154,3496,7650
"286",1848,"63",4176,3482,7658
"287",1848,"64",3590,2961,6551
"288",1848,"65",3808,3107,6915
"289",1848,"66",3663,2963,6626
"290",1848,"67",3567,2859,6426
"291",1848,"68",3127,2482,5609
"292",1848,"69",3038,2389,5427
"293",1848,"70",2840,2186,5026
"294",1848,"71",2465,1867,4332
"295",1848,"72",2764,2108,4872
"296",1848,"73",2091,1609,3700
"297",1848,"74",1703,1316,3019
"298",1848,"75",1718,1337,3055
"299",1848,"76",1735,1323,3058
"300",1848,"77",1562,1164,2726
"301",1848,"78",1440,1035,2475
"302",1848,"79",1227,870,2097
"303",1848,"80",1269,856,2125
"304",1848,"81",1162,782,1944
"305",1848,"82",1037,698,1735
"306",1848,"83",922,626,1548
"307",1848,"84",792,518,1310
"308",1848,"85",672,443,1115
"309",1848,"86",579,359,938
"310",1848,"87",487,281,768
"311",1848,"88",395,214,609
"312",1848,"89",309,167,476
"313",1848,"90",217,117,334
"314",1848,"91",154,89,243
"315",1848,"92",126,69,195
"316",1848,"93",100,53,153
"317",1848,"94",85,39,124
"318",1848,"95",67,28,95
"319",1848,"96",46,22,68
"320",1848,"97",36,22,58
"321",1848,"98",24,10,34
"322",1848,"99",19,8,27
"323",1848,"100",8,4,12
"324",1848,"101",3,2,5
"325",1848,"102",4,0,4
"326",1848,"103",3,1,4
"327",1848,"104",2,0,2
"328",1848,"105",1,0,1
"329",1848,"106",0,0,0
"330",1848,"107",0,0,0
"331",1848,"108",0,0,0
"332",1848,"109",0,0,0
"333",1848,"110+",0,0,0
"334",1849,"0",18537,18771,37308
"335",1849,"1",17506,18108,35614
"336",1849,"2",16863,17483,34346
"337",1849,"3",16101,16381,32482
"338",1849,"4",15025,15617,30642
"339",1849,"5",15366,16065,31431
"340",1849,"6",16323,16366,32689
"341",1849,"7",15351,15620,30971
"342",1849,"8",13899,13877,27776
"343",1849,"9",12940,13139,26079
"344",1849,"10",13172,13481,26653
"345",1849,"11",13441,13681,27122
"346",1849,"12",13697,13680,27377
"347",1849,"13",14871,14828,29699
"348",1849,"14",14295,14088,28383
"349",1849,"15",13588,13462,27050
"350",1849,"16",12880,13140,26020
"351",1849,"17",13063,13212,26275
"352",1849,"18",13564,13388,26952
"353",1849,"19",13720,13741,27461
"354",1849,"20",12858,12581,25439
"355",1849,"21",12709,12460,25169
"356",1849,"22",13560,13291,26851
"357",1849,"23",13253,12693,25946
"358",1849,"24",12423,11752,24175
"359",1849,"25",12672,12197,24869
"360",1849,"26",12175,11600,23775
"361",1849,"27",12549,11894,24443
"362",1849,"28",11724,11167,22891
"363",1849,"29",10961,10437,21398
"364",1849,"30",10132,9843,19975
"365",1849,"31",10454,9995,20449
"366",1849,"32",10889,10458,21347
"367",1849,"33",9137,8803,17940
"368",1849,"34",7073,6927,14000
"369",1849,"35",7414,7192,14606
"370",1849,"36",8156,7997,16153
"371",1849,"37",7456,7308,14764
"372",1849,"38",7012,7031,14043
"373",1849,"39",5893,5711,11604
"374",1849,"40",7285,7000,14285
"375",1849,"41",7582,7394,14976
"376",1849,"42",7535,7439,14974
"377",1849,"43",7421,7088,14509
"378",1849,"44",6600,6295,12895
"379",1849,"45",6990,6459,13449
"380",1849,"46",6392,5864,12256
"381",1849,"47",6952,6506,13458
"382",1849,"48",6860,6401,13261
"383",1849,"49",6757,6286,13043
"384",1849,"50",6453,5994,12447
"385",1849,"51",6367,5932,12299
"386",1849,"52",6020,5558,11578
"387",1849,"53",6102,5594,11696
"388",1849,"54",6223,5643,11866
"389",1849,"55",6123,5532,11655
"390",1849,"56",6100,5467,11567
"391",1849,"57",5629,5005,10634
"392",1849,"58",5376,4760,10136
"393",1849,"59",5028,4404,9432
"394",1849,"60",4812,4242,9054
"395",1849,"61",4387,3842,8229
"396",1849,"62",4381,3790,8171
"397",1849,"63",4034,3359,7393
"398",1849,"64",4012,3312,7324
"399",1849,"65",3443,2806,6249
"400",1849,"66",3628,2922,6550
"401",1849,"67",3490,2781,6271
"402",1849,"68",3365,2670,6035
"403",1849,"69",2953,2310,5263
"404",1849,"70",2817,2198,5015
"405",1849,"71",2685,2046,4731
"406",1849,"72",2298,1717,4015
"407",1849,"73",2598,1952,4550
"408",1849,"74",1933,1481,3414
"409",1849,"75",1540,1186,2726
"410",1849,"76",1559,1204,2763
"411",1849,"77",1543,1172,2715
"412",1849,"78",1379,1012,2391
"413",1849,"79",1288,906,2194
"414",1849,"80",1258,836,2094
"415",1849,"81",1136,755,1891
"416",1849,"82",1014,675,1689
"417",1849,"83",889,591,1480
"418",1849,"84",766,503,1269
"419",1849,"85",662,426,1088
"420",1849,"86",558,350,908
"421",1849,"87",473,286,759
"422",1849,"88",390,214,604
"423",1849,"89",323,169,492
"424",1849,"90",214,113,327
"425",1849,"91",169,91,260
"426",1849,"92",113,64,177
"427",1849,"93",92,46,138
"428",1849,"94",73,36,109
"429",1849,"95",60,26,86
"430",1849,"96",45,15,60
"431",1849,"97",27,17,44
"432",1849,"98",23,15,38
"433",1849,"99",18,7,25
"434",1849,"100",6,4,10
"435",1849,"101",4,2,6
"436",1849,"102",2,1,3
"437",1849,"103",2,0,2
"438",1849,"104",2,0,2
"439",1849,"105",1,0,1
"440",1849,"106",0,0,0
"441",1849,"107",0,0,0
"442",1849,"108",0,0,0
"443",1849,"109",0,0,0
"444",1849,"110+",0,0,0
"445",1850,"0",20073,20981,41054
"446",1850,"1",17500,17605,35105
"447",1850,"2",17070,17610,34680
"448",1850,"3",16576,17167,33743
"449",1850,"4",15937,16207,32144
"450",1850,"5",14892,15496,30388
"451",1850,"6",15184,15860,31044
"452",1850,"7",16005,16138,32143
"453",1850,"8",15062,15412,30474
"454",1850,"9",13710,13724,27434
"455",1850,"10",12809,13015,25824
"456",1850,"11",13065,13372,26437
"457",1850,"12",13374,13574,26948
"458",1850,"13",13671,13574,27245
"459",1850,"14",14873,14711,29584
"460",1850,"15",14353,13977,28330
"461",1850,"16",13669,13355,27024
"462",1850,"17",12964,13009,25973
"463",1850,"18",13142,13086,26228
"464",1850,"19",13647,13259,26906
"465",1850,"20",13743,13562,27305
"466",1850,"21",12859,12398,25257
"467",1850,"22",12684,12294,24978
"468",1850,"23",13503,13139,26642
"469",1850,"24",13114,12545,25659
"470",1850,"25",12252,11598,23850
"471",1850,"26",12459,12025,24484
"472",1850,"27",11946,11427,23373
"473",1850,"28",12290,11707,23997
"474",1850,"29",11472,10995,22467
"475",1850,"30",10698,10244,20942
"476",1850,"31",9901,9681,19582
"477",1850,"32",10210,9805,20015
"478",1850,"33",10648,10260,20908
"479",1850,"34",8954,8637,17591
"480",1850,"35",6942,6786,13728
"481",1850,"36",7268,7044,14312
"482",1850,"37",8017,7832,15849
"483",1850,"38",7328,7163,14491
"484",1850,"39",6912,6898,13810
"485",1850,"40",5792,5594,11386
"486",1850,"41",7197,6892,14089
"487",1850,"42",7494,7269,14763
"488",1850,"43",7463,7327,14790
"489",1850,"44",7369,6983,14352
"490",1850,"45",6565,6196,12761
"491",1850,"46",6964,6381,13345
"492",1850,"47",6365,5780,12145
"493",1850,"48",6907,6400,13307
"494",1850,"49",6792,6291,13083
"495",1850,"50",6640,6120,12760
"496",1850,"51",6337,5871,12208
"497",1850,"52",6231,5782,12013
"498",1850,"53",5883,5425,11308
"499",1850,"54",5985,5453,11438
"500",1850,"55",6097,5487,11584
"501",1850,"56",6003,5374,11377
"502",1850,"57",5994,5315,11309
"503",1850,"58",5533,4868,10401
"504",1850,"59",5286,4639,9925
"505",1850,"60",4880,4274,9154
"506",1850,"61",4721,4158,8879
"507",1850,"62",4295,3738,8033
"508",1850,"63",4269,3675,7944
"509",1850,"64",3904,3226,7130
"510",1850,"65",3866,3172,7038
"511",1850,"66",3298,2668,5966
"512",1850,"67",3470,2768,6238
"513",1850,"68",3309,2622,5931
"514",1850,"69",3192,2507,5699
"515",1850,"70",2754,2135,4889
"516",1850,"71",2668,2062,4730
"517",1850,"72",2509,1891,4400
"518",1850,"73",2150,1577,3727
"519",1850,"74",2419,1807,4226
"520",1850,"75",1772,1350,3122
"521",1850,"76",1408,1075,2483
"522",1850,"77",1397,1078,2475
"523",1850,"78",1373,1033,2406
"524",1850,"79",1242,898,2140
"525",1850,"80",1256,865,2121
"526",1850,"81",1126,746,1872
"527",1850,"82",988,658,1646
"528",1850,"83",867,579,1446
"529",1850,"84",734,479,1213
"530",1850,"85",637,420,1057
"531",1850,"86",549,342,891
"532",1850,"87",454,286,740
"533",1850,"88",376,225,601
"534",1850,"89",319,174,493
"535",1850,"90",239,120,359
"536",1850,"91",172,90,262
"537",1850,"92",133,68,201
"538",1850,"93",83,43,126
"539",1850,"94",68,31,99
"540",1850,"95",51,24,75
"541",1850,"96",41,14,55
"542",1850,"97",27,11,38
"543",1850,"98",16,11,27
"544",1850,"99",18,12,30
"545",1850,"100",7,5,12
"546",1850,"101",3,3,6
"547",1850,"102",3,1,4
"548",1850,"103",1,1,2
"549",1850,"104",1,0,1
"550",1850,"105",1,0,1
"551",1850,"106",0,0,0
"552",1850,"107",0,0,0
"553",1850,"108",0,0,0
"554",1850,"109",0,0,0
"555",1850,"110+",0,0,0
"556",1851,"0",19760,20233,39993
"557",1851,"1",19042,19803,38845
"558",1851,"2",17101,17156,34257
"559",1851,"3",16821,17355,34176
"560",1851,"4",16401,16985,33386
"561",1851,"5",15863,16138,32001
"562",1851,"6",14813,15413,30226
"563",1851,"7",15035,15697,30732
"564",1851,"8",15715,15928,31643
"565",1851,"9",14793,15223,30016
"566",1851,"10",13548,13594,27142
"567",1851,"11",12683,12908,25591
"568",1851,"12",12970,13273,26243
"569",1851,"13",13305,13474,26779
"570",1851,"14",13637,13478,27115
"571",1851,"15",14870,14600,29470
"572",1851,"16",14403,13864,28267
"573",1851,"17",13751,13240,26991
"574",1851,"18",13047,12868,25915
"575",1851,"19",13210,12954,26164
"576",1851,"20",13693,13083,26776
"577",1851,"21",13773,13377,27150
"578",1851,"22",12862,12231,25093
"579",1851,"23",12664,12162,24826
"580",1851,"24",13443,12995,26438
"581",1851,"25",12981,12396,25377
"582",1851,"26",12084,11445,23529
"583",1851,"27",12251,11869,24120
"584",1851,"28",11715,11253,22968
"585",1851,"29",12037,11542,23579
"586",1851,"30",11207,10810,22017
"587",1851,"31",10455,10083,20538
"588",1851,"32",9661,9531,19192
"589",1851,"33",9972,9619,19591
"590",1851,"34",10409,10075,20484
"591",1851,"35",8782,8476,17258
"592",1851,"36",6802,6650,13452
"593",1851,"37",7138,6905,14043
"594",1851,"38",7871,7683,15554
"595",1851,"39",7213,7030,14243
"596",1851,"40",6795,6762,13557
"597",1851,"41",5717,5507,11224
"598",1851,"42",7107,6774,13881
"599",1851,"43",7415,7163,14578
"600",1851,"44",7396,7212,14608
"601",1851,"45",7326,6875,14201
"602",1851,"46",6537,6120,12657
"603",1851,"47",6948,6296,13244
"604",1851,"48",6341,5692,12033
"605",1851,"49",6875,6307,13182
"606",1851,"50",6709,6147,12856
"607",1851,"51",6552,6014,12566
"608",1851,"52",6221,5735,11956
"609",1851,"53",6093,5659,11752
"610",1851,"54",5764,5302,11066
"611",1851,"55",5869,5316,11185
"612",1851,"56",5983,5345,11328
"613",1851,"57",5906,5232,11138
"614",1851,"58",5897,5180,11077
"615",1851,"59",5447,4751,10198
"616",1851,"60",5142,4499,9641
"617",1851,"61",4795,4183,8978
"618",1851,"62",4638,4052,8690
"619",1851,"63",4204,3634,7838
"620",1851,"64",4151,3541,7692
"621",1851,"65",3796,3100,6896
"622",1851,"66",3725,3026,6751
"623",1851,"67",3174,2535,5709
"624",1851,"68",3308,2612,5920
"625",1851,"69",3157,2464,5621
"626",1851,"70",3000,2321,5321
"627",1851,"71",2621,2001,4622
"628",1851,"72",2502,1903,4405
"629",1851,"73",2352,1735,4087
"630",1851,"74",1993,1436,3429
"631",1851,"75",2239,1646,3885
"632",1851,"76",1641,1225,2866
"633",1851,"77",1273,957,2230
"634",1851,"78",1257,948,2205
"635",1851,"79",1248,917,2165
"636",1851,"80",1303,906,2209
"637",1851,"81",1145,783,1928
"638",1851,"82",1002,657,1659
"639",1851,"83",865,570,1435
"640",1851,"84",737,478,1215
"641",1851,"85",626,404,1030
"642",1851,"86",543,344,887
"643",1851,"87",460,283,743
"644",1851,"88",374,231,605
"645",1851,"89",316,189,505
"646",1851,"90",235,130,365
"647",1851,"91",197,99,296
"648",1851,"92",135,69,204
"649",1851,"93",103,49,152
"650",1851,"94",59,29,88
"651",1851,"95",46,20,66
"652",1851,"96",32,14,46
"653",1851,"97",23,10,33
"654",1851,"98",16,6,22
"655",1851,"99",11,8,19
"656",1851,"100",6,5,11
"657",1851,"101",4,2,6
"658",1851,"102",2,1,3
"659",1851,"103",1,1,2
"660",1851,"104",0,0,0
"661",1851,"105",0,0,0
"662",1851,"106",0,0,0
"663",1851,"107",0,0,0
"664",1851,"108",0,0,0
"665",1851,"109",0,0,0
"666",1851,"110+",0,0,0
"667",1852,"0",20371,21129,41500
"668",1852,"1",18804,19179,37983
"669",1852,"2",18569,19302,37871
"670",1852,"3",16870,16889,33759
"671",1852,"4",16654,17164,33818
"672",1852,"5",16298,16877,33175
"673",1852,"6",15824,16114,31938
"674",1852,"7",14767,15374,30141
"675",1852,"8",14918,15566,30484
"676",1852,"9",15452,15753,31205
"677",1852,"10",14542,15052,29594
"678",1852,"11",13394,13476,26870
"679",1852,"12",12569,12811,25380
"680",1852,"13",12881,13180,26061
"681",1852,"14",13235,13377,26612
"682",1852,"15",13614,13383,26997
"683",1852,"16",14871,14485,29356
"684",1852,"17",14464,13749,28213
"685",1852,"18",13837,13112,26949
"686",1852,"19",13133,12716,25849
"687",1852,"20",13258,12799,26057
"688",1852,"21",13757,12927,26684
"689",1852,"22",13819,13226,27045
"690",1852,"23",12877,12113,24990
"691",1852,"24",12651,12059,24710
"692",1852,"25",13393,12868,26261
"693",1852,"26",12857,12272,25129
"694",1852,"27",11929,11314,23243
"695",1852,"28",12040,11729,23769
"696",1852,"29",11495,11107,22602
"697",1852,"30",11791,11374,23165
"698",1852,"31",10965,10649,21614
"699",1852,"32",10218,9930,20148
"700",1852,"33",9439,9386,18825
"701",1852,"34",9751,9448,19199
"702",1852,"35",10185,9898,20083
"703",1852,"36",8612,8320,16932
"704",1852,"37",6680,6526,13206
"705",1852,"38",7014,6788,13802
"706",1852,"39",7741,7552,15293
"707",1852,"40",7090,6892,13982
"708",1852,"41",6704,6656,13360
"709",1852,"42",5639,5410,11049
"710",1852,"43",7033,6675,13708
"711",1852,"44",7346,7064,14410
"712",1852,"45",7345,7102,14447
"713",1852,"46",7290,6790,14080
"714",1852,"47",6524,6049,12573
"715",1852,"48",6936,6217,13153
"716",1852,"49",6334,5628,11962
"717",1852,"50",6832,6202,13034
"718",1852,"51",6646,6050,12696
"719",1852,"52",6459,5898,12357
"720",1852,"53",6110,5613,11723
"721",1852,"54",5967,5539,11506
"722",1852,"55",5636,5168,10804
"723",1852,"56",5759,5181,10940
"724",1852,"57",5884,5217,11101
"725",1852,"58",5806,5087,10893
"726",1852,"59",5797,5047,10844
"727",1852,"60",5322,4607,9929
"728",1852,"61",5051,4394,9445
"729",1852,"62",4706,4074,8780
"730",1852,"63",4535,3935,8470
"731",1852,"64",4099,3516,7615
"732",1852,"65",4036,3414,7450
"733",1852,"66",3671,2969,6640
"734",1852,"67",3588,2880,6468
"735",1852,"68",3042,2400,5442
"736",1852,"69",3166,2464,5630
"737",1852,"70",2951,2281,5232
"738",1852,"71",2832,2159,4991
"739",1852,"72",2459,1846,4305
"740",1852,"73",2328,1751,4079
"741",1852,"74",2177,1580,3757
"742",1852,"75",1827,1293,3120
"743",1852,"76",2077,1502,3579
"744",1852,"77",1494,1102,2596
"745",1852,"78",1147,853,2000
"746",1852,"79",1136,854,1990
"747",1852,"80",1320,907,2227
"748",1852,"81",1179,811,1990
"749",1852,"82",1021,681,1702
"750",1852,"83",880,561,1441
"751",1852,"84",743,482,1225
"752",1852,"85",626,397,1023
"753",1852,"86",530,338,868
"754",1852,"87",458,285,743
"755",1852,"88",377,225,602
"756",1852,"89",312,186,498
"757",1852,"90",239,138,377
"758",1852,"91",189,97,286
"759",1852,"92",150,73,223
"760",1852,"93",96,48,144
"761",1852,"94",78,32,110
"762",1852,"95",39,18,57
"763",1852,"96",29,11,40
"764",1852,"97",25,9,34
"765",1852,"98",16,6,22
"766",1852,"99",10,4,14
"767",1852,"100",5,2,7
"768",1852,"101",3,0,3
"769",1852,"102",1,0,1
"770",1852,"103",1,0,1
"771",1852,"104",0,0,0
"772",1852,"105",0,0,0
"773",1852,"106",0,0,0
"774",1852,"107",0,0,0
"775",1852,"108",0,0,0
"776",1852,"109",0,0,0
"777",1852,"110+",0,0,0
"778",1853,"0",20107,20447,40554
"779",1853,"1",19183,19941,39124
"780",1853,"2",18188,18589,36777
"781",1853,"3",18220,18934,37154
"782",1853,"4",16669,16699,33368
"783",1853,"5",16542,17035,33577
"784",1853,"6",16208,16779,32987
"785",1853,"7",15810,16105,31915
"786",1853,"8",14729,15345,30074
"787",1853,"9",14804,15436,30240
"788",1853,"10",15178,15559,30737
"789",1853,"11",14288,14875,29163
"790",1853,"12",13243,13350,26593
"791",1853,"13",12454,12695,25149
"792",1853,"14",12776,13069,25845
"793",1853,"15",13163,13266,26429
"794",1853,"16",13574,13267,26841
"795",1853,"17",14864,14343,29207
"796",1853,"18",14509,13585,28094
"797",1853,"19",13912,12938,26850
"798",1853,"20",13164,12497,25661
"799",1853,"21",13287,12586,25873
"800",1853,"22",13805,12736,26541
"801",1853,"23",13841,13077,26918
"802",1853,"24",12874,11982,24856
"803",1853,"25",12618,11922,24540
"804",1853,"26",13328,12720,26048
"805",1853,"27",12722,12115,24837
"806",1853,"28",11746,11166,22912
"807",1853,"29",11825,11576,23401
"808",1853,"30",11259,10925,22184
"809",1853,"31",11534,11191,22725
"810",1853,"32",10708,10468,21176
"811",1853,"33",9968,9758,19726
"812",1853,"34",9208,9228,18436
"813",1853,"35",9515,9257,18772
"814",1853,"36",9945,9695,19640
"815",1853,"37",8435,8150,16585
"816",1853,"38",6546,6395,12941
"817",1853,"39",6883,6658,13541
"818",1853,"40",7589,7390,14979
"819",1853,"41",6976,6767,13743
"820",1853,"42",6594,6524,13118
"821",1853,"43",5562,5318,10880
"822",1853,"44",6946,6564,13510
"823",1853,"45",7271,6943,14214
"824",1853,"46",7278,6991,14269
"825",1853,"47",7254,6691,13945
"826",1853,"48",6497,5956,12453
"827",1853,"49",6923,6137,13060
"828",1853,"50",6291,5533,11824
"829",1853,"51",6786,6115,12901
"830",1853,"52",6561,5937,12498
"831",1853,"53",6352,5780,12132
"832",1853,"54",5980,5491,11471
"833",1853,"55",5809,5402,11211
"834",1853,"56",5499,5037,10536
"835",1853,"57",5643,5058,10701
"836",1853,"58",5761,5075,10836
"837",1853,"59",5690,4951,10641
"838",1853,"60",5650,4883,10533
"839",1853,"61",5215,4488,9703
"840",1853,"62",4942,4271,9213
"841",1853,"63",4589,3948,8537
"842",1853,"64",4419,3813,8232
"843",1853,"65",3984,3398,7382
"844",1853,"66",3898,3279,7177
"845",1853,"67",3547,2836,6383
"846",1853,"68",3440,2734,6174
"847",1853,"69",2913,2271,5184
"848",1853,"70",2964,2279,5243
"849",1853,"71",2789,2121,4910
"850",1853,"72",2659,1988,4647
"851",1853,"73",2288,1692,3980
"852",1853,"74",2148,1586,3734
"853",1853,"75",1988,1417,3405
"854",1853,"76",1669,1148,2817
"855",1853,"77",1894,1345,3239
"856",1853,"78",1349,977,2326
"857",1853,"79",1036,765,1801
"858",1853,"80",1365,916,2281
"859",1853,"81",1192,808,2000
"860",1853,"82",1051,704,1755
"861",1853,"83",895,581,1476
"862",1853,"84",754,469,1223
"863",1853,"85",628,397,1025
"864",1853,"86",526,328,854
"865",1853,"87",442,276,718
"866",1853,"88",372,225,597
"867",1853,"89",312,178,490
"868",1853,"90",234,133,367
"869",1853,"91",193,104,297
"870",1853,"92",142,70,212
"871",1853,"93",111,51,162
"872",1853,"94",71,30,101
"873",1853,"95",58,21,79
"874",1853,"96",22,9,31
"875",1853,"97",21,6,27
"876",1853,"98",18,5,23
"877",1853,"99",10,4,14
"878",1853,"100",5,3,8
"879",1853,"101",3,1,4
"880",1853,"102",1,0,1
"881",1853,"103",0,0,0
"882",1853,"104",0,0,0
"883",1853,"105",0,0,0
"884",1853,"106",0,0,0
"885",1853,"107",0,0,0
"886",1853,"108",0,0,0
"887",1853,"109",0,0,0
"888",1853,"110+",0,0,0
"889",1854,"0",20906,21666,42572
"890",1854,"1",19045,19329,38374
"891",1854,"2",18622,19346,37968
"892",1854,"3",17786,18202,35988
"893",1854,"4",17914,18629,36543
"894",1854,"5",16519,16540,33059
"895",1854,"6",16417,16899,33316
"896",1854,"7",16123,16682,32805
"897",1854,"8",15786,16091,31877
"898",1854,"9",14679,15306,29985
"899",1854,"10",14663,15283,29946
"900",1854,"11",14893,15362,30255
"901",1854,"12",14026,14693,28719
"902",1854,"13",13079,13205,26284
"903",1854,"14",12311,12562,24873
"904",1854,"15",12654,12943,25597
"905",1854,"16",13059,13134,26193
"906",1854,"17",13510,13122,26632
"907",1854,"18",14824,14147,28971
"908",1854,"19",14526,13370,27896
"909",1854,"20",13909,12687,26596
"910",1854,"21",13169,12208,25377
"911",1854,"22",13292,12337,25629
"912",1854,"23",13822,12557,26379
"913",1854,"24",13837,12915,26752
"914",1854,"25",12843,11814,24657
"915",1854,"26",12566,11761,24327
"916",1854,"27",13245,12536,25781
"917",1854,"28",12552,11941,24493
"918",1854,"29",11553,11005,22558
"919",1854,"30",11571,11361,22932
"920",1854,"31",10988,10707,21695
"921",1854,"32",11240,10969,22209
"922",1854,"33",10418,10251,20669
"923",1854,"34",9693,9553,19246
"924",1854,"35",8943,9032,17975
"925",1854,"36",9246,9018,18264
"926",1854,"37",9682,9463,19145
"927",1854,"38",8233,7960,16193
"928",1854,"39",6389,6235,12624
"929",1854,"40",6702,6482,13184
"930",1854,"41",7426,7229,14655
"931",1854,"42",6818,6600,13418
"932",1854,"43",6466,6384,12850
"933",1854,"44",5451,5201,10652
"934",1854,"45",6831,6414,13245
"935",1854,"46",7156,6810,13966
"936",1854,"47",7189,6852,14041
"937",1854,"48",7182,6553,13735
"938",1854,"49",6448,5846,12294
"939",1854,"50",6867,6019,12886
"940",1854,"51",6247,5444,11691
"941",1854,"52",6718,6000,12718
"942",1854,"53",6464,5811,12275
"943",1854,"54",6229,5652,11881
"944",1854,"55",5820,5339,11159
"945",1854,"56",5646,5251,10897
"946",1854,"57",5360,4906,10266
"947",1854,"58",5506,4910,10416
"948",1854,"59",5626,4927,10553
"949",1854,"60",5525,4771,10296
"950",1854,"61",5517,4736,10253
"951",1854,"62",5085,4341,9426
"952",1854,"63",4796,4122,8918
"953",1854,"64",4448,3806,8254
"954",1854,"65",4284,3681,7965
"955",1854,"66",3838,3262,7100
"956",1854,"67",3754,3134,6888
"957",1854,"68",3404,2693,6097
"958",1854,"69",3288,2586,5874
"959",1854,"70",2718,2114,4832
"960",1854,"71",2795,2129,4924
"961",1854,"72",2611,1963,4574
"962",1854,"73",2468,1828,4296
"963",1854,"74",2100,1532,3632
"964",1854,"75",1941,1421,3362
"965",1854,"76",1795,1260,3055
"966",1854,"77",1477,1001,2478
"967",1854,"78",1700,1196,2896
"968",1854,"79",1209,878,2087
"969",1854,"80",1375,931,2306
"970",1854,"81",1239,824,2063
"971",1854,"82",1066,708,1774
"972",1854,"83",927,611,1538
"973",1854,"84",771,496,1267
"974",1854,"85",641,390,1031
"975",1854,"86",532,332,864
"976",1854,"87",440,270,710
"977",1854,"88",358,219,577
"978",1854,"89",309,182,491
"979",1854,"90",239,141,380
"980",1854,"91",191,108,299
"981",1854,"92",149,84,233
"982",1854,"93",106,55,161
"983",1854,"94",86,39,125
"984",1854,"95",52,22,74
"985",1854,"96",41,14,55
"986",1854,"97",15,6,21
"987",1854,"98",14,3,17
"988",1854,"99",13,4,17
"989",1854,"100",8,2,10
"990",1854,"101",4,1,5
"991",1854,"102",2,0,2
"992",1854,"103",1,0,1
"993",1854,"104",0,0,0
"994",1854,"105",0,0,0
"995",1854,"106",0,0,0
"996",1854,"107",0,0,0
"997",1854,"108",0,0,0
"998",1854,"109",0,0,0
"999",1854,"110+",0,0,0
"1000",1855,"0",22737,23513,46250
"1001",1855,"1",19748,20500,40248
"1002",1855,"2",18492,18846,37338
"1003",1855,"3",18302,18994,37296
"1004",1855,"4",17528,17913,35441
"1005",1855,"5",17720,18427,36147
"1006",1855,"6",16423,16459,32882
"1007",1855,"7",16354,16835,33189
"1008",1855,"8",16077,16641,32718
"1009",1855,"9",15792,16117,31909
"1010",1855,"10",14644,15279,29923
"1011",1855,"11",14550,15155,29705
"1012",1855,"12",14638,15184,29822
"1013",1855,"13",13786,14516,28302
"1014",1855,"14",12921,13067,25988
"1015",1855,"15",12185,12442,24627
"1016",1855,"16",12537,12825,25362
"1017",1855,"17",12968,13000,25968
"1018",1855,"18",13452,12954,26406
"1019",1855,"19",14794,13940,28734
"1020",1855,"20",14508,13123,27631
"1021",1855,"21",13927,12423,26350
"1022",1855,"22",13194,11950,25144
"1023",1855,"23",13309,12158,25467
"1024",1855,"24",13854,12406,26260
"1025",1855,"25",13848,12756,26604
"1026",1855,"26",12833,11664,24497
"1027",1855,"27",12534,11609,24143
"1028",1855,"28",13169,12376,25545
"1029",1855,"29",12412,11794,24206
"1030",1855,"30",11368,10845,22213
"1031",1855,"31",11348,11193,22541
"1032",1855,"32",10746,10530,21276
"1033",1855,"33",10975,10787,21762
"1034",1855,"34",10163,10074,20237
"1035",1855,"35",9443,9381,18824
"1036",1855,"36",8702,8860,17562
"1037",1855,"37",9008,8821,17829
"1038",1855,"38",9446,9275,18721
"1039",1855,"39",8058,7803,15861
"1040",1855,"40",6247,6097,12344
"1041",1855,"41",6575,6364,12939
"1042",1855,"42",7280,7083,14363
"1043",1855,"43",6703,6480,13183
"1044",1855,"44",6361,6269,12630
"1045",1855,"45",5370,5099,10469
"1046",1855,"46",6736,6305,13041
"1047",1855,"47",7079,6701,13780
"1048",1855,"48",7122,6733,13855
"1049",1855,"49",7143,6455,13598
"1050",1855,"50",6407,5745,12152
"1051",1855,"51",6845,5937,12782
"1052",1855,"52",6216,5354,11570
"1053",1855,"53",6671,5900,12571
"1054",1855,"54",6387,5704,12091
"1055",1855,"55",6114,5528,11642
"1056",1855,"56",5694,5209,10903
"1057",1855,"57",5517,5131,10648
"1058",1855,"58",5236,4778,10014
"1059",1855,"59",5396,4786,10182
"1060",1855,"60",5475,4764,10239
"1061",1855,"61",5411,4636,10047
"1062",1855,"62",5396,4591,9987
"1063",1855,"63",4954,4200,9154
"1064",1855,"64",4667,3990,8657
"1065",1855,"65",4330,3687,8017
"1066",1855,"66",4162,3563,7725
"1067",1855,"67",3727,3146,6873
"1068",1855,"68",3630,3008,6638
"1069",1855,"69",3295,2576,5871
"1070",1855,"70",3112,2434,5546
"1071",1855,"71",2592,1993,4585
"1072",1855,"72",2644,1986,4630
"1073",1855,"73",2449,1818,4267
"1074",1855,"74",2295,1669,3964
"1075",1855,"75",1921,1379,3300
"1076",1855,"76",1767,1269,3036
"1077",1855,"77",1611,1107,2718
"1078",1855,"78",1314,866,2180
"1079",1855,"79",1547,1077,2624
"1080",1855,"80",1394,955,2349
"1081",1855,"81",1259,843,2102
"1082",1855,"82",1123,729,1852
"1083",1855,"83",953,619,1572
"1084",1855,"84",814,530,1344
"1085",1855,"85",667,420,1087
"1086",1855,"86",552,329,881
"1087",1855,"87",452,277,729
"1088",1855,"88",362,216,578
"1089",1855,"89",300,177,477
"1090",1855,"90",226,133,359
"1091",1855,"91",189,109,298
"1092",1855,"92",141,83,224
"1093",1855,"93",107,64,171
"1094",1855,"94",78,39,117
"1095",1855,"95",64,28,92
"1096",1855,"96",33,13,46
"1097",1855,"97",33,10,43
"1098",1855,"98",7,3,10
"1099",1855,"99",8,1,9
"1100",1855,"100",8,1,9
"1101",1855,"101",6,0,6
"1102",1855,"102",2,0,2
"1103",1855,"103",1,0,1
"1104",1855,"104",0,0,0
"1105",1855,"105",0,0,0
"1106",1855,"106",0,0,0
"1107",1855,"107",0,0,0
"1108",1855,"108",0,0,0
"1109",1855,"109",0,0,0
"1110",1855,"110+",0,0,0
"1111",1856,"0",22313,23331,45644
"1112",1856,"1",21325,22233,43558
"1113",1856,"2",19030,19852,38882
"1114",1856,"3",18124,18543,36667
"1115",1856,"4",18045,18739,36784
"1116",1856,"5",17382,17744,35126
"1117",1856,"6",17622,18301,35923
"1118",1856,"7",16432,16462,32894
"1119",1856,"8",16375,16843,33218
"1120",1856,"9",16090,16644,32734
"1121",1856,"10",15840,16178,32018
"1122",1856,"11",14660,15306,29966
"1123",1856,"12",14485,15075,29560
"1124",1856,"13",14424,15043,29467
"1125",1856,"14",13572,14378,27950
"1126",1856,"15",12797,12970,25767
"1127",1856,"16",12082,12356,24438
"1128",1856,"17",12456,12738,25194
"1129",1856,"18",12906,12891,25797
"1130",1856,"19",13429,12829,26258
"1131",1856,"20",14785,13765,28550
"1132",1856,"21",14560,12942,27502
"1133",1856,"22",14013,12261,26274
"1134",1856,"23",13275,11796,25071
"1135",1856,"24",13384,12049,25433
"1136",1856,"25",13942,12304,26246
"1137",1856,"26",13918,12663,26581
"1138",1856,"27",12881,11571,24452
"1139",1856,"28",12543,11527,24070
"1140",1856,"29",13152,12286,25438
"1141",1856,"30",12305,11684,23989
"1142",1856,"31",11232,10746,21978
"1143",1856,"32",11165,11078,22243
"1144",1856,"33",10548,10408,20956
"1145",1856,"34",10756,10657,21413
"1146",1856,"35",9944,9942,19886
"1147",1856,"36",9226,9245,18471
"1148",1856,"37",8500,8733,17233
"1149",1856,"38",8802,8672,17474
"1150",1856,"39",9244,9123,18367
"1151",1856,"40",7902,7662,15564
"1152",1856,"41",6148,6003,12151
"1153",1856,"42",6461,6253,12714
"1154",1856,"43",7172,6970,14142
"1155",1856,"44",6603,6374,12977
"1156",1856,"45",6278,6157,12435
"1157",1856,"46",5301,5019,10320
"1158",1856,"47",6672,6205,12877
"1159",1856,"48",7014,6591,13605
"1160",1856,"49",7077,6630,13707
"1161",1856,"50",7096,6351,13447
"1162",1856,"51",6388,5673,12061
"1163",1856,"52",6828,5855,12683
"1164",1856,"53",6194,5275,11469
"1165",1856,"54",6630,5815,12445
"1166",1856,"55",6303,5594,11897
"1167",1856,"56",6016,5414,11430
"1168",1856,"57",5585,5097,10682
"1169",1856,"58",5388,5008,10396
"1170",1856,"59",5120,4662,9782
"1171",1856,"60",5242,4621,9863
"1172",1856,"61",5354,4626,9980
"1173",1856,"62",5286,4484,9770
"1174",1856,"63",5250,4428,9678
"1175",1856,"64",4810,4047,8857
"1176",1856,"65",4530,3853,8383
"1177",1856,"66",4195,3557,7752
"1178",1856,"67",4043,3438,7481
"1179",1856,"68",3608,3023,6631
"1180",1856,"69",3512,2884,6396
"1181",1856,"70",3109,2422,5531
"1182",1856,"71",2957,2302,5259
"1183",1856,"72",2438,1856,4294
"1184",1856,"73",2465,1841,4306
"1185",1856,"74",2259,1654,3913
"1186",1856,"75",2082,1497,3579
"1187",1856,"76",1725,1217,2942
"1188",1856,"77",1549,1096,2645
"1189",1856,"78",1400,945,2345
"1190",1856,"79",1139,739,1878
"1191",1856,"80",1355,942,2297
"1192",1856,"81",1251,855,2106
"1193",1856,"82",1115,736,1851
"1194",1856,"83",982,628,1610
"1195",1856,"84",812,528,1340
"1196",1856,"85",685,444,1129
"1197",1856,"86",556,350,906
"1198",1856,"87",452,267,719
"1199",1856,"88",355,216,571
"1200",1856,"89",290,169,459
"1201",1856,"90",224,121,345
"1202",1856,"91",181,96,277
"1203",1856,"92",143,80,223
"1204",1856,"93",103,60,163
"1205",1856,"94",82,45,127
"1206",1856,"95",59,26,85
"1207",1856,"96",47,18,65
"1208",1856,"97",26,8,34
"1209",1856,"98",26,6,32
"1210",1856,"99",1,1,2
"1211",1856,"100",5,0,5
"1212",1856,"101",6,0,6
"1213",1856,"102",4,0,4
"1214",1856,"103",2,0,2
"1215",1856,"104",1,0,1
"1216",1856,"105",0,0,0
"1217",1856,"106",0,0,0
"1218",1856,"107",0,0,0
"1219",1856,"108",0,0,0
"1220",1856,"109",0,0,0
"1221",1856,"110+",0,0,0
"1222",1857,"0",22106,23193,45299
"1223",1857,"1",21195,21980,43175
"1224",1857,"2",20756,21589,42345
"1225",1857,"3",18677,19528,38205
"1226",1857,"4",17847,18294,36141
"1227",1857,"5",17844,18544,36388
"1228",1857,"6",17209,17587,34796
"1229",1857,"7",17498,18168,35666
"1230",1857,"8",16334,16354,32688
"1231",1857,"9",16345,16750,33095
"1232",1857,"10",16068,16543,32611
"1233",1857,"11",15824,16046,31870
"1234",1857,"12",14637,15171,29808
"1235",1857,"13",14477,14947,29424
"1236",1857,"14",14440,14923,29363
"1237",1857,"15",13603,14279,27882
"1238",1857,"16",12835,12901,25736
"1239",1857,"17",12127,12284,24411
"1240",1857,"18",12491,12646,25137
"1241",1857,"19",12915,12781,25696
"1242",1857,"20",13349,12672,26021
"1243",1857,"21",14620,13568,28188
"1244",1857,"22",14293,12747,27040
"1245",1857,"23",13735,12078,25813
"1246",1857,"24",13021,11629,24650
"1247",1857,"25",13146,11888,25034
"1248",1857,"26",13723,12165,25888
"1249",1857,"27",13741,12565,26306
"1250",1857,"28",12736,11492,24228
"1251",1857,"29",12410,11440,23850
"1252",1857,"30",12986,12150,25136
"1253",1857,"31",12142,11545,23687
"1254",1857,"32",11061,10590,21651
"1255",1857,"33",10998,10914,21912
"1256",1857,"34",10402,10256,20658
"1257",1857,"35",10618,10527,21145
"1258",1857,"36",9912,9842,19754
"1259",1857,"37",9221,9176,18397
"1260",1857,"38",8504,8687,17191
"1261",1857,"39",8804,8633,17437
"1262",1857,"40",9247,9067,18314
"1263",1857,"41",7855,7605,15460
"1264",1857,"42",6117,5958,12075
"1265",1857,"43",6433,6199,12632
"1266",1857,"44",7136,6893,14029
"1267",1857,"45",6558,6297,12855
"1268",1857,"46",6225,6068,12293
"1269",1857,"47",5246,4942,10188
"1270",1857,"48",6593,6093,12686
"1271",1857,"49",6916,6454,13370
"1272",1857,"50",6932,6488,13420
"1273",1857,"51",6958,6227,13185
"1274",1857,"52",6244,5548,11792
"1275",1857,"53",6660,5723,12383
"1276",1857,"54",6052,5152,11204
"1277",1857,"55",6472,5676,12148
"1278",1857,"56",6209,5475,11684
"1279",1857,"57",5942,5299,11241
"1280",1857,"58",5530,5003,10533
"1281",1857,"59",5340,4910,10250
"1282",1857,"60",5030,4541,9571
"1283",1857,"61",5144,4504,9648
"1284",1857,"62",5208,4491,9699
"1285",1857,"63",5122,4336,9458
"1286",1857,"64",5069,4261,9330
"1287",1857,"65",4643,3893,8536
"1288",1857,"66",4361,3678,8039
"1289",1857,"67",4042,3393,7435
"1290",1857,"68",3898,3274,7172
"1291",1857,"69",3490,2882,6372
"1292",1857,"70",3339,2717,6056
"1293",1857,"71",2974,2293,5267
"1294",1857,"72",2804,2156,4960
"1295",1857,"73",2301,1727,4028
"1296",1857,"74",2300,1696,3996
"1297",1857,"75",2094,1517,3611
"1298",1857,"76",1933,1371,3304
"1299",1857,"77",1600,1109,2709
"1300",1857,"78",1417,996,2413
"1301",1857,"79",1282,859,2141
"1302",1857,"80",1373,946,2319
"1303",1857,"81",1239,848,2087
"1304",1857,"82",1120,757,1877
"1305",1857,"83",988,641,1629
"1306",1857,"84",853,532,1385
"1307",1857,"85",694,441,1135
"1308",1857,"86",573,360,933
"1309",1857,"87",459,278,737
"1310",1857,"88",361,210,571
"1311",1857,"89",286,170,456
"1312",1857,"90",215,128,343
"1313",1857,"91",172,95,267
"1314",1857,"92",133,74,207
"1315",1857,"93",103,61,164
"1316",1857,"94",77,46,123
"1317",1857,"95",57,33,90
"1318",1857,"96",41,17,58
"1319",1857,"97",32,13,45
"1320",1857,"98",15,4,19
"1321",1857,"99",21,3,24
"1322",1857,"100",1,0,1
"1323",1857,"101",0,0,0
"1324",1857,"102",0,0,0
"1325",1857,"103",0,0,0
"1326",1857,"104",0,0,0
"1327",1857,"105",0,0,0
"1328",1857,"106",0,0,0
"1329",1857,"107",0,0,0
"1330",1857,"108",0,0,0
"1331",1857,"109",0,0,0
"1332",1857,"110+",0,0,0
"1333",1858,"0",23027,23837,46864
"1334",1858,"1",20950,21906,42856
"1335",1858,"2",20625,21342,41967
"1336",1858,"3",20380,21220,41600
"1337",1858,"4",18387,19247,37634
"1338",1858,"5",17647,18083,35730
"1339",1858,"6",17646,18359,36005
"1340",1858,"7",17042,17451,34493
"1341",1858,"8",17351,18025,35376
"1342",1858,"9",16235,16239,32474
"1343",1858,"10",16291,16639,32930
"1344",1858,"11",16033,16417,32450
"1345",1858,"12",15786,15895,31681
"1346",1858,"13",14596,15015,29611
"1347",1858,"14",14447,14793,29240
"1348",1858,"15",14424,14775,29199
"1349",1858,"16",13609,14152,27761
"1350",1858,"17",12844,12787,25631
"1351",1858,"18",12136,12158,24294
"1352",1858,"19",12489,12488,24977
"1353",1858,"20",12841,12564,25405
"1354",1858,"21",13224,12421,25645
"1355",1858,"22",14406,13310,27716
"1356",1858,"23",13985,12524,26509
"1357",1858,"24",13411,11858,25269
"1358",1858,"25",12717,11414,24131
"1359",1858,"26",12869,11675,24544
"1360",1858,"27",13459,11986,25445
"1361",1858,"28",13524,12419,25943
"1362",1858,"29",12550,11374,23924
"1363",1858,"30",12236,11287,23523
"1364",1858,"31",12790,11986,24776
"1365",1858,"32",11941,11357,23298
"1366",1858,"33",10847,10400,21247
"1367",1858,"34",10814,10717,21531
"1368",1858,"35",10225,10078,20303
"1369",1858,"36",10451,10347,20798
"1370",1858,"37",9864,9710,19574
"1371",1858,"38",9193,9085,18278
"1372",1858,"39",8491,8615,17106
"1373",1858,"40",8782,8572,17354
"1374",1858,"41",9246,8996,18242
"1375",1858,"42",7785,7528,15313
"1376",1858,"43",6069,5898,11967
"1377",1858,"44",6386,6117,12503
"1378",1858,"45",7079,6794,13873
"1379",1858,"46",6503,6197,12700
"1380",1858,"47",6155,5967,12122
"1381",1858,"48",5183,4841,10024
"1382",1858,"49",6499,5967,12466
"1383",1858,"50",6776,6287,13063
"1384",1858,"51",6803,6357,13160
"1385",1858,"52",6800,6081,12881
"1386",1858,"53",6089,5414,11503
"1387",1858,"54",6490,5576,12066
"1388",1858,"55",5887,5014,10901
"1389",1858,"56",6303,5529,11832
"1390",1858,"57",6111,5344,11455
"1391",1858,"58",5862,5191,11053
"1392",1858,"59",5469,4906,10375
"1393",1858,"60",5244,4779,10023
"1394",1858,"61",4963,4434,9397
"1395",1858,"62",5006,4371,9377
"1396",1858,"63",5040,4342,9382
"1397",1858,"64",4935,4171,9106
"1398",1858,"65",4879,4096,8975
"1399",1858,"66",4444,3700,8144
"1400",1858,"67",4182,3504,7686
"1401",1858,"68",3872,3223,7095
"1402",1858,"69",3750,3123,6873
"1403",1858,"70",3312,2723,6035
"1404",1858,"71",3192,2576,5768
"1405",1858,"72",2811,2155,4966
"1406",1858,"73",2639,2015,4654
"1407",1858,"74",2135,1596,3731
"1408",1858,"75",2119,1562,3681
"1409",1858,"76",1922,1386,3308
"1410",1858,"77",1781,1252,3033
"1411",1858,"78",1454,1011,2465
"1412",1858,"79",1289,912,2201
"1413",1858,"80",1370,948,2318
"1414",1858,"81",1246,846,2092
"1415",1858,"82",1097,746,1843
"1416",1858,"83",982,655,1637
"1417",1858,"84",847,540,1387
"1418",1858,"85",724,440,1164
"1419",1858,"86",572,352,924
"1420",1858,"87",468,283,751
"1421",1858,"88",360,218,578
"1422",1858,"89",285,161,446
"1423",1858,"90",217,122,339
"1424",1858,"91",167,99,266
"1425",1858,"92",127,70,197
"1426",1858,"93",96,53,149
"1427",1858,"94",79,45,124
"1428",1858,"95",55,33,88
"1429",1858,"96",41,23,64
"1430",1858,"97",27,11,38
"1431",1858,"98",22,8,30
"1432",1858,"99",11,1,12
"1433",1858,"100",0,0,0
"1434",1858,"101",0,0,0
"1435",1858,"102",0,0,0
"1436",1858,"103",0,0,0
"1437",1858,"104",0,0,0
"1438",1858,"105",0,0,0
"1439",1858,"106",0,0,0
"1440",1858,"107",0,0,0
"1441",1858,"108",0,0,0
"1442",1858,"109",0,0,0
"1443",1858,"110+",0,0,0
"1444",1859,"0",23688,24547,48235
"1445",1859,"1",22079,22771,44850
"1446",1859,"2",20482,21401,41883
"1447",1859,"3",20366,21001,41367
"1448",1859,"4",20167,20952,41119
"1449",1859,"5",18249,19080,37329
"1450",1859,"6",17525,17948,35473
"1451",1859,"7",17528,18259,35787
"1452",1859,"8",16926,17367,34293
"1453",1859,"9",17272,17937,35209
"1454",1859,"10",16169,16163,32332
"1455",1859,"11",16287,16565,32852
"1456",1859,"12",16030,16330,32360
"1457",1859,"13",15778,15777,31555
"1458",1859,"14",14580,14890,29470
"1459",1859,"15",14435,14668,29103
"1460",1859,"16",14436,14657,29093
"1461",1859,"17",13642,14045,27687
"1462",1859,"18",12879,12696,25575
"1463",1859,"19",12175,12061,24236
"1464",1859,"20",12495,12340,24835
"1465",1859,"21",12825,12405,25230
"1466",1859,"22",13147,12264,25411
"1467",1859,"23",14249,13137,27386
"1468",1859,"24",13727,12357,26084
"1469",1859,"25",13133,11690,24823
"1470",1859,"26",12466,11247,23713
"1471",1859,"27",12633,11525,24158
"1472",1859,"28",13239,11857,25096
"1473",1859,"29",13348,12327,25675
"1474",1859,"30",12404,11292,23696
"1475",1859,"31",12110,11205,23315
"1476",1859,"32",12629,11871,24500
"1477",1859,"33",11769,11227,22996
"1478",1859,"34",10684,10264,20948
"1479",1859,"35",10664,10578,21242
"1480",1859,"36",10079,9930,20009
"1481",1859,"37",10324,10212,20536
"1482",1859,"38",9844,9628,19472
"1483",1859,"39",9198,9035,18233
"1484",1859,"40",8493,8574,17067
"1485",1859,"41",8793,8544,17337
"1486",1859,"42",9256,8949,18205
"1487",1859,"43",7733,7476,15209
"1488",1859,"44",6035,5847,11882
"1489",1859,"45",6352,6051,12403
"1490",1859,"46",7046,6711,13757
"1491",1859,"47",6461,6121,12582
"1492",1859,"48",6105,5874,11979
"1493",1859,"49",5128,4762,9890
"1494",1859,"50",6391,5852,12243
"1495",1859,"51",6675,6163,12838
"1496",1859,"52",6673,6233,12906
"1497",1859,"53",6649,5953,12602
"1498",1859,"54",5950,5291,11241
"1499",1859,"55",6317,5439,11756
"1500",1859,"56",5730,4892,10622
"1501",1859,"57",6146,5395,11541
"1502",1859,"58",6019,5240,11259
"1503",1859,"59",5789,5099,10888
"1504",1859,"60",5380,4794,10174
"1505",1859,"61",5196,4683,9879
"1506",1859,"62",4883,4330,9213
"1507",1859,"63",4873,4245,9118
"1508",1859,"64",4876,4198,9074
"1509",1859,"65",4768,4028,8796
"1510",1859,"66",4685,3915,8600
"1511",1859,"67",4263,3534,7797
"1512",1859,"68",4014,3346,7360
"1513",1859,"69",3729,3087,6816
"1514",1859,"70",3574,2975,6549
"1515",1859,"71",3194,2599,5793
"1516",1859,"72",3047,2438,5485
"1517",1859,"73",2666,2032,4698
"1518",1859,"74",2476,1883,4359
"1519",1859,"75",1986,1486,3472
"1520",1859,"76",1962,1443,3405
"1521",1859,"77",1776,1271,3047
"1522",1859,"78",1636,1152,2788
"1523",1859,"79",1337,935,2272
"1524",1859,"80",1370,933,2303
"1525",1859,"81",1262,846,2108
"1526",1859,"82",1123,741,1864
"1527",1859,"83",979,644,1623
"1528",1859,"84",860,552,1412
"1529",1859,"85",737,446,1183
"1530",1859,"86",619,350,969
"1531",1859,"87",482,274,756
"1532",1859,"88",382,222,604
"1533",1859,"89",295,169,464
"1534",1859,"90",221,119,340
"1535",1859,"91",171,95,266
"1536",1859,"92",125,77,202
"1537",1859,"93",92,51,143
"1538",1859,"94",73,39,112
"1539",1859,"95",58,33,91
"1540",1859,"96",40,24,64
"1541",1859,"97",27,17,44
"1542",1859,"98",17,7,24
"1543",1859,"99",18,5,23
"1544",1859,"100",0,0,0
"1545",1859,"101",0,0,0
"1546",1859,"102",0,0,0
"1547",1859,"103",0,0,0
"1548",1859,"104",0,0,0
"1549",1859,"105",0,0,0
"1550",1859,"106",0,0,0
"1551",1859,"107",0,0,0
"1552",1859,"108",0,0,0
"1553",1859,"109",0,0,0
"1554",1859,"110+",0,0,0
"1555",1860,"0",24819,26079,50898
"1556",1860,"1",22589,23294,45883
"1557",1860,"2",21504,22170,43674
"1558",1860,"3",20112,21008,41120
"1559",1860,"4",20114,20693,40807
"1560",1860,"5",19993,20737,40730
"1561",1860,"6",18110,18917,37027
"1562",1860,"7",17415,17837,35252
"1563",1860,"8",17395,18157,35552
"1564",1860,"9",16821,17290,34111
"1565",1860,"10",17181,17846,35027
"1566",1860,"11",16119,16088,32207
"1567",1860,"12",16279,16494,32773
"1568",1860,"13",16029,16243,32272
"1569",1860,"14",15769,15657,31426
"1570",1860,"15",14555,14761,29316
"1571",1860,"16",14424,14540,28964
"1572",1860,"17",14445,14525,28970
"1573",1860,"18",13670,13923,27593
"1574",1860,"19",12908,12588,25496
"1575",1860,"20",12194,11929,24123
"1576",1860,"21",12507,12197,24704
"1577",1860,"22",12811,12267,25078
"1578",1860,"23",13082,12124,25206
"1579",1860,"24",14098,12983,27081
"1580",1860,"25",13468,12201,25669
"1581",1860,"26",12861,11527,24388
"1582",1860,"27",12214,11102,23316
"1583",1860,"28",12401,11380,23781
"1584",1860,"29",13022,11743,24765
"1585",1860,"30",13163,12226,25389
"1586",1860,"31",12256,11226,23482
"1587",1860,"32",11970,11118,23088
"1588",1860,"33",12447,11760,24207
"1589",1860,"34",11601,11104,22705
"1590",1860,"35",10512,10139,20651
"1591",1860,"36",10502,10424,20926
"1592",1860,"37",9935,9784,19719
"1593",1860,"38",10188,10085,20273
"1594",1860,"39",9821,9548,19369
"1595",1860,"40",9189,8981,18170
"1596",1860,"41",8509,8544,17053
"1597",1860,"42",8798,8519,17317
"1598",1860,"43",9268,8906,18174
"1599",1860,"44",7677,7416,15093
"1600",1860,"45",5998,5794,11792
"1601",1860,"46",6325,5981,12306
"1602",1860,"47",7009,6635,13644
"1603",1860,"48",6423,6035,12458
"1604",1860,"49",6051,5788,11839
"1605",1860,"50",5058,4677,9735
"1606",1860,"51",6313,5758,12071
"1607",1860,"52",6567,6027,12594
"1608",1860,"53",6547,6107,12654
"1609",1860,"54",6512,5815,12327
"1610",1860,"55",5805,5159,10964
"1611",1860,"56",6149,5299,11448
"1612",1860,"57",5584,4762,10346
"1613",1860,"58",5993,5268,11261
"1614",1860,"59",5935,5135,11070
"1615",1860,"60",5678,4977,10655
"1616",1860,"61",5324,4700,10024
"1617",1860,"62",5121,4577,9698
"1618",1860,"63",4790,4217,9007
"1619",1860,"64",4727,4110,8837
"1620",1860,"65",4714,4062,8776
"1621",1860,"66",4579,3855,8434
"1622",1860,"67",4492,3741,8233
"1623",1860,"68",4074,3365,7439
"1624",1860,"69",3854,3205,7059
"1625",1860,"70",3548,2934,6482
"1626",1860,"71",3441,2842,6283
"1627",1860,"72",3063,2463,5526
"1628",1860,"73",2906,2298,5204
"1629",1860,"74",2510,1900,4410
"1630",1860,"75",2316,1755,4071
"1631",1860,"76",1846,1373,3219
"1632",1860,"77",1818,1325,3143
"1633",1860,"78",1622,1157,2779
"1634",1860,"79",1508,1060,2568
"1635",1860,"80",1356,954,2310
"1636",1860,"81",1255,845,2100
"1637",1860,"82",1132,755,1887
"1638",1860,"83",998,652,1650
"1639",1860,"84",851,555,1406
"1640",1860,"85",742,471,1213
"1641",1860,"86",626,368,994
"1642",1860,"87",524,283,807
"1643",1860,"88",391,221,612
"1644",1860,"89",313,179,492
"1645",1860,"90",227,123,350
"1646",1860,"91",174,91,265
"1647",1860,"92",128,72,200
"1648",1860,"93",89,55,144
"1649",1860,"94",69,35,104
"1650",1860,"95",51,26,77
"1651",1860,"96",42,24,66
"1652",1860,"97",26,17,43
"1653",1860,"98",17,12,29
"1654",1860,"99",13,4,17
"1655",1860,"100",5,2,7
"1656",1860,"101",0,0,0
"1657",1860,"102",0,0,0
"1658",1860,"103",0,0,0
"1659",1860,"104",0,0,0
"1660",1860,"105",0,0,0
"1661",1860,"106",0,0,0
"1662",1860,"107",0,0,0
"1663",1860,"108",0,0,0
"1664",1860,"109",0,0,0
"1665",1860,"110+",0,0,0
"1666",1861,"0",24251,25456,49707
"1667",1861,"1",23698,24767,48465
"1668",1861,"2",22032,22688,44720
"1669",1861,"3",21053,21737,42790
"1670",1861,"4",19779,20672,40451
"1671",1861,"5",19936,20471,40407
"1672",1861,"6",19829,20551,40380
"1673",1861,"7",17993,18800,36793
"1674",1861,"8",17293,17736,35029
"1675",1861,"9",17278,18071,35349
"1676",1861,"10",16713,17219,33932
"1677",1861,"11",17105,17759,34864
"1678",1861,"12",16067,16019,32086
"1679",1861,"13",16277,16430,32707
"1680",1861,"14",16030,16157,32187
"1681",1861,"15",15753,15536,31289
"1682",1861,"16",14534,14632,29166
"1683",1861,"17",14412,14399,28811
"1684",1861,"18",14450,14381,28831
"1685",1861,"19",13694,13785,27479
"1686",1861,"20",12916,12447,25363
"1687",1861,"21",12206,11789,23995
"1688",1861,"22",12513,12060,24573
"1689",1861,"23",12798,12135,24933
"1690",1861,"24",13014,11997,25011
"1691",1861,"25",13937,12834,26771
"1692",1861,"26",13205,12044,25249
"1693",1861,"27",12580,11375,23955
"1694",1861,"28",11955,10954,22909
"1695",1861,"29",12161,11243,23404
"1696",1861,"30",12797,11619,24416
"1697",1861,"31",12987,12147,25134
"1698",1861,"32",12107,11161,23268
"1699",1861,"33",11821,11043,22864
"1700",1861,"34",12283,11663,23946
"1701",1861,"35",11435,10996,22431
"1702",1861,"36",10340,10005,20345
"1703",1861,"37",10355,10277,20632
"1704",1861,"38",9795,9650,19445
"1705",1861,"39",10061,9965,20026
"1706",1861,"40",9790,9458,19248
"1707",1861,"41",9193,8931,18124
"1708",1861,"42",8517,8510,17027
"1709",1861,"43",8800,8495,17295
"1710",1861,"44",9273,8849,18122
"1711",1861,"45",7616,7348,14964
"1712",1861,"46",5965,5732,11697
"1713",1861,"47",6291,5914,12205
"1714",1861,"48",6974,6544,13518
"1715",1861,"49",6380,5951,12331
"1716",1861,"50",5987,5695,11682
"1717",1861,"51",5010,4613,9623
"1718",1861,"52",6226,5648,11874
"1719",1861,"53",6459,5885,12344
"1720",1861,"54",6430,5970,12400
"1721",1861,"55",6366,5668,12034
"1722",1861,"56",5659,5023,10682
"1723",1861,"57",5985,5149,11134
"1724",1861,"58",5437,4637,10074
"1725",1861,"59",5843,5138,10981
"1726",1861,"60",5806,4991,10797
"1727",1861,"61",5605,4865,10470
"1728",1861,"62",5243,4586,9829
"1729",1861,"63",5038,4451,9489
"1730",1861,"64",4689,4082,8771
"1731",1861,"65",4587,3970,8557
"1732",1861,"66",4534,3880,8414
"1733",1861,"67",4395,3676,8071
"1734",1861,"68",4298,3552,7850
"1735",1861,"69",3899,3202,7101
"1736",1861,"70",3651,3026,6677
"1737",1861,"71",3401,2786,6187
"1738",1861,"72",3287,2681,5968
"1739",1861,"73",2926,2310,5236
"1740",1861,"74",2744,2132,4876
"1741",1861,"75",2346,1759,4105
"1742",1861,"76",2153,1610,3763
"1743",1861,"77",1710,1248,2958
"1744",1861,"78",1655,1194,2849
"1745",1861,"79",1478,1044,2522
"1746",1861,"80",1404,956,2360
"1747",1861,"81",1227,853,2080
"1748",1861,"82",1109,741,1850
"1749",1861,"83",990,653,1643
"1750",1861,"84",853,549,1402
"1751",1861,"85",718,462,1180
"1752",1861,"86",617,382,999
"1753",1861,"87",518,290,808
"1754",1861,"88",422,223,645
"1755",1861,"89",312,172,484
"1756",1861,"90",244,128,372
"1757",1861,"91",179,91,270
"1758",1861,"92",129,64,193
"1759",1861,"93",91,48,139
"1760",1861,"94",65,37,102
"1761",1861,"95",47,21,68
"1762",1861,"96",35,15,50
"1763",1861,"97",28,18,46
"1764",1861,"98",16,12,28
"1765",1861,"99",13,9,22
"1766",1861,"100",4,2,6
"1767",1861,"101",5,2,7
"1768",1861,"102",0,0,0
"1769",1861,"103",0,0,0
"1770",1861,"104",0,0,0
"1771",1861,"105",0,0,0
"1772",1861,"106",0,0,0
"1773",1861,"107",0,0,0
"1774",1861,"108",0,0,0
"1775",1861,"109",0,0,0
"1776",1861,"110+",0,0,0
"1777",1862,"0",22612,23484,46096
"1778",1862,"1",22333,23283,45616
"1779",1862,"2",22772,23803,46575
"1780",1862,"3",21354,21952,43306
"1781",1862,"4",20469,21123,41592
"1782",1862,"5",19375,20271,39646
"1783",1862,"6",19618,20114,39732
"1784",1862,"7",19530,20242,39772
"1785",1862,"8",17729,18539,36268
"1786",1862,"9",17048,17517,34565
"1787",1862,"10",17101,17919,35020
"1788",1862,"11",16557,17088,33645
"1789",1862,"12",16966,17622,34588
"1790",1862,"13",15966,15896,31862
"1791",1862,"14",16211,16299,32510
"1792",1862,"15",15943,15998,31941
"1793",1862,"16",15666,15332,30998
"1794",1862,"17",14432,14400,28832
"1795",1862,"18",14310,14124,28434
"1796",1862,"19",14366,14093,28459
"1797",1862,"20",13591,13476,27067
"1798",1862,"21",12828,12127,24955
"1799",1862,"22",12131,11505,23636
"1800",1862,"23",12442,11860,24302
"1801",1862,"24",12705,11933,24638
"1802",1862,"25",12864,11778,24642
"1803",1862,"26",13702,12592,26294
"1804",1862,"27",12859,11798,24657
"1805",1862,"28",12224,11132,23356
"1806",1862,"29",11627,10733,22360
"1807",1862,"30",11845,11005,22850
"1808",1862,"31",12518,11418,23936
"1809",1862,"32",12749,11978,24727
"1810",1862,"33",11894,11019,22913
"1811",1862,"34",11627,10893,22520
"1812",1862,"35",12073,11499,23572
"1813",1862,"36",11222,10807,22029
"1814",1862,"37",10134,9804,19938
"1815",1862,"38",10167,10071,20238
"1816",1862,"39",9619,9467,19086
"1817",1862,"40",9887,9793,19680
"1818",1862,"41",9742,9348,19090
"1819",1862,"42",9160,8841,18001
"1820",1862,"43",8503,8448,16951
"1821",1862,"44",8783,8432,17215
"1822",1862,"45",9257,8764,18021
"1823",1862,"46",7533,7269,14802
"1824",1862,"47",5912,5654,11566
"1825",1862,"48",6244,5815,12059
"1826",1862,"49",6920,6437,13357
"1827",1862,"50",6313,5840,12153
"1828",1862,"51",5913,5585,11498
"1829",1862,"52",4932,4513,9445
"1830",1862,"53",6122,5516,11638
"1831",1862,"54",6332,5722,12054
"1832",1862,"55",6284,5818,12102
"1833",1862,"56",6200,5508,11708
"1834",1862,"57",5499,4881,10380
"1835",1862,"58",5799,4990,10789
"1836",1862,"59",5281,4501,9782
"1837",1862,"60",5647,4985,10632
"1838",1862,"61",5696,4866,10562
"1839",1862,"62",5499,4742,10241
"1840",1862,"63",5141,4470,9611
"1841",1862,"64",4942,4319,9261
"1842",1862,"65",4581,3941,8522
"1843",1862,"66",4418,3813,8231
"1844",1862,"67",4338,3714,8052
"1845",1862,"68",4179,3493,7672
"1846",1862,"69",4093,3367,7460
"1847",1862,"70",3674,3019,6693
"1848",1862,"71",3482,2876,6358
"1849",1862,"72",3214,2624,5838
"1850",1862,"73",3102,2510,5612
"1851",1862,"74",2766,2144,4910
"1852",1862,"75",2555,1965,4520
"1853",1862,"76",2174,1615,3789
"1854",1862,"77",1973,1462,3435
"1855",1862,"78",1561,1126,2687
"1856",1862,"79",1504,1065,2569
"1857",1862,"80",1417,960,2377
"1858",1862,"81",1261,838,2099
"1859",1862,"82",1086,743,1829
"1860",1862,"83",975,625,1600
"1861",1862,"84",865,556,1421
"1862",1862,"85",730,462,1192
"1863",1862,"86",610,388,998
"1864",1862,"87",518,309,827
"1865",1862,"88",427,226,653
"1866",1862,"89",333,169,502
"1867",1862,"90",248,128,376
"1868",1862,"91",187,97,284
"1869",1862,"92",131,64,195
"1870",1862,"93",91,43,134
"1871",1862,"94",64,32,96
"1872",1862,"95",46,23,69
"1873",1862,"96",31,14,45
"1874",1862,"97",24,12,36
"1875",1862,"98",21,13,34
"1876",1862,"99",11,9,20
"1877",1862,"100",4,2,6
"1878",1862,"101",3,2,5
"1879",1862,"102",4,2,6
"1880",1862,"103",0,0,0
"1881",1862,"104",0,0,0
"1882",1862,"105",0,0,0
"1883",1862,"106",0,0,0
"1884",1862,"107",0,0,0
"1885",1862,"108",0,0,0
"1886",1862,"109",0,0,0
"1887",1862,"110+",0,0,0
"1888",1863,"0",23792,24822,48614
"1889",1863,"1",20681,21259,41940
"1890",1863,"2",21528,22440,43968
"1891",1863,"3",22037,23047,45084
"1892",1863,"4",20751,21352,42103
"1893",1863,"5",20058,20731,40789
"1894",1863,"6",19042,19933,38975
"1895",1863,"7",19358,19823,39181
"1896",1863,"8",19279,19981,39260
"1897",1863,"9",17512,18337,35849
"1898",1863,"10",16925,17392,34317
"1899",1863,"11",16972,17801,34773
"1900",1863,"12",16425,16991,33416
"1901",1863,"13",16860,17505,34365
"1902",1863,"14",15876,15786,31662
"1903",1863,"15",16145,16179,32324
"1904",1863,"16",15889,15848,31737
"1905",1863,"17",15597,15130,30727
"1906",1863,"18",14344,14154,28498
"1907",1863,"19",14237,13868,28105
"1908",1863,"20",14295,13825,28120
"1909",1863,"21",13547,13206,26753
"1910",1863,"22",12794,11905,24699
"1911",1863,"23",12109,11352,23461
"1912",1863,"24",12414,11700,24114
"1913",1863,"25",12654,11769,24423
"1914",1863,"26",12760,11610,24370
"1915",1863,"27",13497,12400,25897
"1916",1863,"28",12554,11607,24161
"1917",1863,"29",11908,10949,22857
"1918",1863,"30",11326,10538,21864
"1919",1863,"31",11580,10824,22404
"1920",1863,"32",12264,11262,23526
"1921",1863,"33",12534,11857,24391
"1922",1863,"34",11716,10924,22640
"1923",1863,"35",11474,10796,22270
"1924",1863,"36",11886,11365,23251
"1925",1863,"37",11042,10652,21694
"1926",1863,"38",9955,9643,19598
"1927",1863,"39",10003,9908,19911
"1928",1863,"40",9451,9304,18755
"1929",1863,"41",9741,9661,19402
"1930",1863,"42",9706,9247,18953
"1931",1863,"43",9151,8784,17935
"1932",1863,"44",8506,8399,16905
"1933",1863,"45",8778,8388,17166
"1934",1863,"46",9255,8710,17965
"1935",1863,"47",7471,7195,14666
"1936",1863,"48",5873,5583,11456
"1937",1863,"49",6205,5737,11942
"1938",1863,"50",6871,6341,13212
"1939",1863,"51",6263,5756,12019
"1940",1863,"52",5845,5493,11338
"1941",1863,"53",4862,4426,9288
"1942",1863,"54",6020,5394,11414
"1943",1863,"55",6207,5564,11771
"1944",1863,"56",6141,5671,11812
"1945",1863,"57",6037,5362,11399
"1946",1863,"58",5337,4740,10077
"1947",1863,"59",5624,4846,10470
"1948",1863,"60",5094,4355,9449
"1949",1863,"61",5471,4836,10307
"1950",1863,"62",5575,4731,10306
"1951",1863,"63",5382,4618,10000
"1952",1863,"64",5044,4339,9383
"1953",1863,"65",4848,4177,9025
"1954",1863,"66",4460,3795,8255
"1955",1863,"67",4249,3654,7903
"1956",1863,"68",4136,3531,7667
"1957",1863,"69",3984,3313,7297
"1958",1863,"70",3859,3172,7031
"1959",1863,"71",3488,2854,6342
"1960",1863,"72",3282,2701,5983
"1961",1863,"73",3020,2446,5466
"1962",1863,"74",2927,2333,5260
"1963",1863,"75",2589,1977,4566
"1964",1863,"76",2385,1803,4188
"1965",1863,"77",1996,1466,3462
"1966",1863,"78",1810,1319,3129
"1967",1863,"79",1424,1001,2425
"1968",1863,"80",1423,944,2367
"1969",1863,"81",1277,845,2122
"1970",1863,"82",1123,730,1853
"1971",1863,"83",955,628,1583
"1972",1863,"84",852,530,1382
"1973",1863,"85",744,471,1215
"1974",1863,"86",625,388,1013
"1975",1863,"87",513,317,830
"1976",1863,"88",428,246,674
"1977",1863,"89",340,172,512
"1978",1863,"90",273,132,405
"1979",1863,"91",194,103,297
"1980",1863,"92",142,74,216
"1981",1863,"93",96,46,142
"1982",1863,"94",65,31,96
"1983",1863,"95",46,21,67
"1984",1863,"96",31,17,48
"1985",1863,"97",21,11,32
"1986",1863,"98",17,8,25
"1987",1863,"99",17,11,28
"1988",1863,"100",3,3,6
"1989",1863,"101",4,1,5
"1990",1863,"102",3,1,4
"1991",1863,"103",4,2,6
"1992",1863,"104",0,0,0
"1993",1863,"105",0,0,0
"1994",1863,"106",0,0,0
"1995",1863,"107",0,0,0
"1996",1863,"108",0,0,0
"1997",1863,"109",0,0,0
"1998",1863,"110+",0,0,0
"1999",1864,"0",24622,25759,50381
"2000",1864,"1",22239,23051,45290
"2001",1864,"2",20146,20741,40887
"2002",1864,"3",21071,21959,43030
"2003",1864,"4",21598,22572,44170
"2004",1864,"5",20479,21068,41547
"2005",1864,"6",19791,20461,40252
"2006",1864,"7",18827,19712,38539
"2007",1864,"8",19201,19619,38820
"2008",1864,"9",19125,19816,38941
"2009",1864,"10",17452,18254,35706
"2010",1864,"11",16866,17323,34189
"2011",1864,"12",16883,17734,34617
"2012",1864,"13",16344,16933,33277
"2013",1864,"14",16785,17420,34205
"2014",1864,"15",15810,15708,31518
"2015",1864,"16",16135,16092,32227
"2016",1864,"17",15877,15729,31606
"2017",1864,"18",15572,14951,30523
"2018",1864,"19",14313,13967,28280
"2019",1864,"20",14206,13669,27875
"2020",1864,"21",14288,13627,27915
"2021",1864,"22",13562,13036,26598
"2022",1864,"23",12818,11791,24609
"2023",1864,"24",12137,11249,23386
"2024",1864,"25",12434,11592,24026
"2025",1864,"26",12652,11668,24320
"2026",1864,"27",12694,11502,24196
"2027",1864,"28",13343,12272,25615
"2028",1864,"29",12294,11479,23773
"2029",1864,"30",11617,10796,22413
"2030",1864,"31",11074,10399,21473
"2031",1864,"32",11343,10689,22032
"2032",1864,"33",12036,11151,23187
"2033",1864,"34",12354,11782,24136
"2034",1864,"35",11578,10880,22458
"2035",1864,"36",11344,10731,22075
"2036",1864,"37",11733,11265,22998
"2037",1864,"38",10887,10532,21419
"2038",1864,"39",9797,9523,19320
"2039",1864,"40",9847,9743,19590
"2040",1864,"41",9317,9163,18480
"2041",1864,"42",9612,9514,19126
"2042",1864,"43",9698,9159,18857
"2043",1864,"44",9164,8719,17883
"2044",1864,"45",8525,8350,16875
"2045",1864,"46",8789,8357,17146
"2046",1864,"47",9278,8642,17920
"2047",1864,"48",7425,7106,14531
"2048",1864,"49",5846,5515,11361
"2049",1864,"50",6174,5661,11835
"2050",1864,"51",6839,6260,13099
"2051",1864,"52",6218,5677,11895
"2052",1864,"53",5784,5402,11186
"2053",1864,"54",4797,4339,9136
"2054",1864,"55",5920,5271,11191
"2055",1864,"56",6086,5404,11490
"2056",1864,"57",6002,5526,11528
"2057",1864,"58",5873,5204,11077
"2058",1864,"59",5185,4597,9782
"2059",1864,"60",5420,4679,10099
"2060",1864,"61",4928,4213,9141
"2061",1864,"62",5284,4677,9961
"2062",1864,"63",5444,4594,10038
"2063",1864,"64",5270,4474,9744
"2064",1864,"65",4948,4197,9145
"2065",1864,"66",4739,4029,8768
"2066",1864,"67",4340,3646,7986
"2067",1864,"68",4072,3478,7550
"2068",1864,"69",3955,3352,7307
"2069",1864,"70",3746,3116,6862
"2070",1864,"71",3654,2991,6645
"2071",1864,"72",3260,2659,5919
"2072",1864,"73",3062,2504,5566
"2073",1864,"74",2823,2258,5081
"2074",1864,"75",2721,2150,4871
"2075",1864,"76",2420,1808,4228
"2076",1864,"77",2198,1629,3827
"2077",1864,"78",1824,1317,3141
"2078",1864,"79",1649,1169,2818
"2079",1864,"80",1389,973,2362
"2080",1864,"81",1271,824,2095
"2081",1864,"82",1128,732,1860
"2082",1864,"83",982,612,1594
"2083",1864,"84",822,529,1351
"2084",1864,"85",721,442,1163
"2085",1864,"86",630,395,1025
"2086",1864,"87",521,314,835
"2087",1864,"88",416,251,667
"2088",1864,"89",334,190,524
"2089",1864,"90",280,135,415
"2090",1864,"91",219,106,325
"2091",1864,"92",149,80,229
"2092",1864,"93",107,55,162
"2093",1864,"94",70,33,103
"2094",1864,"95",47,20,67
"2095",1864,"96",31,15,46
"2096",1864,"97",21,13,34
"2097",1864,"98",14,7,21
"2098",1864,"99",13,6,19
"2099",1864,"100",4,2,6
"2100",1864,"101",2,2,4
"2101",1864,"102",3,1,4
"2102",1864,"103",2,1,3
"2103",1864,"104",3,2,5
"2104",1864,"105",0,0,0
"2105",1864,"106",0,0,0
"2106",1864,"107",0,0,0
"2107",1864,"108",0,0,0
"2108",1864,"109",0,0,0
"2109",1864,"110+",0,0,0
"2110",1865,"0",24419,25550,49969
"2111",1865,"1",23344,24117,47461
"2112",1865,"2",21671,22469,44140
"2113",1865,"3",19912,20467,40379
"2114",1865,"4",20883,21723,42606
"2115",1865,"5",21384,22337,43721
"2116",1865,"6",20274,20850,41124
"2117",1865,"7",19567,20250,39817
"2118",1865,"8",18641,19525,38166
"2119",1865,"9",19071,19457,38528
"2120",1865,"10",19023,19684,38707
"2121",1865,"11",17369,18155,35524
"2122",1865,"12",16772,17238,34010
"2123",1865,"13",16776,17645,34421
"2124",1865,"14",16228,16844,33072
"2125",1865,"15",16666,17304,33970
"2126",1865,"16",15725,15596,31321
"2127",1865,"17",16093,15965,32058
"2128",1865,"18",15828,15546,31374
"2129",1865,"19",15514,14721,30235
"2130",1865,"20",14223,13694,27917
"2131",1865,"21",14130,13377,27507
"2132",1865,"22",14239,13356,27595
"2133",1865,"23",13541,12842,26383
"2134",1865,"24",12799,11631,24430
"2135",1865,"25",12127,11096,23223
"2136",1865,"26",12421,11438,23859
"2137",1865,"27",12607,11516,24123
"2138",1865,"28",12596,11350,23946
"2139",1865,"29",13156,12107,25263
"2140",1865,"30",11979,11292,23271
"2141",1865,"31",11304,10612,21916
"2142",1865,"32",10778,10221,20999
"2143",1865,"33",11061,10519,21580
"2144",1865,"34",11775,11011,22786
"2145",1865,"35",12153,11688,23841
"2146",1865,"36",11407,10799,22206
"2147",1865,"37",11197,10634,21831
"2148",1865,"38",11554,11142,22696
"2149",1865,"39",10708,10400,21108
"2150",1865,"40",9592,9359,18951
"2151",1865,"41",9672,9582,19254
"2152",1865,"42",9148,8994,18142
"2153",1865,"43",9463,9371,18834
"2154",1865,"44",9669,9056,18725
"2155",1865,"45",9150,8649,17799
"2156",1865,"46",8520,8309,16829
"2157",1865,"47",8786,8308,17094
"2158",1865,"48",9279,8559,17838
"2159",1865,"49",7355,7022,14377
"2160",1865,"50",5793,5449,11242
"2161",1865,"51",6132,5590,11722
"2162",1865,"52",6785,6177,12962
"2163",1865,"53",6158,5592,11750
"2164",1865,"54",5703,5305,11008
"2165",1865,"55",4710,4246,8956
"2166",1865,"56",5800,5137,10937
"2167",1865,"57",5947,5242,11189
"2168",1865,"58",5838,5369,11207
"2169",1865,"59",5699,5044,10743
"2170",1865,"60",4984,4424,9408
"2171",1865,"61",5213,4508,9721
"2172",1865,"62",4723,4050,8773
"2173",1865,"63",5058,4506,9564
"2174",1865,"64",5290,4430,9720
"2175",1865,"65",5130,4311,9441
"2176",1865,"66",4810,4040,8850
"2177",1865,"67",4604,3869,8473
"2178",1865,"68",4185,3472,7657
"2179",1865,"69",3890,3298,7188
"2180",1865,"70",3702,3144,6846
"2181",1865,"71",3532,2932,6464
"2182",1865,"72",3394,2775,6169
"2183",1865,"73",3000,2438,5438
"2184",1865,"74",2831,2295,5126
"2185",1865,"75",2589,2060,4649
"2186",1865,"76",2515,1963,4478
"2187",1865,"77",2224,1627,3851
"2188",1865,"78",2011,1456,3467
"2189",1865,"79",1648,1162,2810
"2190",1865,"80",1447,1025,2472
"2191",1865,"81",1228,853,2081
"2192",1865,"82",1112,711,1823
"2193",1865,"83",977,613,1590
"2194",1865,"84",840,513,1353
"2195",1865,"85",683,440,1123
"2196",1865,"86",599,366,965
"2197",1865,"87",519,321,840
"2198",1865,"88",417,249,666
"2199",1865,"89",315,195,510
"2200",1865,"90",264,152,416
"2201",1865,"91",217,109,326
"2202",1865,"92",167,84,251
"2203",1865,"93",108,62,170
"2204",1865,"94",77,42,119
"2205",1865,"95",49,22,71
"2206",1865,"96",30,14,44
"2207",1865,"97",19,11,30
"2208",1865,"98",13,9,22
"2209",1865,"99",9,5,14
"2210",1865,"100",5,2,7
"2211",1865,"101",3,1,4
"2212",1865,"102",1,1,2
"2213",1865,"103",2,1,3
"2214",1865,"104",2,1,3
"2215",1865,"105",3,2,5
"2216",1865,"106",0,0,0
"2217",1865,"107",0,0,0
"2218",1865,"108",0,0,0
"2219",1865,"109",0,0,0
"2220",1865,"110+",0,0,0
"2221",1866,"0",25482,26282,51764
"2222",1866,"1",23554,24410,47964
"2223",1866,"2",23101,23713,46814
"2224",1866,"3",21479,22242,43721
"2225",1866,"4",19819,20379,40198
"2226",1866,"5",20811,21629,42440
"2227",1866,"6",21174,22070,43244
"2228",1866,"7",20024,20560,40584
"2229",1866,"8",19285,19945,39230
"2230",1866,"9",18368,19228,37596
"2231",1866,"10",18911,19231,38142
"2232",1866,"11",18892,19515,38407
"2233",1866,"12",17258,18040,35298
"2234",1866,"13",16676,17138,33814
"2235",1866,"14",16652,17542,34194
"2236",1866,"15",16088,16743,32831
"2237",1866,"16",16556,17177,33733
"2238",1866,"17",15637,15473,31110
"2239",1866,"18",16056,15814,31870
"2240",1866,"19",15794,15366,31160
"2241",1866,"20",15448,14469,29917
"2242",1866,"21",14153,13414,27567
"2243",1866,"22",14071,13111,27182
"2244",1866,"23",14210,13148,27358
"2245",1866,"24",13526,12654,26180
"2246",1866,"25",12788,11474,24262
"2247",1866,"26",12128,10950,23078
"2248",1866,"27",12413,11284,23697
"2249",1866,"28",12578,11366,23944
"2250",1866,"29",12514,11198,23712
"2251",1866,"30",12949,11918,24867
"2252",1866,"31",11669,11108,22777
"2253",1866,"32",10967,10421,21388
"2254",1866,"33",10461,10040,20501
"2255",1866,"34",10770,10347,21117
"2256",1866,"35",11513,10879,22392
"2257",1866,"36",11937,11584,23521
"2258",1866,"37",11237,10716,21953
"2259",1866,"38",11043,10537,21580
"2260",1866,"39",11370,11027,22397
"2261",1866,"40",10496,10237,20733
"2262",1866,"41",9390,9199,18589
"2263",1866,"42",9484,9391,18875
"2264",1866,"43",8976,8825,17801
"2265",1866,"44",9309,9208,18517
"2266",1866,"45",9638,8945,18583
"2267",1866,"46",9137,8587,17724
"2268",1866,"47",8525,8251,16776
"2269",1866,"48",8785,8246,17031
"2270",1866,"49",9281,8481,17762
"2271",1866,"50",7290,6938,14228
"2272",1866,"51",5756,5388,11144
"2273",1866,"52",6097,5513,11610
"2274",1866,"53",6742,6082,12824
"2275",1866,"54",6104,5494,11598
"2276",1866,"55",5629,5194,10823
"2277",1866,"56",4633,4137,8770
"2278",1866,"57",5686,4998,10684
"2279",1866,"58",5808,5057,10865
"2280",1866,"59",5686,5201,10887
"2281",1866,"60",5503,4866,10369
"2282",1866,"61",4805,4265,9070
"2283",1866,"62",4996,4333,9329
"2284",1866,"63",4513,3895,8408
"2285",1866,"64",4844,4330,9174
"2286",1866,"65",5148,4271,9419
"2287",1866,"66",4993,4160,9153
"2288",1866,"67",4691,3902,8593
"2289",1866,"68",4483,3713,8196
"2290",1866,"69",4070,3323,7393
"2291",1866,"70",3681,3102,6783
"2292",1866,"71",3508,2962,6470
"2293",1866,"72",3292,2723,6015
"2294",1866,"73",3138,2545,5683
"2295",1866,"74",2762,2217,4979
"2296",1866,"75",2595,2088,4683
"2297",1866,"76",2390,1872,4262
"2298",1866,"77",2317,1773,4090
"2299",1866,"78",2063,1457,3520
"2300",1866,"79",1845,1281,3126
"2301",1866,"80",1495,1042,2537
"2302",1866,"81",1299,908,2207
"2303",1866,"82",1082,744,1826
"2304",1866,"83",974,596,1570
"2305",1866,"84",846,516,1362
"2306",1866,"85",713,427,1140
"2307",1866,"86",570,365,935
"2308",1866,"87",497,294,791
"2309",1866,"88",424,257,681
"2310",1866,"89",325,195,520
"2311",1866,"90",251,154,405
"2312",1866,"91",207,124,331
"2313",1866,"92",170,85,255
"2314",1866,"93",129,64,193
"2315",1866,"94",80,48,128
"2316",1866,"95",58,30,88
"2317",1866,"96",33,16,49
"2318",1866,"97",19,10,29
"2319",1866,"98",12,7,19
"2320",1866,"99",9,6,15
"2321",1866,"100",9,5,14
"2322",1866,"101",5,2,7
"2323",1866,"102",3,1,4
"2324",1866,"103",1,0,1
"2325",1866,"104",0,0,0
"2326",1866,"105",0,0,0
"2327",1866,"106",0,0,0
"2328",1866,"107",0,0,0
"2329",1866,"108",0,0,0
"2330",1866,"109",0,0,0
"2331",1866,"110+",0,0,0
"2332",1867,"0",24741,25779,50520
"2333",1867,"1",24064,24650,48714
"2334",1867,"2",22736,23563,46299
"2335",1867,"3",22471,23067,45538
"2336",1867,"4",21027,21759,42786
"2337",1867,"5",19502,20008,39510
"2338",1867,"6",20510,21292,41802
"2339",1867,"7",20909,21774,42683
"2340",1867,"8",19780,20274,40054
"2341",1867,"9",19053,19688,38741
"2342",1867,"10",18163,19001,37164
"2343",1867,"11",18725,19037,37762
"2344",1867,"12",18727,19342,38069
"2345",1867,"13",17112,17868,34980
"2346",1867,"14",16532,16965,33497
"2347",1867,"15",16512,17345,33857
"2348",1867,"16",16387,16520,32907
"2349",1867,"17",16617,16910,33527
"2350",1867,"18",15336,15134,30470
"2351",1867,"19",15522,15431,30953
"2352",1867,"20",15385,14904,30289
"2353",1867,"21",14930,13996,28926
"2354",1867,"22",13956,12945,26901
"2355",1867,"23",13853,12764,26617
"2356",1867,"24",13853,12748,26601
"2357",1867,"25",13004,12195,25199
"2358",1867,"26",12146,10992,23138
"2359",1867,"27",11387,10379,21766
"2360",1867,"28",11587,10636,22223
"2361",1867,"29",11850,10850,22700
"2362",1867,"30",11904,10804,22708
"2363",1867,"31",12854,11745,24599
"2364",1867,"32",12089,11039,23128
"2365",1867,"33",11585,10466,22051
"2366",1867,"34",10889,9996,20885
"2367",1867,"35",11008,10212,21220
"2368",1867,"36",11445,10539,21984
"2369",1867,"37",11464,11158,22622
"2370",1867,"38",10661,10203,20864
"2371",1867,"39",10582,10125,20707
"2372",1867,"40",11011,10733,21744
"2373",1867,"41",10438,10157,20595
"2374",1867,"42",9539,9235,18774
"2375",1867,"43",9735,9541,19276
"2376",1867,"44",9029,8874,17903
"2377",1867,"45",9263,9156,18419
"2378",1867,"46",9491,8723,18214
"2379",1867,"47",9007,8293,17300
"2380",1867,"48",8395,7896,16291
"2381",1867,"49",8655,7951,16606
"2382",1867,"50",9164,8271,17435
"2383",1867,"51",7223,6868,14091
"2384",1867,"52",5737,5385,11122
"2385",1867,"53",6127,5584,11711
"2386",1867,"54",6720,6091,12811
"2387",1867,"55",6031,5432,11463
"2388",1867,"56",5511,5107,10618
"2389",1867,"57",4513,4028,8541
"2390",1867,"58",5571,4875,10446
"2391",1867,"59",5689,4931,10620
"2392",1867,"60",5564,5074,10638
"2393",1867,"61",5377,4735,10112
"2394",1867,"62",4675,4133,8808
"2395",1867,"63",4861,4188,9049
"2396",1867,"64",4372,3741,8113
"2397",1867,"65",4790,4156,8946
"2398",1867,"66",4981,4105,9086
"2399",1867,"67",4803,3952,8755
"2400",1867,"68",4496,3668,8164
"2401",1867,"69",4282,3497,7779
"2402",1867,"70",3868,3125,6993
"2403",1867,"71",3477,2943,6420
"2404",1867,"72",3303,2825,6128
"2405",1867,"73",3086,2567,5653
"2406",1867,"74",2933,2383,5316
"2407",1867,"75",2561,2037,4598
"2408",1867,"76",2396,1815,4211
"2409",1867,"77",2127,1576,3703
"2410",1867,"78",1941,1434,3375
"2411",1867,"79",1653,1195,2848
"2412",1867,"80",1527,1100,2627
"2413",1867,"81",1333,911,2244
"2414",1867,"82",1147,788,1935
"2415",1867,"83",941,635,1576
"2416",1867,"84",844,501,1345
"2417",1867,"85",731,432,1163
"2418",1867,"86",612,352,964
"2419",1867,"87",479,297,776
"2420",1867,"88",416,234,650
"2421",1867,"89",350,204,554
"2422",1867,"90",261,150,411
"2423",1867,"91",195,116,311
"2424",1867,"92",159,91,250
"2425",1867,"93",130,59,189
"2426",1867,"94",97,44,141
"2427",1867,"95",57,32,89
"2428",1867,"96",40,20,60
"2429",1867,"97",21,12,33
"2430",1867,"98",12,8,20
"2431",1867,"99",8,5,13
"2432",1867,"100",5,5,10
"2433",1867,"101",1,1,2
"2434",1867,"102",0,0,0
"2435",1867,"103",0,0,0
"2436",1867,"104",0,0,0
"2437",1867,"105",0,0,0
"2438",1867,"106",0,0,0
"2439",1867,"107",0,0,0
"2440",1867,"108",0,0,0
"2441",1867,"109",0,0,0
"2442",1867,"110+",0,0,0
"2443",1868,"0",23149,24098,47247
"2444",1868,"1",23165,23926,47091
"2445",1868,"2",23150,23748,46898
"2446",1868,"3",22100,22929,45029
"2447",1868,"4",21998,22554,44552
"2448",1868,"5",20679,21365,42044
"2449",1868,"6",19207,19664,38871
"2450",1868,"7",20237,20994,41231
"2451",1868,"8",20657,21505,42162
"2452",1868,"9",19541,20037,39578
"2453",1868,"10",18842,19470,38312
"2454",1868,"11",17955,18803,36758
"2455",1868,"12",18534,18861,37395
"2456",1868,"13",18568,19169,37737
"2457",1868,"14",16955,17696,34651
"2458",1868,"15",16378,16799,33177
"2459",1868,"16",16358,17167,33525
"2460",1868,"17",16234,16327,32561
"2461",1868,"18",16467,16696,33163
"2462",1868,"19",15194,14880,30074
"2463",1868,"20",15323,15110,30433
"2464",1868,"21",15211,14489,29700
"2465",1868,"22",14758,13612,28370
"2466",1868,"23",13782,12677,26459
"2467",1868,"24",13666,12509,26175
"2468",1868,"25",13668,12489,26157
"2469",1868,"26",12808,11920,24728
"2470",1868,"27",11956,10741,22697
"2471",1868,"28",11197,10147,21344
"2472",1868,"29",11397,10417,21814
"2473",1868,"30",11676,10635,22311
"2474",1868,"31",11731,10592,22323
"2475",1868,"32",12681,11537,24218
"2476",1868,"33",11914,10839,22753
"2477",1868,"34",11421,10262,21683
"2478",1868,"35",10718,9792,20510
"2479",1868,"36",10823,10019,20842
"2480",1868,"37",11250,10357,21607
"2481",1868,"38",11280,10986,22266
"2482",1868,"39",10480,10041,20521
"2483",1868,"40",10409,9962,20371
"2484",1868,"41",10842,10564,21406
"2485",1868,"42",10285,9986,20271
"2486",1868,"43",9387,9060,18447
"2487",1868,"44",9599,9362,18961
"2488",1868,"45",8895,8692,17587
"2489",1868,"46",9128,8981,18109
"2490",1868,"47",9357,8561,17918
"2491",1868,"48",8885,8130,17015
"2492",1868,"49",8272,7730,16002
"2493",1868,"50",8531,7797,16328
"2494",1868,"51",9039,8116,17155
"2495",1868,"52",7106,6712,13818
"2496",1868,"53",5618,5228,10846
"2497",1868,"54",6006,5439,11445
"2498",1868,"55",6596,5946,12542
"2499",1868,"56",5903,5285,11188
"2500",1868,"57",5380,4960,10340
"2501",1868,"58",4378,3888,8266
"2502",1868,"59",5430,4735,10165
"2503",1868,"60",5550,4797,10347
"2504",1868,"61",5420,4940,10360
"2505",1868,"62",5232,4601,9833
"2506",1868,"63",4523,3997,8520
"2507",1868,"64",4696,4048,8744
"2508",1868,"65",4193,3585,7778
"2509",1868,"66",4605,3973,8578
"2510",1868,"67",4772,3909,8681
"2511",1868,"68",4586,3750,8336
"2512",1868,"69",4275,3463,7738
"2513",1868,"70",4056,3289,7345
"2514",1868,"71",3638,2915,6553
"2515",1868,"72",3246,2733,5979
"2516",1868,"73",3072,2617,5689
"2517",1868,"74",2856,2361,5217
"2518",1868,"75",2704,2181,4885
"2519",1868,"76",2335,1840,4175
"2520",1868,"77",2176,1625,3801
"2521",1868,"78",1911,1393,3304
"2522",1868,"79",1734,1260,2994
"2523",1868,"80",1516,1108,2624
"2524",1868,"81",1337,948,2285
"2525",1868,"82",1153,771,1924
"2526",1868,"83",977,661,1638
"2527",1868,"84",785,522,1307
"2528",1868,"85",705,402,1107
"2529",1868,"86",609,348,957
"2530",1868,"87",510,278,788
"2531",1868,"88",388,232,620
"2532",1868,"89",335,178,513
"2533",1868,"90",279,156,435
"2534",1868,"91",200,110,310
"2535",1868,"92",147,82,229
"2536",1868,"93",117,64,181
"2537",1868,"94",97,37,134
"2538",1868,"95",71,27,98
"2539",1868,"96",37,19,56
"2540",1868,"97",27,12,39
"2541",1868,"98",13,7,20
"2542",1868,"99",9,5,14
"2543",1868,"100",4,3,7
"2544",1868,"101",1,4,5
"2545",1868,"102",1,0,1
"2546",1868,"103",0,0,0
"2547",1868,"104",0,0,0
"2548",1868,"105",0,0,0
"2549",1868,"106",0,0,0
"2550",1868,"107",0,0,0
"2551",1868,"108",0,0,0
"2552",1868,"109",0,0,0
"2553",1868,"110+",0,0,0
"2554",1869,"0",23169,24195,47364
"2555",1869,"1",21567,22329,43896
"2556",1869,"2",22262,22935,45197
"2557",1869,"3",22534,23101,45635
"2558",1869,"4",21603,22422,44025
"2559",1869,"5",21623,22161,43784
"2560",1869,"6",20358,21044,41402
"2561",1869,"7",18917,19378,38295
"2562",1869,"8",19970,20735,40705
"2563",1869,"9",20401,21268,41669
"2564",1869,"10",19327,19819,39146
"2565",1869,"11",18650,19273,37923
"2566",1869,"12",17786,18614,36400
"2567",1869,"13",18369,18676,37045
"2568",1869,"14",18407,18984,37391
"2569",1869,"15",16782,17506,34288
"2570",1869,"16",16220,16608,32828
"2571",1869,"17",16206,16937,33143
"2572",1869,"18",16072,16049,32121
"2573",1869,"19",16314,16368,32682
"2574",1869,"20",14983,14496,29479
"2575",1869,"21",15124,14670,29794
"2576",1869,"22",15017,14084,29101
"2577",1869,"23",14563,13340,27903
"2578",1869,"24",13578,12417,25995
"2579",1869,"25",13465,12241,25706
"2580",1869,"26",13486,12201,25687
"2581",1869,"27",12625,11627,24252
"2582",1869,"28",11764,10471,22235
"2583",1869,"29",11002,9893,20895
"2584",1869,"30",11212,10185,21397
"2585",1869,"31",11494,10425,21919
"2586",1869,"32",11551,10387,21938
"2587",1869,"33",12504,11339,23843
"2588",1869,"34",11747,10639,22386
"2589",1869,"35",11252,10060,21312
"2590",1869,"36",10559,9584,20143
"2591",1869,"37",10659,9921,20580
"2592",1869,"38",11083,10168,21251
"2593",1869,"39",11126,10806,21932
"2594",1869,"40",10325,9873,20198
"2595",1869,"41",10255,9789,20044
"2596",1869,"42",10690,10390,21080
"2597",1869,"43",10132,9806,19938
"2598",1869,"44",9248,8877,18125
"2599",1869,"45",9461,9174,18635
"2600",1869,"46",8756,8516,17272
"2601",1869,"47",8990,8805,17795
"2602",1869,"48",9217,8399,17616
"2603",1869,"49",8758,7965,16723
"2604",1869,"50",8142,7565,15707
"2605",1869,"51",8401,7632,16033
"2606",1869,"52",8919,7962,16881
"2607",1869,"53",6985,6557,13542
"2608",1869,"54",5496,5073,10569
"2609",1869,"55",5882,5283,11165
"2610",1869,"56",6463,5801,12264
"2611",1869,"57",5767,5139,10906
"2612",1869,"58",5249,4813,10062
"2613",1869,"59",4245,3744,7989
"2614",1869,"60",5300,4590,9890
"2615",1869,"61",5416,4650,10066
"2616",1869,"62",5288,4797,10085
"2617",1869,"63",5092,4453,9545
"2618",1869,"64",4373,3845,8218
"2619",1869,"65",4534,3890,8424
"2620",1869,"66",4019,3417,7436
"2621",1869,"67",4419,3800,8219
"2622",1869,"68",4574,3725,8299
"2623",1869,"69",4379,3555,7934
"2624",1869,"70",4070,3259,7329
"2625",1869,"71",3845,3078,6923
"2626",1869,"72",3428,2713,6141
"2627",1869,"73",3035,2536,5571
"2628",1869,"74",2860,2428,5288
"2629",1869,"75",2645,2178,4823
"2630",1869,"76",2496,2003,4499
"2631",1869,"77",2130,1669,3799
"2632",1869,"78",1975,1461,3436
"2633",1869,"79",1716,1238,2954
"2634",1869,"80",1693,1167,2860
"2635",1869,"81",1335,981,2316
"2636",1869,"82",1166,822,1988
"2637",1869,"83",994,656,1650
"2638",1869,"84",832,557,1389
"2639",1869,"85",653,434,1087
"2640",1869,"86",590,329,919
"2641",1869,"87",507,285,792
"2642",1869,"88",421,223,644
"2643",1869,"89",312,184,496
"2644",1869,"90",270,136,406
"2645",1869,"91",225,121,346
"2646",1869,"92",154,79,233
"2647",1869,"93",108,57,165
"2648",1869,"94",84,44,128
"2649",1869,"95",72,22,94
"2650",1869,"96",52,16,68
"2651",1869,"97",24,13,37
"2652",1869,"98",19,8,27
"2653",1869,"99",8,5,13
"2654",1869,"100",7,4,11
"2655",1869,"101",4,2,6
"2656",1869,"102",1,4,5
"2657",1869,"103",1,0,1
"2658",1869,"104",0,0,0
"2659",1869,"105",0,0,0
"2660",1869,"106",0,0,0
"2661",1869,"107",0,0,0
"2662",1869,"108",0,0,0
"2663",1869,"109",0,0,0
"2664",1869,"110+",0,0,0
"2665",1870,"0",22454,23258,45712
"2666",1870,"1",21746,22543,44289
"2667",1870,"2",20764,21441,42205
"2668",1870,"3",21681,22296,43977
"2669",1870,"4",22063,22571,44634
"2670",1870,"5",21227,21997,43224
"2671",1870,"6",21303,21813,43116
"2672",1870,"7",20063,20727,40790
"2673",1870,"8",18629,19092,37721
"2674",1870,"9",19697,20464,40161
"2675",1870,"10",20159,21013,41172
"2676",1870,"11",19106,19588,38694
"2677",1870,"12",18453,19065,37518
"2678",1870,"13",17592,18409,36001
"2679",1870,"14",18179,18450,36629
"2680",1870,"15",18220,18751,36971
"2681",1870,"16",16598,17262,33860
"2682",1870,"17",16044,16333,32377
"2683",1870,"18",16016,16601,32617
"2684",1870,"19",15853,15649,31502
"2685",1870,"20",16011,15896,31907
"2686",1870,"21",14697,13917,28614
"2687",1870,"22",14827,14154,28981
"2688",1870,"23",14737,13747,28484
"2689",1870,"24",14290,12999,27289
"2690",1870,"25",13307,12062,25369
"2691",1870,"26",13205,11873,25078
"2692",1870,"27",13243,11838,25081
"2693",1870,"28",12379,11275,23654
"2694",1870,"29",11515,10139,21654
"2695",1870,"30",10773,9591,20364
"2696",1870,"31",11004,9893,20897
"2697",1870,"32",11284,10155,21439
"2698",1870,"33",11340,10128,21468
"2699",1870,"34",12306,11073,23379
"2700",1870,"35",11544,10386,21930
"2701",1870,"36",11061,9818,20879
"2702",1870,"37",10381,9341,19722
"2703",1870,"38",10479,9693,20172
"2704",1870,"39",10902,9941,20843
"2705",1870,"40",10945,10598,21543
"2706",1870,"41",10163,9679,19842
"2707",1870,"42",10097,9614,19711
"2708",1870,"43",10532,10232,20764
"2709",1870,"44",9974,9647,19621
"2710",1870,"45",9090,8716,17806
"2711",1870,"46",9302,9010,18312
"2712",1870,"47",8598,8351,16949
"2713",1870,"48",8847,8635,17482
"2714",1870,"49",9073,8224,17297
"2715",1870,"50",8612,7785,16397
"2716",1870,"51",7995,7383,15378
"2717",1870,"52",8270,7464,15734
"2718",1870,"53",8787,7794,16581
"2719",1870,"54",6851,6407,13258
"2720",1870,"55",5360,4921,10281
"2721",1870,"56",5742,5130,10872
"2722",1870,"57",6329,5657,11986
"2723",1870,"58",5629,4994,10623
"2724",1870,"59",5117,4675,9792
"2725",1870,"60",4112,3605,7717
"2726",1870,"61",5163,4447,9610
"2727",1870,"62",5274,4507,9781
"2728",1870,"63",5142,4661,9803
"2729",1870,"64",4938,4313,9251
"2730",1870,"65",4207,3696,7903
"2731",1870,"66",4366,3732,8098
"2732",1870,"67",3831,3237,7068
"2733",1870,"68",4226,3616,7842
"2734",1870,"69",4377,3540,7917
"2735",1870,"70",4175,3368,7543
"2736",1870,"71",3863,3068,6931
"2737",1870,"72",3635,2888,6523
"2738",1870,"73",3216,2525,5741
"2739",1870,"74",2823,2350,5173
"2740",1870,"75",2647,2241,4888
"2741",1870,"76",2432,1997,4429
"2742",1870,"77",2282,1825,4107
"2743",1870,"78",1916,1493,3409
"2744",1870,"79",1765,1287,3052
"2745",1870,"80",1718,1195,2913
"2746",1870,"81",1507,1012,2519
"2747",1870,"82",1163,841,2004
"2748",1870,"83",1011,699,1710
"2749",1870,"84",855,551,1406
"2750",1870,"85",712,469,1181
"2751",1870,"86",552,358,910
"2752",1870,"87",501,266,767
"2753",1870,"88",429,235,664
"2754",1870,"89",352,180,532
"2755",1870,"90",252,147,399
"2756",1870,"91",216,102,318
"2757",1870,"92",179,91,270
"2758",1870,"93",115,54,169
"2759",1870,"94",75,37,112
"2760",1870,"95",58,30,88
"2761",1870,"96",50,15,65
"2762",1870,"97",37,13,50
"2763",1870,"98",14,11,25
"2764",1870,"99",14,6,20
"2765",1870,"100",6,4,10
"2766",1870,"101",6,3,9
"2767",1870,"102",3,1,4
"2768",1870,"103",1,3,4
"2769",1870,"104",1,0,1
"2770",1870,"105",0,0,0
"2771",1870,"106",0,0,0
"2772",1870,"107",0,0,0
"2773",1870,"108",0,0,0
"2774",1870,"109",0,0,0
"2775",1870,"110+",0,0,0
"2776",1871,"0",22976,23763,46739
"2777",1871,"1",21223,21884,43107
"2778",1871,"2",21041,21760,42801
"2779",1871,"3",20254,20884,41138
"2780",1871,"4",21272,21827,43099
"2781",1871,"5",21745,22202,43947
"2782",1871,"6",20945,21680,42625
"2783",1871,"7",21058,21546,42604
"2784",1871,"8",19822,20479,40301
"2785",1871,"9",18415,18857,37272
"2786",1871,"10",19495,20243,39738
"2787",1871,"11",19990,20811,40801
"2788",1871,"12",18955,19410,38365
"2789",1871,"13",18305,18875,37180
"2790",1871,"14",17446,18218,35664
"2791",1871,"15",18018,18249,36267
"2792",1871,"16",18043,18524,36567
"2793",1871,"17",16399,16992,33391
"2794",1871,"18",15851,15990,31841
"2795",1871,"19",15799,16180,31979
"2796",1871,"20",15574,15185,30759
"2797",1871,"21",15736,15363,31099
"2798",1871,"22",14436,13474,27910
"2799",1871,"23",14573,13857,28430
"2800",1871,"24",14497,13477,27974
"2801",1871,"25",14066,12720,26786
"2802",1871,"26",13097,11787,24884
"2803",1871,"27",12990,11603,24593
"2804",1871,"28",13025,11576,24601
"2805",1871,"29",12176,11027,23203
"2806",1871,"30",11326,9910,21236
"2807",1871,"31",10583,9377,19960
"2808",1871,"32",10813,9681,20494
"2809",1871,"33",11106,9952,21058
"2810",1871,"34",11161,9922,21083
"2811",1871,"35",12127,10866,22993
"2812",1871,"36",11377,10177,21554
"2813",1871,"37",10907,9623,20530
"2814",1871,"38",10241,9158,19399
"2815",1871,"39",10335,9510,19845
"2816",1871,"40",10756,9772,20528
"2817",1871,"41",10797,10441,21238
"2818",1871,"42",10013,9535,19548
"2819",1871,"43",9947,9464,19411
"2820",1871,"44",10382,10079,20461
"2821",1871,"45",9822,9490,19312
"2822",1871,"46",8938,8572,17510
"2823",1871,"47",9149,8861,18010
"2824",1871,"48",8460,8199,16659
"2825",1871,"49",8708,8479,17187
"2826",1871,"50",8934,8067,17001
"2827",1871,"51",8473,7627,16100
"2828",1871,"52",7856,7223,15079
"2829",1871,"53",8144,7303,15447
"2830",1871,"54",8658,7635,16293
"2831",1871,"55",6720,6262,12982
"2832",1871,"56",5226,4776,10002
"2833",1871,"57",5606,4993,10599
"2834",1871,"58",6198,5519,11717
"2835",1871,"59",5495,4863,10358
"2836",1871,"60",4989,4544,9533
"2837",1871,"61",3979,3473,7452
"2838",1871,"62",5027,4314,9341
"2839",1871,"63",5135,4371,9506
"2840",1871,"64",4995,4520,9515
"2841",1871,"65",4781,4163,8944
"2842",1871,"66",4042,3536,7578
"2843",1871,"67",4184,3551,7735
"2844",1871,"68",3647,3052,6699
"2845",1871,"69",4039,3427,7466
"2846",1871,"70",4185,3350,7535
"2847",1871,"71",3980,3176,7156
"2848",1871,"72",3664,2878,6542
"2849",1871,"73",3431,2697,6128
"2850",1871,"74",3010,2336,5346
"2851",1871,"75",2614,2158,4772
"2852",1871,"76",2433,2053,4486
"2853",1871,"77",2214,1810,4024
"2854",1871,"78",2063,1630,3693
"2855",1871,"79",1699,1312,3011
"2856",1871,"80",1873,1388,3261
"2857",1871,"81",1522,1035,2557
"2858",1871,"82",1328,868,2196
"2859",1871,"83",1003,714,1717
"2860",1871,"84",868,590,1458
"2861",1871,"85",733,460,1193
"2862",1871,"86",612,381,993
"2863",1871,"87",466,294,760
"2864",1871,"88",426,216,642
"2865",1871,"89",364,191,555
"2866",1871,"90",296,143,439
"2867",1871,"91",202,114,316
"2868",1871,"92",173,74,247
"2869",1871,"93",142,67,209
"2870",1871,"94",84,33,117
"2871",1871,"95",48,20,68
"2872",1871,"96",35,18,53
"2873",1871,"97",33,8,41
"2874",1871,"98",26,9,35
"2875",1871,"99",7,8,15
"2876",1871,"100",9,4,13
"2877",1871,"101",3,2,5
"2878",1871,"102",4,2,6
"2879",1871,"103",2,1,3
"2880",1871,"104",0,1,1
"2881",1871,"105",1,0,1
"2882",1871,"106",0,0,0
"2883",1871,"107",0,0,0
"2884",1871,"108",0,0,0
"2885",1871,"109",0,0,0
"2886",1871,"110+",0,0,0
"2887",1872,"0",23309,24217,47526
"2888",1872,"1",21736,22321,44057
"2889",1872,"2",20534,21064,41598
"2890",1872,"3",20514,21159,41673
"2891",1872,"4",19792,20383,40175
"2892",1872,"5",20942,21433,42375
"2893",1872,"6",21480,21874,43354
"2894",1872,"7",20704,21415,42119
"2895",1872,"8",20822,21297,42119
"2896",1872,"9",19619,20260,39879
"2897",1872,"10",18234,18695,36929
"2898",1872,"11",19332,20070,39402
"2899",1872,"12",19851,20651,40502
"2900",1872,"13",18827,19251,38078
"2901",1872,"14",18177,18707,36884
"2902",1872,"15",17308,18049,35357
"2903",1872,"16",17862,18066,35928
"2904",1872,"17",17874,18243,36117
"2905",1872,"18",16162,16622,32784
"2906",1872,"19",15649,15563,31212
"2907",1872,"20",15597,15696,31293
"2908",1872,"21",15364,14663,30027
"2909",1872,"22",15459,14989,30448
"2910",1872,"23",14229,13245,27474
"2911",1872,"24",14325,13600,27925
"2912",1872,"25",14252,13201,27453
"2913",1872,"26",13851,12453,26304
"2914",1872,"27",12884,11534,24418
"2915",1872,"28",12768,11366,24134
"2916",1872,"29",12828,11320,24148
"2917",1872,"30",11992,10796,22788
"2918",1872,"31",11154,9708,20862
"2919",1872,"32",10468,9218,19686
"2920",1872,"33",10683,9486,20169
"2921",1872,"34",10975,9786,20761
"2922",1872,"35",11012,9740,20752
"2923",1872,"36",11950,10649,22599
"2924",1872,"37",11251,10026,21277
"2925",1872,"38",10762,9482,20244
"2926",1872,"39",10088,9020,19108
"2927",1872,"40",10183,9360,19543
"2928",1872,"41",10606,9608,20214
"2929",1872,"42",10664,10316,20980
"2930",1872,"43",9884,9414,19298
"2931",1872,"44",9833,9317,19150
"2932",1872,"45",10237,9932,20169
"2933",1872,"46",9668,9351,19019
"2934",1872,"47",8831,8440,17271
"2935",1872,"48",9011,8709,17720
"2936",1872,"49",8329,8022,16351
"2937",1872,"50",8571,8310,16881
"2938",1872,"51",8792,7904,16696
"2939",1872,"52",8349,7485,15834
"2940",1872,"53",7740,7079,14819
"2941",1872,"54",8001,7191,15192
"2942",1872,"55",8495,7470,15965
"2943",1872,"56",6594,6102,12696
"2944",1872,"57",5114,4658,9772
"2945",1872,"58",5494,4880,10374
"2946",1872,"59",6066,5361,11427
"2947",1872,"60",5348,4721,10069
"2948",1872,"61",4826,4417,9243
"2949",1872,"62",3866,3345,7211
"2950",1872,"63",4894,4201,9095
"2951",1872,"64",4996,4228,9224
"2952",1872,"65",4833,4369,9202
"2953",1872,"66",4631,3978,8609
"2954",1872,"67",3906,3380,7286
"2955",1872,"68",4016,3398,7414
"2956",1872,"69",3495,2891,6386
"2957",1872,"70",3840,3243,7083
"2958",1872,"71",3950,3149,7099
"2959",1872,"72",3782,2985,6767
"2960",1872,"73",3491,2717,6208
"2961",1872,"74",3224,2501,5725
"2962",1872,"75",2817,2147,4964
"2963",1872,"76",2394,1965,4359
"2964",1872,"77",2232,1858,4090
"2965",1872,"78",1968,1628,3596
"2966",1872,"79",1831,1442,3273
"2967",1872,"80",1769,1320,3089
"2968",1872,"81",1686,1243,2929
"2969",1872,"82",1349,907,2256
"2970",1872,"83",1156,739,1895
"2971",1872,"84",849,593,1442
"2972",1872,"85",721,503,1224
"2973",1872,"86",604,372,976
"2974",1872,"87",497,310,807
"2975",1872,"88",366,228,594
"2976",1872,"89",345,173,518
"2977",1872,"90",289,142,431
"2978",1872,"91",236,120,356
"2979",1872,"92",155,82,237
"2980",1872,"93",129,55,184
"2981",1872,"94",111,46,157
"2982",1872,"95",54,24,78
"2983",1872,"96",26,13,39
"2984",1872,"97",18,12,30
"2985",1872,"98",20,7,27
"2986",1872,"99",18,4,22
"2987",1872,"100",3,4,7
"2988",1872,"101",4,1,5
"2989",1872,"102",2,1,3
"2990",1872,"103",1,1,2
"2991",1872,"104",1,1,2
"2992",1872,"105",0,0,0
"2993",1872,"106",0,0,0
"2994",1872,"107",0,0,0
"2995",1872,"108",0,0,0
"2996",1872,"109",0,0,0
"2997",1872,"110+",0,0,0
"2998",1873,"0",23845,24525,48370
"2999",1873,"1",21893,22743,44636
"3000",1873,"2",21029,21642,42671
"3001",1873,"3",20024,20490,40514
"3002",1873,"4",20015,20620,40635
"3003",1873,"5",19558,20073,39631
"3004",1873,"6",20619,21071,41690
"3005",1873,"7",21057,21466,42523
"3006",1873,"8",20459,21171,41630
"3007",1873,"9",20548,21127,41675
"3008",1873,"10",19449,20084,39533
"3009",1873,"11",18025,18446,36471
"3010",1873,"12",19131,19854,38985
"3011",1873,"13",19634,20390,40024
"3012",1873,"14",18710,19099,37809
"3013",1873,"15",18088,18510,36598
"3014",1873,"16",17265,17796,35061
"3015",1873,"17",17786,17745,35531
"3016",1873,"18",17780,17778,35558
"3017",1873,"19",16231,16195,32426
"3018",1873,"20",15576,14971,30547
"3019",1873,"21",15543,15025,30568
"3020",1873,"22",15204,14150,29354
"3021",1873,"23",15219,14472,29691
"3022",1873,"24",13974,12791,26765
"3023",1873,"25",13941,13014,26955
"3024",1873,"26",13819,12659,26478
"3025",1873,"27",13473,12029,25502
"3026",1873,"28",12516,11197,23713
"3027",1873,"29",12421,11044,23465
"3028",1873,"30",12408,11027,23435
"3029",1873,"31",11762,10620,22382
"3030",1873,"32",10995,9627,20622
"3031",1873,"33",10285,9076,19361
"3032",1873,"34",10459,9312,19771
"3033",1873,"35",10701,9585,20286
"3034",1873,"36",10725,9566,20291
"3035",1873,"37",11634,10474,22108
"3036",1873,"38",11009,9887,20896
"3037",1873,"39",10507,9394,19901
"3038",1873,"40",9862,8916,18778
"3039",1873,"41",10035,9286,19321
"3040",1873,"42",10420,9523,19943
"3041",1873,"43",10478,10101,20579
"3042",1873,"44",9786,9232,19018
"3043",1873,"45",9723,9117,18840
"3044",1873,"46",10152,9759,19911
"3045",1873,"47",9741,9295,19036
"3046",1873,"48",8891,8423,17314
"3047",1873,"49",8977,8639,17616
"3048",1873,"50",8348,8010,16358
"3049",1873,"51",8602,8306,16908
"3050",1873,"52",8708,7915,16623
"3051",1873,"53",8158,7380,15538
"3052",1873,"54",7523,6927,14450
"3053",1873,"55",7681,6932,14613
"3054",1873,"56",8153,7241,15394
"3055",1873,"57",6552,6042,12594
"3056",1873,"58",5125,4668,9793
"3057",1873,"59",5384,4794,10178
"3058",1873,"60",5930,5257,11187
"3059",1873,"61",5296,4670,9966
"3060",1873,"62",4816,4354,9170
"3061",1873,"63",3855,3361,7216
"3062",1873,"64",4676,4015,8691
"3063",1873,"65",4764,4028,8792
"3064",1873,"66",4593,4142,8735
"3065",1873,"67",4474,3808,8282
"3066",1873,"68",3835,3283,7118
"3067",1873,"69",3878,3246,7124
"3068",1873,"70",3444,2804,6248
"3069",1873,"71",3656,3100,6756
"3070",1873,"72",3762,2996,6758
"3071",1873,"73",3597,2842,6439
"3072",1873,"74",3240,2453,5693
"3073",1873,"75",2956,2261,5217
"3074",1873,"76",2575,1995,4570
"3075",1873,"77",2270,1857,4127
"3076",1873,"78",2089,1699,3788
"3077",1873,"79",1813,1491,3304
"3078",1873,"80",1829,1385,3214
"3079",1873,"81",1601,1179,2780
"3080",1873,"82",1544,1103,2647
"3081",1873,"83",1185,773,1958
"3082",1873,"84",1009,621,1630
"3083",1873,"85",720,485,1205
"3084",1873,"86",606,414,1020
"3085",1873,"87",493,309,802
"3086",1873,"88",388,231,619
"3087",1873,"89",299,192,491
"3088",1873,"90",264,113,377
"3089",1873,"91",247,116,363
"3090",1873,"92",190,98,288
"3091",1873,"93",120,59,179
"3092",1873,"94",101,39,140
"3093",1873,"95",77,34,111
"3094",1873,"96",36,20,56
"3095",1873,"97",19,8,27
"3096",1873,"98",14,5,19
"3097",1873,"99",14,4,18
"3098",1873,"100",9,2,11
"3099",1873,"101",2,3,5
"3100",1873,"102",3,1,4
"3101",1873,"103",1,1,2
"3102",1873,"104",0,1,1
"3103",1873,"105",1,0,1
"3104",1873,"106",0,0,0
"3105",1873,"107",0,0,0
"3106",1873,"108",0,0,0
"3107",1873,"109",0,0,0
"3108",1873,"110+",0,0,0
"3109",1874,"0",24185,24688,48873
"3110",1874,"1",22459,22964,45423
"3111",1874,"2",21175,22006,43181
"3112",1874,"3",20511,21135,41646
"3113",1874,"4",19720,20206,39926
"3114",1874,"5",19662,20248,39910
"3115",1874,"6",19404,19875,39279
"3116",1874,"7",20385,20822,41207
"3117",1874,"8",20708,21131,41839
"3118",1874,"9",20247,21008,41255
"3119",1874,"10",20332,21018,41350
"3120",1874,"11",19264,19879,39143
"3121",1874,"12",17972,18393,36365
"3122",1874,"13",18936,19628,38564
"3123",1874,"14",19427,20151,39578
"3124",1874,"15",18607,18919,37526
"3125",1874,"16",17996,18251,36247
"3126",1874,"17",17237,17497,34734
"3127",1874,"18",17685,17298,34983
"3128",1874,"19",17753,17350,35103
"3129",1874,"20",16205,15730,31935
"3130",1874,"21",15616,14480,30096
"3131",1874,"22",15490,14497,29987
"3132",1874,"23",15118,13772,28890
"3133",1874,"24",15003,13931,28934
"3134",1874,"25",13778,12368,26146
"3135",1874,"26",13594,12496,26090
"3136",1874,"27",13466,12179,25645
"3137",1874,"28",13093,11647,24740
"3138",1874,"29",12263,10951,23214
"3139",1874,"30",12035,10740,22775
"3140",1874,"31",12122,10844,22966
"3141",1874,"32",11524,10473,21997
"3142",1874,"33",10866,9583,20449
"3143",1874,"34",10138,9007,19145
"3144",1874,"35",10242,9191,19433
"3145",1874,"36",10442,9412,19854
"3146",1874,"37",10464,9457,19921
"3147",1874,"38",11335,10310,21645
"3148",1874,"39",10783,9808,20591
"3149",1874,"40",10230,9303,19533
"3150",1874,"41",9737,8922,18659
"3151",1874,"42",9887,9226,19113
"3152",1874,"43",10263,9464,19727
"3153",1874,"44",10314,9862,20176
"3154",1874,"45",9699,9062,18761
"3155",1874,"46",9608,8943,18551
"3156",1874,"47",10090,9631,19721
"3157",1874,"48",9769,9208,18977
"3158",1874,"49",8959,8413,17372
"3159",1874,"50",8896,8535,17431
"3160",1874,"51",8423,8048,16471
"3161",1874,"52",8607,8292,16899
"3162",1874,"53",8610,7945,16555
"3163",1874,"54",7982,7261,15243
"3164",1874,"55",7327,6771,14098
"3165",1874,"56",7374,6688,14062
"3166",1874,"57",7842,7016,14858
"3167",1874,"58",6517,5956,12473
"3168",1874,"59",5145,4687,9832
"3169",1874,"60",5229,4672,9901
"3170",1874,"61",5804,5154,10958
"3171",1874,"62",5259,4616,9875
"3172",1874,"63",4801,4279,9080
"3173",1874,"64",3854,3369,7223
"3174",1874,"65",4456,3789,8245
"3175",1874,"66",4542,3829,8371
"3176",1874,"67",4381,3922,8303
"3177",1874,"68",4293,3648,7941
"3178",1874,"69",3759,3192,6951
"3179",1874,"70",3732,3087,6819
"3180",1874,"71",3398,2737,6135
"3181",1874,"72",3504,2975,6479
"3182",1874,"73",3579,2850,6429
"3183",1874,"74",3365,2665,6030
"3184",1874,"75",2961,2216,5177
"3185",1874,"76",2707,2069,4776
"3186",1874,"77",2359,1845,4204
"3187",1874,"78",2135,1688,3823
"3188",1874,"79",1953,1568,3521
"3189",1874,"80",1837,1427,3264
"3190",1874,"81",1652,1274,2926
"3191",1874,"82",1404,1051,2455
"3192",1874,"83",1377,952,2329
"3193",1874,"84",999,642,1641
"3194",1874,"85",854,525,1379
"3195",1874,"86",597,393,990
"3196",1874,"87",517,340,857
"3197",1874,"88",388,254,642
"3198",1874,"89",312,180,492
"3199",1874,"90",214,148,362
"3200",1874,"91",222,94,316
"3201",1874,"92",201,87,288
"3202",1874,"93",144,74,218
"3203",1874,"94",91,41,132
"3204",1874,"95",75,28,103
"3205",1874,"96",53,22,75
"3206",1874,"97",19,14,33
"3207",1874,"98",12,5,17
"3208",1874,"99",9,5,14
"3209",1874,"100",7,2,9
"3210",1874,"101",4,2,6
"3211",1874,"102",2,1,3
"3212",1874,"103",3,0,3
"3213",1874,"104",0,1,1
"3214",1874,"105",0,1,1
"3215",1874,"106",0,0,0
"3216",1874,"107",0,0,0
"3217",1874,"108",0,0,0
"3218",1874,"109",0,0,0
"3219",1874,"110+",0,0,0
"3220",1875,"0",24922,25971,50893
"3221",1875,"1",22680,22938,45618
"3222",1875,"2",21745,22258,44003
"3223",1875,"3",20702,21585,42287
"3224",1875,"4",20243,20801,41044
"3225",1875,"5",19573,20022,39595
"3226",1875,"6",19369,19992,39361
"3227",1875,"7",19284,19741,39025
"3228",1875,"8",20194,20625,40819
"3229",1875,"9",20418,20875,41293
"3230",1875,"10",20077,20851,40928
"3231",1875,"11",20101,20890,40991
"3232",1875,"12",19192,19797,38989
"3233",1875,"13",17914,18353,36267
"3234",1875,"14",18749,19439,38188
"3235",1875,"15",19208,19917,39125
"3236",1875,"16",18465,18741,37206
"3237",1875,"17",17913,18052,35965
"3238",1875,"18",17216,17250,34466
"3239",1875,"19",17682,17009,34691
"3240",1875,"20",17754,16986,34740
"3241",1875,"21",16344,15454,31798
"3242",1875,"22",15668,14180,29848
"3243",1875,"23",15533,14172,29705
"3244",1875,"24",15104,13470,28574
"3245",1875,"25",14899,13516,28415
"3246",1875,"26",13642,12047,25689
"3247",1875,"27",13352,12077,25429
"3248",1875,"28",13134,11796,24930
"3249",1875,"29",12836,11369,24205
"3250",1875,"30",11997,10762,22759
"3251",1875,"31",11793,10581,22374
"3252",1875,"32",11873,10698,22571
"3253",1875,"33",11293,10365,21658
"3254",1875,"34",10780,9583,20363
"3255",1875,"35",10006,8959,18965
"3256",1875,"36",10050,9089,19139
"3257",1875,"37",10231,9276,19507
"3258",1875,"38",10241,9372,19613
"3259",1875,"39",11077,10192,21269
"3260",1875,"40",10517,9730,20247
"3261",1875,"41",10026,9278,19304
"3262",1875,"42",9613,8929,18542
"3263",1875,"43",9770,9171,18941
"3264",1875,"44",10135,9417,19552
"3265",1875,"45",10156,9647,19803
"3266",1875,"46",9607,8937,18544
"3267",1875,"47",9497,8801,18298
"3268",1875,"48",10021,9476,19497
"3269",1875,"49",9845,9149,18994
"3270",1875,"50",8971,8363,17334
"3271",1875,"51",8893,8483,17376
"3272",1875,"52",8491,8124,16615
"3273",1875,"53",8638,8251,16889
"3274",1875,"54",8514,7957,16471
"3275",1875,"55",7794,7168,14962
"3276",1875,"56",7122,6615,13737
"3277",1875,"57",7073,6447,13520
"3278",1875,"58",7531,6784,14315
"3279",1875,"59",6466,5880,12346
"3280",1875,"60",5120,4628,9748
"3281",1875,"61",5129,4594,9723
"3282",1875,"62",5699,5060,10759
"3283",1875,"63",5222,4574,9796
"3284",1875,"64",4787,4199,8986
"3285",1875,"65",3826,3376,7202
"3286",1875,"66",4224,3567,7791
"3287",1875,"67",4327,3642,7969
"3288",1875,"68",4184,3715,7899
"3289",1875,"69",4143,3483,7626
"3290",1875,"70",3577,3040,6617
"3291",1875,"71",3620,2939,6559
"3292",1875,"72",3373,2661,6034
"3293",1875,"73",3317,2835,6152
"3294",1875,"74",3370,2662,6032
"3295",1875,"75",3113,2495,5608
"3296",1875,"76",2744,1986,4730
"3297",1875,"77",2459,1861,4320
"3298",1875,"78",2158,1671,3829
"3299",1875,"79",2036,1580,3616
"3300",1875,"80",1768,1377,3145
"3301",1875,"81",1674,1275,2949
"3302",1875,"82",1436,1114,2550
"3303",1875,"83",1227,904,2131
"3304",1875,"84",1182,793,1975
"3305",1875,"85",833,538,1371
"3306",1875,"86",698,423,1121
"3307",1875,"87",489,320,809
"3308",1875,"88",404,273,677
"3309",1875,"89",325,195,520
"3310",1875,"90",224,129,353
"3311",1875,"91",175,112,287
"3312",1875,"92",175,70,245
"3313",1875,"93",161,63,224
"3314",1875,"94",116,62,178
"3315",1875,"95",62,30,92
"3316",1875,"96",51,20,71
"3317",1875,"97",40,15,55
"3318",1875,"98",15,8,23
"3319",1875,"99",5,1,6
"3320",1875,"100",4,2,6
"3321",1875,"101",5,2,7
"3322",1875,"102",3,1,4
"3323",1875,"103",2,1,3
"3324",1875,"104",1,0,1
"3325",1875,"105",0,0,0
"3326",1875,"106",0,0,0
"3327",1875,"107",0,0,0
"3328",1875,"108",0,0,0
"3329",1875,"109",0,0,0
"3330",1875,"110+",0,0,0
"3331",1876,"0",25559,26840,52399
"3332",1876,"1",23544,24326,47870
"3333",1876,"2",22041,22235,44276
"3334",1876,"3",21397,21931,43328
"3335",1876,"4",20428,21305,41733
"3336",1876,"5",20105,20602,40707
"3337",1876,"6",19473,19949,39422
"3338",1876,"7",19144,19749,38893
"3339",1876,"8",19195,19614,38809
"3340",1876,"9",20039,20457,40496
"3341",1876,"10",20169,20621,40790
"3342",1876,"11",19901,20698,40599
"3343",1876,"12",19947,20859,40806
"3344",1876,"13",19144,19728,38872
"3345",1876,"14",17865,18337,36202
"3346",1876,"15",18574,19232,37806
"3347",1876,"16",18977,19655,38632
"3348",1876,"17",18337,18532,36869
"3349",1876,"18",17810,17833,35643
"3350",1876,"19",17214,16978,34192
"3351",1876,"20",17629,16665,34294
"3352",1876,"21",17777,16671,34448
"3353",1876,"22",16464,15189,31653
"3354",1876,"23",15749,13940,29689
"3355",1876,"24",15587,13853,29440
"3356",1876,"25",15096,13201,28297
"3357",1876,"26",14812,13131,27943
"3358",1876,"27",13560,11743,25303
"3359",1876,"28",13125,11664,24789
"3360",1876,"29",12833,11423,24256
"3361",1876,"30",12531,11104,23635
"3362",1876,"31",11787,10622,22409
"3363",1876,"32",11555,10416,21971
"3364",1876,"33",11636,10574,22210
"3365",1876,"34",11103,10276,21379
"3366",1876,"35",10688,9593,20281
"3367",1876,"36",9882,8918,18800
"3368",1876,"37",9874,8990,18864
"3369",1876,"38",10017,9148,19165
"3370",1876,"39",10023,9291,19314
"3371",1876,"40",10783,10035,20818
"3372",1876,"41",10315,9682,19997
"3373",1876,"42",9816,9225,19041
"3374",1876,"43",9474,8924,18398
"3375",1876,"44",9650,9106,18756
"3376",1876,"45",9997,9345,19342
"3377",1876,"46",10010,9431,19441
"3378",1876,"47",9523,8812,18335
"3379",1876,"48",9373,8626,17999
"3380",1876,"49",9950,9344,19294
"3381",1876,"50",9858,9003,18861
"3382",1876,"51",9056,8370,17426
"3383",1876,"52",8854,8401,17255
"3384",1876,"53",8568,8149,16717
"3385",1876,"54",8665,8237,16902
"3386",1876,"55",8430,7938,16368
"3387",1876,"56",7591,7049,14640
"3388",1876,"57",6881,6445,13326
"3389",1876,"58",6776,6212,12988
"3390",1876,"59",7217,6551,13768
"3391",1876,"60",6361,5739,12100
"3392",1876,"61",5140,4616,9756
"3393",1876,"62",5005,4485,9490
"3394",1876,"63",5582,4940,10522
"3395",1876,"64",5150,4499,9649
"3396",1876,"65",4729,4109,8838
"3397",1876,"66",3815,3361,7176
"3398",1876,"67",3979,3351,7330
"3399",1876,"68",4073,3436,7509
"3400",1876,"69",3971,3462,7433
"3401",1876,"70",3862,3238,7100
"3402",1876,"71",3508,2915,6423
"3403",1876,"72",3451,2764,6215
"3404",1876,"73",3283,2565,5848
"3405",1876,"74",3111,2656,5767
"3406",1876,"75",3123,2494,5617
"3407",1876,"76",2849,2339,5188
"3408",1876,"77",2473,1751,4224
"3409",1876,"78",2163,1645,3808
"3410",1876,"79",1970,1530,3500
"3411",1876,"80",1832,1414,3246
"3412",1876,"81",1580,1219,2799
"3413",1876,"82",1492,1085,2577
"3414",1876,"83",1257,956,2213
"3415",1876,"84",1041,751,1792
"3416",1876,"85",993,658,1651
"3417",1876,"86",681,438,1119
"3418",1876,"87",561,334,895
"3419",1876,"88",380,234,614
"3420",1876,"89",329,200,529
"3421",1876,"90",245,140,385
"3422",1876,"91",180,93,273
"3423",1876,"92",130,84,214
"3424",1876,"93",125,51,176
"3425",1876,"94",117,45,162
"3426",1876,"95",89,38,127
"3427",1876,"96",45,16,61
"3428",1876,"97",34,15,49
"3429",1876,"98",24,11,35
"3430",1876,"99",12,4,16
"3431",1876,"100",2,0,2
"3432",1876,"101",2,1,3
"3433",1876,"102",4,2,6
"3434",1876,"103",2,1,3
"3435",1876,"104",1,0,1
"3436",1876,"105",0,0,0
"3437",1876,"106",0,0,0
"3438",1876,"107",0,0,0
"3439",1876,"108",0,0,0
"3440",1876,"109",0,0,0
"3441",1876,"110+",0,0,0
"3442",1877,"0",26376,27073,53449
"3443",1877,"1",24016,25110,49126
"3444",1877,"2",22772,23455,46227
"3445",1877,"3",21563,21670,43233
"3446",1877,"4",20989,21479,42468
"3447",1877,"5",20164,20977,41141
"3448",1877,"6",19902,20319,40221
"3449",1877,"7",19337,19766,39103
"3450",1877,"8",19053,19592,38645
"3451",1877,"9",19115,19465,38580
"3452",1877,"10",19944,20314,40258
"3453",1877,"11",20042,20463,40505
"3454",1877,"12",19843,20532,40375
"3455",1877,"13",19868,20713,40581
"3456",1877,"14",19034,19602,38636
"3457",1877,"15",17772,18232,36004
"3458",1877,"16",18455,19050,37505
"3459",1877,"17",18822,19378,38200
"3460",1877,"18",18151,18204,36355
"3461",1877,"19",17636,17467,35103
"3462",1877,"20",17032,16599,33631
"3463",1877,"21",17450,16298,33748
"3464",1877,"22",17557,16347,33904
"3465",1877,"23",16260,14934,31194
"3466",1877,"24",15556,13750,29306
"3467",1877,"25",15390,13662,29052
"3468",1877,"26",14896,13020,27916
"3469",1877,"27",14627,12948,27575
"3470",1877,"28",13370,11604,24974
"3471",1877,"29",12995,11581,24576
"3472",1877,"30",12682,11317,23999
"3473",1877,"31",12401,11033,23434
"3474",1877,"32",11691,10549,22240
"3475",1877,"33",11462,10322,21784
"3476",1877,"34",11532,10489,22021
"3477",1877,"35",11005,10205,21210
"3478",1877,"36",10575,9507,20082
"3479",1877,"37",9778,8822,18600
"3480",1877,"38",9764,8885,18649
"3481",1877,"39",9916,9049,18965
"3482",1877,"40",9907,9156,19063
"3483",1877,"41",10676,9942,20618
"3484",1877,"42",10206,9574,19780
"3485",1877,"43",9703,9135,18838
"3486",1877,"44",9348,8816,18164
"3487",1877,"45",9527,8965,18492
"3488",1877,"46",9893,9220,19113
"3489",1877,"47",9907,9290,19197
"3490",1877,"48",9408,8672,18080
"3491",1877,"49",9243,8506,17749
"3492",1877,"50",9793,9159,18952
"3493",1877,"51",9729,8894,18623
"3494",1877,"52",8949,8229,17178
"3495",1877,"53",8718,8261,16979
"3496",1877,"54",8455,7997,16452
"3497",1877,"55",8513,8073,16586
"3498",1877,"56",8280,7752,16032
"3499",1877,"57",7466,6904,14370
"3500",1877,"58",6769,6304,13073
"3501",1877,"59",6666,6072,12738
"3502",1877,"60",7012,6356,13368
"3503",1877,"61",6215,5605,11820
"3504",1877,"62",5029,4500,9529
"3505",1877,"63",4894,4362,9256
"3506",1877,"64",5434,4767,10201
"3507",1877,"65",4991,4340,9331
"3508",1877,"66",4562,3961,8523
"3509",1877,"67",3681,3226,6907
"3510",1877,"68",3847,3198,7045
"3511",1877,"69",3918,3285,7203
"3512",1877,"70",3763,3250,7013
"3513",1877,"71",3683,3092,6775
"3514",1877,"72",3332,2745,6077
"3515",1877,"73",3276,2596,5872
"3516",1877,"74",3089,2417,5506
"3517",1877,"75",2888,2439,5327
"3518",1877,"76",2899,2284,5183
"3519",1877,"77",2604,2123,4727
"3520",1877,"78",2263,1562,3825
"3521",1877,"79",2000,1482,3482
"3522",1877,"80",1872,1372,3244
"3523",1877,"81",1668,1274,2942
"3524",1877,"82",1399,1073,2472
"3525",1877,"83",1321,945,2266
"3526",1877,"84",1034,800,1834
"3527",1877,"85",873,614,1487
"3528",1877,"86",845,533,1378
"3529",1877,"87",569,355,924
"3530",1877,"88",457,254,711
"3531",1877,"89",323,194,517
"3532",1877,"90",243,144,387
"3533",1877,"91",201,114,315
"3534",1877,"92",134,67,201
"3535",1877,"93",106,62,168
"3536",1877,"94",97,36,133
"3537",1877,"95",84,27,111
"3538",1877,"96",62,21,83
"3539",1877,"97",31,13,44
"3540",1877,"98",21,8,29
"3541",1877,"99",13,6,19
"3542",1877,"100",7,2,9
"3543",1877,"101",1,0,1
"3544",1877,"102",2,1,3
"3545",1877,"103",1,2,3
"3546",1877,"104",0,1,1
"3547",1877,"105",1,0,1
"3548",1877,"106",0,0,0
"3549",1877,"107",0,0,0
"3550",1877,"108",0,0,0
"3551",1877,"109",0,0,0
"3552",1877,"110+",0,0,0
"3553",1878,"0",26571,28028,54599
"3554",1878,"1",24887,25360,50247
"3555",1878,"2",23342,24338,47680
"3556",1878,"3",22373,23028,45401
"3557",1878,"4",21267,21347,42614
"3558",1878,"5",20802,21230,42032
"3559",1878,"6",20026,20767,40793
"3560",1878,"7",19807,20161,39968
"3561",1878,"8",19242,19645,38887
"3562",1878,"9",19017,19509,38526
"3563",1878,"10",19101,19383,38484
"3564",1878,"11",19900,20209,40109
"3565",1878,"12",19976,20342,40318
"3566",1878,"13",19782,20401,40183
"3567",1878,"14",19789,20589,40378
"3568",1878,"15",18935,19504,38439
"3569",1878,"16",17697,18122,35819
"3570",1878,"17",18366,18855,37221
"3571",1878,"18",18684,19096,37780
"3572",1878,"19",18017,17885,35902
"3573",1878,"20",17443,17145,34588
"3574",1878,"21",16887,16280,33167
"3575",1878,"22",17295,16022,33317
"3576",1878,"23",17384,16133,33517
"3577",1878,"24",16083,14764,30847
"3578",1878,"25",15395,13611,29006
"3579",1878,"26",15199,13519,28718
"3580",1878,"27",14738,12893,27631
"3581",1878,"28",14443,12832,27275
"3582",1878,"29",13228,11522,24750
"3583",1878,"30",12854,11491,24345
"3584",1878,"31",12581,11255,23836
"3585",1878,"32",12297,10984,23281
"3586",1878,"33",11603,10473,22076
"3587",1878,"34",11373,10256,21629
"3588",1878,"35",11454,10428,21882
"3589",1878,"36",10902,10118,21020
"3590",1878,"37",10497,9426,19923
"3591",1878,"38",9675,8743,18418
"3592",1878,"39",9691,8808,18499
"3593",1878,"40",9804,8946,18750
"3594",1878,"41",9833,9091,18924
"3595",1878,"42",10572,9818,20390
"3596",1878,"43",10126,9489,19615
"3597",1878,"44",9599,9044,18643
"3598",1878,"45",9254,8711,17965
"3599",1878,"46",9413,8875,18288
"3600",1878,"47",9806,9119,18925
"3601",1878,"48",9797,9167,18964
"3602",1878,"49",9313,8565,17878
"3603",1878,"50",9109,8357,17466
"3604",1878,"51",9673,9025,18698
"3605",1878,"52",9605,8757,18362
"3606",1878,"53",8821,8128,16949
"3607",1878,"54",8609,8152,16761
"3608",1878,"55",8326,7844,16170
"3609",1878,"56",8369,7922,16291
"3610",1878,"57",8164,7619,15783
"3611",1878,"58",7341,6766,14107
"3612",1878,"59",6678,6182,12860
"3613",1878,"60",6491,5910,12401
"3614",1878,"61",6888,6243,13131
"3615",1878,"62",6112,5468,11580
"3616",1878,"63",4924,4392,9316
"3617",1878,"64",4785,4229,9014
"3618",1878,"65",5305,4639,9944
"3619",1878,"66",4850,4189,9039
"3620",1878,"67",4429,3795,8224
"3621",1878,"68",3553,3101,6654
"3622",1878,"69",3684,3069,6753
"3623",1878,"70",3711,3097,6808
"3624",1878,"71",3630,3113,6743
"3625",1878,"72",3528,2903,6431
"3626",1878,"73",3189,2585,5774
"3627",1878,"74",3084,2425,5509
"3628",1878,"75",2887,2222,5109
"3629",1878,"76",2678,2268,4946
"3630",1878,"77",2696,2092,4788
"3631",1878,"78",2405,1937,4342
"3632",1878,"79",2078,1411,3489
"3633",1878,"80",1831,1278,3109
"3634",1878,"81",1707,1245,2952
"3635",1878,"82",1484,1127,2611
"3636",1878,"83",1223,933,2156
"3637",1878,"84",1138,783,1921
"3638",1878,"85",878,684,1562
"3639",1878,"86",747,507,1254
"3640",1878,"87",708,444,1152
"3641",1878,"88",453,274,727
"3642",1878,"89",376,209,585
"3643",1878,"90",245,146,391
"3644",1878,"91",188,121,309
"3645",1878,"92",151,92,243
"3646",1878,"93",101,55,156
"3647",1878,"94",85,44,129
"3648",1878,"95",74,27,101
"3649",1878,"96",58,17,75
"3650",1878,"97",35,18,53
"3651",1878,"98",20,8,28
"3652",1878,"99",16,6,22
"3653",1878,"100",5,3,8
"3654",1878,"101",2,0,2
"3655",1878,"102",1,0,1
"3656",1878,"103",0,1,1
"3657",1878,"104",1,1,2
"3658",1878,"105",0,0,0
"3659",1878,"106",0,0,0
"3660",1878,"107",0,0,0
"3661",1878,"108",0,0,0
"3662",1878,"109",0,0,0
"3663",1878,"110+",0,0,0
"3664",1879,"0",27049,27866,54915
"3665",1879,"1",25131,26441,51572
"3666",1879,"2",24259,24653,48912
"3667",1879,"3",22925,23935,46860
"3668",1879,"4",22096,22716,44812
"3669",1879,"5",21057,21126,42183
"3670",1879,"6",20644,21034,41678
"3671",1879,"7",19905,20597,40502
"3672",1879,"8",19718,20011,39729
"3673",1879,"9",19177,19540,38717
"3674",1879,"10",18968,19428,38396
"3675",1879,"11",19072,19294,38366
"3676",1879,"12",19842,20108,39950
"3677",1879,"13",19913,20218,40131
"3678",1879,"14",19704,20266,39970
"3679",1879,"15",19728,20430,40158
"3680",1879,"16",18820,19347,38167
"3681",1879,"17",17602,17928,35530
"3682",1879,"18",18249,18561,36810
"3683",1879,"19",18531,18732,37263
"3684",1879,"20",17821,17431,35252
"3685",1879,"21",17242,16695,33937
"3686",1879,"22",16715,15929,32644
"3687",1879,"23",17132,15772,32904
"3688",1879,"24",17191,15880,33071
"3689",1879,"25",15893,14540,30433
"3690",1879,"26",15223,13426,28649
"3691",1879,"27",14998,13366,28364
"3692",1879,"28",14566,12739,27305
"3693",1879,"29",14263,12700,26963
"3694",1879,"30",13063,11435,24498
"3695",1879,"31",12720,11392,24112
"3696",1879,"32",12479,11200,23679
"3697",1879,"33",12191,10913,23104
"3698",1879,"34",11517,10404,21921
"3699",1879,"35",11276,10177,21453
"3700",1879,"36",11355,10342,21697
"3701",1879,"37",10804,10032,20836
"3702",1879,"38",10417,9357,19774
"3703",1879,"39",9601,8673,18274
"3704",1879,"40",9588,8700,18288
"3705",1879,"41",9702,8848,18550
"3706",1879,"42",9759,9003,18762
"3707",1879,"43",10488,9735,20223
"3708",1879,"44",10045,9405,19450
"3709",1879,"45",9511,8946,18457
"3710",1879,"46",9168,8624,17792
"3711",1879,"47",9306,8770,18076
"3712",1879,"48",9706,9016,18722
"3713",1879,"49",9700,9065,18765
"3714",1879,"50",9192,8417,17609
"3715",1879,"51",9004,8264,17268
"3716",1879,"52",9553,8887,18440
"3717",1879,"53",9481,8640,18121
"3718",1879,"54",8720,8035,16755
"3719",1879,"55",8495,8029,16524
"3720",1879,"56",8209,7732,15941
"3721",1879,"57",8253,7779,16032
"3722",1879,"58",8040,7487,15527
"3723",1879,"59",7225,6645,13870
"3724",1879,"60",6534,6028,12562
"3725",1879,"61",6403,5801,12204
"3726",1879,"62",6768,6085,12853
"3727",1879,"63",5983,5302,11285
"3728",1879,"64",4804,4290,9094
"3729",1879,"65",4648,4099,8747
"3730",1879,"66",5164,4488,9652
"3731",1879,"67",4696,4047,8743
"3732",1879,"68",4283,3666,7949
"3733",1879,"69",3432,2962,6394
"3734",1879,"70",3501,2890,6391
"3735",1879,"71",3579,2955,6534
"3736",1879,"72",3451,2941,6392
"3737",1879,"73",3359,2750,6109
"3738",1879,"74",3007,2419,5426
"3739",1879,"75",2868,2258,5126
"3740",1879,"76",2724,2077,4801
"3741",1879,"77",2458,2083,4541
"3742",1879,"78",2465,1902,4367
"3743",1879,"79",2235,1768,4003
"3744",1879,"80",1662,1205,2867
"3745",1879,"81",1660,1162,2822
"3746",1879,"82",1528,1091,2619
"3747",1879,"83",1307,1002,2309
"3748",1879,"84",1043,774,1817
"3749",1879,"85",986,676,1662
"3750",1879,"86",750,571,1321
"3751",1879,"87",621,421,1042
"3752",1879,"88",587,360,947
"3753",1879,"89",365,208,573
"3754",1879,"90",268,158,426
"3755",1879,"91",201,125,326
"3756",1879,"92",148,94,242
"3757",1879,"93",118,67,185
"3758",1879,"94",74,40,114
"3759",1879,"95",65,29,94
"3760",1879,"96",52,19,71
"3761",1879,"97",34,15,49
"3762",1879,"98",20,11,31
"3763",1879,"99",17,6,23
"3764",1879,"100",6,5,11
"3765",1879,"101",4,3,7
"3766",1879,"102",1,0,1
"3767",1879,"103",1,0,1
"3768",1879,"104",0,0,0
"3769",1879,"105",0,0,0
"3770",1879,"106",0,0,0
"3771",1879,"107",0,0,0
"3772",1879,"108",0,0,0
"3773",1879,"109",0,0,0
"3774",1879,"110+",0,0,0
"3775",1880,"0",28100,29137,57237
"3776",1880,"1",25830,26451,52281
"3777",1880,"2",24559,25824,50383
"3778",1880,"3",23918,24241,48159
"3779",1880,"4",22679,23642,46321
"3780",1880,"5",21892,22504,44396
"3781",1880,"6",20911,20960,41871
"3782",1880,"7",20522,20890,41412
"3783",1880,"8",19814,20438,40252
"3784",1880,"9",19624,19872,39496
"3785",1880,"10",19128,19432,38560
"3786",1880,"11",18931,19366,38297
"3787",1880,"12",19045,19214,38259
"3788",1880,"13",19784,20005,39789
"3789",1880,"14",19839,20089,39928
"3790",1880,"15",19639,20122,39761
"3791",1880,"16",19628,20229,39857
"3792",1880,"17",18692,19086,37778
"3793",1880,"18",17487,17567,35054
"3794",1880,"19",18088,18139,36227
"3795",1880,"20",18322,18160,36482
"3796",1880,"21",17572,16861,34433
"3797",1880,"22",17034,16214,33248
"3798",1880,"23",16507,15529,32036
"3799",1880,"24",16909,15429,32338
"3800",1880,"25",16969,15537,32506
"3801",1880,"26",15670,14219,29889
"3802",1880,"27",14984,13199,28183
"3803",1880,"28",14777,13133,27910
"3804",1880,"29",14350,12543,26893
"3805",1880,"30",14031,12517,26548
"3806",1880,"31",12881,11315,24196
"3807",1880,"32",12581,11285,23866
"3808",1880,"33",12342,11093,23435
"3809",1880,"34",12085,10799,22884
"3810",1880,"35",11417,10274,21691
"3811",1880,"36",11157,10046,21203
"3812",1880,"37",11267,10216,21483
"3813",1880,"38",10697,9927,20624
"3814",1880,"39",10316,9278,19594
"3815",1880,"40",9462,8576,18038
"3816",1880,"41",9482,8625,18107
"3817",1880,"42",9612,8772,18384
"3818",1880,"43",9675,8930,18605
"3819",1880,"44",10379,9620,19999
"3820",1880,"45",9951,9291,19242
"3821",1880,"46",9401,8859,18260
"3822",1880,"47",9066,8524,17590
"3823",1880,"48",9190,8651,17841
"3824",1880,"49",9614,8894,18508
"3825",1880,"50",9559,8901,18460
"3826",1880,"51",9069,8306,17375
"3827",1880,"52",8876,8153,17029
"3828",1880,"53",9410,8769,18179
"3829",1880,"54",9354,8507,17861
"3830",1880,"55",8584,7912,16496
"3831",1880,"56",8367,7910,16277
"3832",1880,"57",8093,7590,15683
"3833",1880,"58",8129,7643,15772
"3834",1880,"59",7903,7355,15258
"3835",1880,"60",7046,6467,13513
"3836",1880,"61",6424,5921,12345
"3837",1880,"62",6281,5664,11945
"3838",1880,"63",6636,5948,12584
"3839",1880,"64",5827,5147,10974
"3840",1880,"65",4694,4164,8858
"3841",1880,"66",4515,3957,8472
"3842",1880,"67",5031,4342,9373
"3843",1880,"68",4521,3901,8422
"3844",1880,"69",4169,3553,7722
"3845",1880,"70",3244,2796,6040
"3846",1880,"71",3374,2756,6130
"3847",1880,"72",3416,2825,6241
"3848",1880,"73",3294,2782,6076
"3849",1880,"74",3175,2603,5778
"3850",1880,"75",2792,2253,5045
"3851",1880,"76",2710,2102,4812
"3852",1880,"77",2545,1918,4463
"3853",1880,"78",2264,1879,4143
"3854",1880,"79",2269,1756,4025
"3855",1880,"80",1662,1358,3020
"3856",1880,"81",1516,1072,2588
"3857",1880,"82",1479,1034,2513
"3858",1880,"83",1346,939,2285
"3859",1880,"84",1148,832,1980
"3860",1880,"85",901,668,1569
"3861",1880,"86",847,549,1396
"3862",1880,"87",637,473,1110
"3863",1880,"88",507,330,837
"3864",1880,"89",484,292,776
"3865",1880,"90",277,158,435
"3866",1880,"91",215,126,341
"3867",1880,"92",165,99,264
"3868",1880,"93",109,65,174
"3869",1880,"94",85,47,132
"3870",1880,"95",49,31,80
"3871",1880,"96",46,14,60
"3872",1880,"97",37,8,45
"3873",1880,"98",20,6,26
"3874",1880,"99",17,8,25
"3875",1880,"100",8,3,11
"3876",1880,"101",5,3,8
"3877",1880,"102",1,1,2
"3878",1880,"103",1,0,1
"3879",1880,"104",1,0,1
"3880",1880,"105",0,0,0
"3881",1880,"106",0,0,0
"3882",1880,"107",0,0,0
"3883",1880,"108",0,0,0
"3884",1880,"109",0,0,0
"3885",1880,"110+",0,0,0
"3886",1881,"0",26967,28190,55157
"3887",1881,"1",26604,27541,54145
"3888",1881,"2",25149,25683,50832
"3889",1881,"3",24056,25275,49331
"3890",1881,"4",23507,23777,47284
"3891",1881,"5",22344,23292,45636
"3892",1881,"6",21599,22206,43805
"3893",1881,"7",20672,20725,41397
"3894",1881,"8",20335,20658,40993
"3895",1881,"9",19633,20227,39860
"3896",1881,"10",19454,19671,39125
"3897",1881,"11",18993,19246,38239
"3898",1881,"12",18803,19194,37997
"3899",1881,"13",18939,19056,37995
"3900",1881,"14",19627,19837,39464
"3901",1881,"15",19730,19910,39640
"3902",1881,"16",19491,19810,39301
"3903",1881,"17",19434,19765,39199
"3904",1881,"18",18448,18477,36925
"3905",1881,"19",17177,16831,34008
"3906",1881,"20",17722,17220,34942
"3907",1881,"21",17902,17121,35023
"3908",1881,"22",17159,15899,33058
"3909",1881,"23",16606,15352,31958
"3910",1881,"24",16119,14813,30932
"3911",1881,"25",16465,14699,31164
"3912",1881,"26",16526,14816,31342
"3913",1881,"27",15312,13663,28975
"3914",1881,"28",14648,12717,27365
"3915",1881,"29",14459,12736,27195
"3916",1881,"30",13982,12160,26142
"3917",1881,"31",13714,12209,25923
"3918",1881,"32",12628,11066,23694
"3919",1881,"33",12344,11003,23347
"3920",1881,"34",12137,10817,22954
"3921",1881,"35",11921,10509,22430
"3922",1881,"36",11241,10043,21284
"3923",1881,"37",11025,9852,20877
"3924",1881,"38",11111,10039,21150
"3925",1881,"39",10568,9748,20316
"3926",1881,"40",10151,9074,19225
"3927",1881,"41",9320,8399,17719
"3928",1881,"42",9342,8468,17810
"3929",1881,"43",9466,8615,18081
"3930",1881,"44",9576,8795,18371
"3931",1881,"45",10223,9458,19681
"3932",1881,"46",9813,9148,18961
"3933",1881,"47",9269,8730,17999
"3934",1881,"48",8924,8363,17287
"3935",1881,"49",9047,8508,17555
"3936",1881,"50",9433,8679,18112
"3937",1881,"51",9400,8727,18127
"3938",1881,"52",8929,8160,17089
"3939",1881,"53",8724,8000,16724
"3940",1881,"54",9232,8596,17828
"3941",1881,"55",9187,8340,17527
"3942",1881,"56",8411,7743,16154
"3943",1881,"57",8219,7753,15972
"3944",1881,"58",7961,7433,15394
"3945",1881,"59",7963,7468,15431
"3946",1881,"60",7689,7155,14844
"3947",1881,"61",6872,6277,13149
"3948",1881,"62",6315,5775,12090
"3949",1881,"63",6123,5500,11623
"3950",1881,"64",6441,5735,12176
"3951",1881,"65",5663,4972,10635
"3952",1881,"66",4532,4023,8555
"3953",1881,"67",4362,3824,8186
"3954",1881,"68",4821,4183,9004
"3955",1881,"69",4364,3736,8100
"3956",1881,"70",3951,3362,7313
"3957",1881,"71",3113,2672,5785
"3958",1881,"72",3221,2618,5839
"3959",1881,"73",3258,2639,5897
"3960",1881,"74",3109,2609,5718
"3961",1881,"75",2991,2416,5407
"3962",1881,"76",2616,2073,4689
"3963",1881,"77",2488,1929,4417
"3964",1881,"78",2326,1754,4080
"3965",1881,"79",2090,1713,3803
"3966",1881,"80",2287,1753,4040
"3967",1881,"81",1504,1220,2724
"3968",1881,"82",1349,951,2300
"3969",1881,"83",1295,892,2187
"3970",1881,"84",1154,780,1934
"3971",1881,"85",984,702,1686
"3972",1881,"86",757,540,1297
"3973",1881,"87",697,432,1129
"3974",1881,"88",510,373,883
"3975",1881,"89",400,262,662
"3976",1881,"90",364,220,584
"3977",1881,"91",230,127,357
"3978",1881,"92",175,96,271
"3979",1881,"93",121,71,192
"3980",1881,"94",79,49,128
"3981",1881,"95",62,32,94
"3982",1881,"96",35,16,51
"3983",1881,"97",26,9,35
"3984",1881,"98",26,3,29
"3985",1881,"99",13,3,16
"3986",1881,"100",6,5,11
"3987",1881,"101",4,1,5
"3988",1881,"102",4,1,5
"3989",1881,"103",0,0,0
"3990",1881,"104",0,0,0
"3991",1881,"105",0,0,0
"3992",1881,"106",0,0,0
"3993",1881,"107",0,0,0
"3994",1881,"108",0,0,0
"3995",1881,"109",0,0,0
"3996",1881,"110+",0,0,0
"3997",1882,"0",26275,27605,53880
"3998",1882,"1",25311,26301,51612
"3999",1882,"2",25607,26523,52130
"4000",1882,"3",24424,24929,49353
"4001",1882,"4",23469,24641,48110
"4002",1882,"5",23049,23286,46335
"4003",1882,"6",21930,22840,44770
"4004",1882,"7",21275,21835,43110
"4005",1882,"8",20385,20434,40819
"4006",1882,"9",20080,20377,40457
"4007",1882,"10",19405,19946,39351
"4008",1882,"11",19222,19405,38627
"4009",1882,"12",18804,19003,37807
"4010",1882,"13",18665,18987,37652
"4011",1882,"14",18736,18835,37571
"4012",1882,"15",19497,19656,39153
"4013",1882,"16",19545,19582,39127
"4014",1882,"17",19244,19272,38516
"4015",1882,"18",19085,18961,38046
"4016",1882,"19",18077,17555,35632
"4017",1882,"20",16715,15801,32516
"4018",1882,"21",17202,16008,33210
"4019",1882,"22",17387,16055,33442
"4020",1882,"23",16609,15125,31734
"4021",1882,"24",16095,14680,30775
"4022",1882,"25",15576,14142,29718
"4023",1882,"26",15947,14023,29970
"4024",1882,"27",16081,14182,30263
"4025",1882,"28",14882,13105,27987
"4026",1882,"29",14262,12274,26536
"4027",1882,"30",14045,12334,26379
"4028",1882,"31",13590,11809,25399
"4029",1882,"32",13399,11901,25300
"4030",1882,"33",12365,10720,23085
"4031",1882,"34",12091,10698,22789
"4032",1882,"35",11891,10522,22413
"4033",1882,"36",11684,10248,21932
"4034",1882,"37",11043,9834,20877
"4035",1882,"38",10836,9656,20492
"4036",1882,"39",10967,9837,20804
"4037",1882,"40",10357,9491,19848
"4038",1882,"41",9977,8855,18832
"4039",1882,"42",9171,8214,17385
"4040",1882,"43",9217,8315,17532
"4041",1882,"44",9319,8454,17773
"4042",1882,"45",9435,8601,18036
"4043",1882,"46",10067,9284,19351
"4044",1882,"47",9699,8991,18690
"4045",1882,"48",9091,8560,17651
"4046",1882,"49",8787,8222,17009
"4047",1882,"50",8844,8275,17119
"4048",1882,"51",9254,8472,17726
"4049",1882,"52",9243,8543,17786
"4050",1882,"53",8781,8007,16788
"4051",1882,"54",8566,7823,16389
"4052",1882,"55",9048,8399,17447
"4053",1882,"56",9002,8133,17135
"4054",1882,"57",8278,7579,15857
"4055",1882,"58",8061,7567,15628
"4056",1882,"59",7817,7278,15095
"4057",1882,"60",7707,7222,14929
"4058",1882,"61",7493,6956,14449
"4059",1882,"62",6699,6111,12810
"4060",1882,"63",6154,5623,11777
"4061",1882,"64",5937,5320,11257
"4062",1882,"65",6265,5544,11809
"4063",1882,"66",5472,4784,10256
"4064",1882,"67",4402,3857,8259
"4065",1882,"68",4190,3659,7849
"4066",1882,"69",4641,4016,8657
"4067",1882,"70",4133,3514,7647
"4068",1882,"71",3760,3171,6931
"4069",1882,"72",2954,2500,5454
"4070",1882,"73",3075,2460,5535
"4071",1882,"74",3042,2467,5509
"4072",1882,"75",2896,2374,5270
"4073",1882,"76",2780,2198,4978
"4074",1882,"77",2413,1883,4296
"4075",1882,"78",2276,1752,4028
"4076",1882,"79",2135,1601,3736
"4077",1882,"80",1840,1393,3233
"4078",1882,"81",2025,1533,3558
"4079",1882,"82",1340,1039,2379
"4080",1882,"83",1179,809,1988
"4081",1882,"84",1081,735,1816
"4082",1882,"85",958,626,1584
"4083",1882,"86",822,573,1395
"4084",1882,"87",631,436,1067
"4085",1882,"88",558,331,889
"4086",1882,"89",397,283,680
"4087",1882,"90",302,200,502
"4088",1882,"91",305,172,477
"4089",1882,"92",166,94,260
"4090",1882,"93",122,76,198
"4091",1882,"94",94,46,140
"4092",1882,"95",61,34,95
"4093",1882,"96",32,15,47
"4094",1882,"97",22,13,35
"4095",1882,"98",22,5,27
"4096",1882,"99",13,1,14
"4097",1882,"100",8,1,9
"4098",1882,"101",4,2,6
"4099",1882,"102",2,0,2
"4100",1882,"103",0,0,0
"4101",1882,"104",0,0,0
"4102",1882,"105",0,0,0
"4103",1882,"106",0,0,0
"4104",1882,"107",0,0,0
"4105",1882,"108",0,0,0
"4106",1882,"109",0,0,0
"4107",1882,"110+",0,0,0
"4108",1883,"0",26459,27818,54277
"4109",1883,"1",24276,25409,49685
"4110",1883,"2",24154,25035,49189
"4111",1883,"3",24647,25541,50188
"4112",1883,"4",23660,24151,47811
"4113",1883,"5",22867,24003,46870
"4114",1883,"6",22518,22742,45260
"4115",1883,"7",21502,22387,43889
"4116",1883,"8",20908,21428,42336
"4117",1883,"9",20056,20081,40137
"4118",1883,"10",19804,20087,39891
"4119",1883,"11",19151,19642,38793
"4120",1883,"12",18952,19092,38044
"4121",1883,"13",18588,18724,37312
"4122",1883,"14",18421,18721,37142
"4123",1883,"15",18612,18648,37260
"4124",1883,"16",19290,19256,38546
"4125",1883,"17",19229,19004,38233
"4126",1883,"18",18796,18371,37167
"4127",1883,"19",18658,17838,36496
"4128",1883,"20",17483,16351,33834
"4129",1883,"21",16121,14589,30710
"4130",1883,"22",16708,14912,31620
"4131",1883,"23",16841,15097,31938
"4132",1883,"24",16058,14360,30418
"4133",1883,"25",15539,13924,29463
"4134",1883,"26",15066,13390,28456
"4135",1883,"27",15504,13384,28888
"4136",1883,"28",15610,13599,29209
"4137",1883,"29",14468,12644,27112
"4138",1883,"30",13796,11860,25656
"4139",1883,"31",13614,11981,25595
"4140",1883,"32",13281,11503,24784
"4141",1883,"33",13070,11492,24562
"4142",1883,"34",12114,10331,22445
"4143",1883,"35",11833,10368,22201
"4144",1883,"36",11614,10199,21813
"4145",1883,"37",11483,10008,21491
"4146",1883,"38",10862,9631,20493
"4147",1883,"39",10656,9469,20125
"4148",1883,"40",10718,9579,20297
"4149",1883,"41",10169,9282,19451
"4150",1883,"42",9829,8678,18507
"4151",1883,"43",9022,8061,17083
"4152",1883,"44",9088,8181,17269
"4153",1883,"45",9161,8293,17454
"4154",1883,"46",9270,8449,17719
"4155",1883,"47",9924,9124,19048
"4156",1883,"48",9551,8817,18368
"4157",1883,"49",8943,8404,17347
"4158",1883,"50",8567,7982,16549
"4159",1883,"51",8640,8071,16711
"4160",1883,"52",9092,8265,17357
"4161",1883,"53",9076,8351,17427
"4162",1883,"54",8625,7848,16473
"4163",1883,"55",8386,7651,16037
"4164",1883,"56",8850,8182,17032
"4165",1883,"57",8821,7973,16794
"4166",1883,"58",8136,7409,15545
"4167",1883,"59",7894,7405,15299
"4168",1883,"60",7596,7048,14644
"4169",1883,"61",7494,7019,14513
"4170",1883,"62",7322,6741,14063
"4171",1883,"63",6518,5911,12429
"4172",1883,"64",5979,5445,11424
"4173",1883,"65",5774,5131,10905
"4174",1883,"66",6039,5335,11374
"4175",1883,"67",5280,4604,9884
"4176",1883,"68",4234,3720,7954
"4177",1883,"69",4049,3521,7570
"4178",1883,"70",4373,3784,8157
"4179",1883,"71",3965,3339,7304
"4180",1883,"72",3586,2998,6584
"4181",1883,"73",2796,2350,5146
"4182",1883,"74",2905,2295,5200
"4183",1883,"75",2829,2317,5146
"4184",1883,"76",2704,2189,4893
"4185",1883,"77",2565,2014,4579
"4186",1883,"78",2226,1714,3940
"4187",1883,"79",2089,1599,3688
"4188",1883,"80",1948,1412,3360
"4189",1883,"81",1672,1236,2908
"4190",1883,"82",1790,1341,3131
"4191",1883,"83",1130,894,2024
"4192",1883,"84",1014,670,1684
"4193",1883,"85",917,620,1537
"4194",1883,"86",806,517,1323
"4195",1883,"87",675,477,1152
"4196",1883,"88",504,327,831
"4197",1883,"89",457,267,724
"4198",1883,"90",296,200,496
"4199",1883,"91",241,152,393
"4200",1883,"92",230,131,361
"4201",1883,"93",113,65,178
"4202",1883,"94",87,53,140
"4203",1883,"95",62,27,89
"4204",1883,"96",36,20,56
"4205",1883,"97",23,11,34
"4206",1883,"98",12,8,20
"4207",1883,"99",14,3,17
"4208",1883,"100",8,0,8
"4209",1883,"101",7,0,7
"4210",1883,"102",2,1,3
"4211",1883,"103",2,0,2
"4212",1883,"104",0,0,0
"4213",1883,"105",0,0,0
"4214",1883,"106",0,0,0
"4215",1883,"107",0,0,0
"4216",1883,"108",0,0,0
"4217",1883,"109",0,0,0
"4218",1883,"110+",0,0,0
"4219",1884,"0",27139,28378,55517
"4220",1884,"1",24924,26050,50974
"4221",1884,"2",23367,24416,47783
"4222",1884,"3",23444,24240,47684
"4223",1884,"4",24006,24876,48882
"4224",1884,"5",23170,23628,46798
"4225",1884,"6",22391,23555,45946
"4226",1884,"7",22170,22364,44534
"4227",1884,"8",21190,22049,43239
"4228",1884,"9",20637,21117,41754
"4229",1884,"10",19813,19834,39647
"4230",1884,"11",19563,19839,39402
"4231",1884,"12",18959,19395,38354
"4232",1884,"13",18758,18864,37622
"4233",1884,"14",18390,18489,36879
"4234",1884,"15",18322,18533,36855
"4235",1884,"16",18425,18345,36770
"4236",1884,"17",19040,18774,37814
"4237",1884,"18",18868,18239,37107
"4238",1884,"19",18412,17405,35817
"4239",1884,"20",18177,16766,34943
"4240",1884,"21",17012,15327,32339
"4241",1884,"22",15748,13755,29503
"4242",1884,"23",16291,14244,30535
"4243",1884,"24",16401,14486,30887
"4244",1884,"25",15582,13805,29387
"4245",1884,"26",15085,13397,28482
"4246",1884,"27",14667,12910,27577
"4247",1884,"28",15106,12964,28070
"4248",1884,"29",15246,13223,28469
"4249",1884,"30",14103,12314,26417
"4250",1884,"31",13461,11570,25031
"4251",1884,"32",13366,11723,25089
"4252",1884,"33",12985,11208,24193
"4253",1884,"34",12803,11191,23994
"4254",1884,"35",11855,10084,21939
"4255",1884,"36",11590,10142,21732
"4256",1884,"37",11421,10013,21434
"4257",1884,"38",11321,9855,21176
"4258",1884,"39",10712,9512,20224
"4259",1884,"40",10464,9288,19752
"4260",1884,"41",10534,9430,19964
"4261",1884,"42",10054,9133,19187
"4262",1884,"43",9707,8539,18246
"4263",1884,"44",8875,7933,16808
"4264",1884,"45",8937,8045,16982
"4265",1884,"46",9007,8162,17169
"4266",1884,"47",9151,8312,17463
"4267",1884,"48",9779,8973,18752
"4268",1884,"49",9414,8691,18105
"4269",1884,"50",8763,8205,16968
"4270",1884,"51",8382,7823,16205
"4271",1884,"52",8489,7937,16426
"4272",1884,"53",8952,8113,17065
"4273",1884,"54",8935,8205,17140
"4274",1884,"55",8448,7680,16128
"4275",1884,"56",8215,7493,15708
"4276",1884,"57",8700,8032,16732
"4277",1884,"58",8659,7805,16464
"4278",1884,"59",7999,7259,15258
"4279",1884,"60",7691,7186,14877
"4280",1884,"61",7413,6878,14291
"4281",1884,"62",7311,6821,14132
"4282",1884,"63",7113,6528,13641
"4283",1884,"64",6330,5725,12055
"4284",1884,"65",5805,5282,11087
"4285",1884,"66",5603,4959,10562
"4286",1884,"67",5847,5163,11010
"4287",1884,"68",5113,4406,9519
"4288",1884,"69",4112,3592,7704
"4289",1884,"70",3846,3321,7167
"4290",1884,"71",4185,3614,7799
"4291",1884,"72",3774,3161,6935
"4292",1884,"73",3373,2834,6207
"4293",1884,"74",2638,2186,4824
"4294",1884,"75",2721,2126,4847
"4295",1884,"76",2666,2145,4811
"4296",1884,"77",2494,2007,4501
"4297",1884,"78",2361,1838,4199
"4298",1884,"79",2056,1580,3636
"4299",1884,"80",1875,1392,3267
"4300",1884,"81",1770,1265,3035
"4301",1884,"82",1479,1072,2551
"4302",1884,"83",1579,1145,2724
"4303",1884,"84",957,754,1711
"4304",1884,"85",852,559,1411
"4305",1884,"86",779,516,1295
"4306",1884,"87",671,417,1088
"4307",1884,"88",543,379,922
"4308",1884,"89",418,269,687
"4309",1884,"90",341,202,543
"4310",1884,"91",244,157,401
"4311",1884,"92",177,116,293
"4312",1884,"93",168,95,263
"4313",1884,"94",82,44,126
"4314",1884,"95",59,39,98
"4315",1884,"96",36,18,54
"4316",1884,"97",26,14,40
"4317",1884,"98",14,9,23
"4318",1884,"99",7,5,12
"4319",1884,"100",9,1,10
"4320",1884,"101",5,0,5
"4321",1884,"102",2,0,2
"4322",1884,"103",2,1,3
"4323",1884,"104",0,0,0
"4324",1884,"105",0,0,0
"4325",1884,"106",0,0,0
"4326",1884,"107",0,0,0
"4327",1884,"108",0,0,0
"4328",1884,"109",0,0,0
"4329",1884,"110+",0,0,0
"4330",1885,"0",27765,29125,56890
"4331",1885,"1",25684,26769,52453
"4332",1885,"2",24139,25202,49341
"4333",1885,"3",22825,23784,46609
"4334",1885,"4",22971,23743,46714
"4335",1885,"5",23583,24423,48006
"4336",1885,"6",22822,23263,46085
"4337",1885,"7",22113,23244,45357
"4338",1885,"8",21911,22131,44042
"4339",1885,"9",20971,21828,42799
"4340",1885,"10",20443,20908,41351
"4341",1885,"11",19644,19657,39301
"4342",1885,"12",19408,19647,39055
"4343",1885,"13",18834,19214,38048
"4344",1885,"14",18606,18675,37281
"4345",1885,"15",18305,18332,36637
"4346",1885,"16",18202,18305,36507
"4347",1885,"17",18274,17966,36240
"4348",1885,"18",18780,18189,36969
"4349",1885,"19",18553,17509,36062
"4350",1885,"20",18041,16613,34654
"4351",1885,"21",17855,15971,33826
"4352",1885,"22",16702,14699,31401
"4353",1885,"23",15431,13274,28705
"4354",1885,"24",15980,13844,29824
"4355",1885,"25",16050,14075,30125
"4356",1885,"26",15255,13442,28697
"4357",1885,"27",14802,13055,27857
"4358",1885,"28",14363,12629,26992
"4359",1885,"29",14838,12725,27563
"4360",1885,"30",14948,12984,27932
"4361",1885,"31",13827,12110,25937
"4362",1885,"32",13231,11386,24617
"4363",1885,"33",13122,11534,24656
"4364",1885,"34",12753,11028,23781
"4365",1885,"35",12556,11018,23574
"4366",1885,"36",11641,9923,21564
"4367",1885,"37",11422,9988,21410
"4368",1885,"38",11283,9915,21198
"4369",1885,"39",11193,9774,20967
"4370",1885,"40",10574,9388,19962
"4371",1885,"41",10334,9179,19513
"4372",1885,"42",10414,9323,19737
"4373",1885,"43",9953,9019,18972
"4374",1885,"44",9594,8431,18025
"4375",1885,"45",8758,7827,16585
"4376",1885,"46",8804,7940,16744
"4377",1885,"47",8901,8071,16972
"4378",1885,"48",9039,8214,17253
"4379",1885,"49",9658,8843,18501
"4380",1885,"50",9268,8538,17806
"4381",1885,"51",8633,8068,16701
"4382",1885,"52",8259,7700,15959
"4383",1885,"53",8348,7797,16145
"4384",1885,"54",8817,7987,16804
"4385",1885,"55",8771,8034,16805
"4386",1885,"56",8297,7519,15816
"4387",1885,"57",8066,7357,15423
"4388",1885,"58",8544,7876,16420
"4389",1885,"59",8503,7654,16157
"4390",1885,"60",7806,7066,14872
"4391",1885,"61",7531,7033,14564
"4392",1885,"62",7266,6724,13990
"4393",1885,"63",7122,6626,13748
"4394",1885,"64",6920,6323,13243
"4395",1885,"65",6136,5552,11688
"4396",1885,"66",5610,5099,10709
"4397",1885,"67",5437,4773,10210
"4398",1885,"68",5658,4979,10637
"4399",1885,"69",4938,4262,9200
"4400",1885,"70",3927,3410,7337
"4401",1885,"71",3717,3178,6895
"4402",1885,"72",4005,3427,7432
"4403",1885,"73",3595,2986,6581
"4404",1885,"74",3208,2670,5878
"4405",1885,"75",2462,2021,4483
"4406",1885,"76",2519,1968,4487
"4407",1885,"77",2464,1959,4423
"4408",1885,"78",2300,1822,4122
"4409",1885,"79",2188,1674,3862
"4410",1885,"80",1873,1437,3310
"4411",1885,"81",1690,1275,2965
"4412",1885,"82",1564,1119,2683
"4413",1885,"83",1292,929,2221
"4414",1885,"84",1365,990,2355
"4415",1885,"85",818,638,1456
"4416",1885,"86",686,462,1148
"4417",1885,"87",643,411,1054
"4418",1885,"88",544,322,866
"4419",1885,"89",462,299,761
"4420",1885,"90",318,202,520
"4421",1885,"91",276,147,423
"4422",1885,"92",191,128,319
"4423",1885,"93",133,87,220
"4424",1885,"94",127,74,201
"4425",1885,"95",67,30,97
"4426",1885,"96",43,24,67
"4427",1885,"97",29,13,42
"4428",1885,"98",15,5,20
"4429",1885,"99",4,3,7
"4430",1885,"100",2,2,4
"4431",1885,"101",4,0,4
"4432",1885,"102",2,0,2
"4433",1885,"103",1,0,1
"4434",1885,"104",0,0,0
"4435",1885,"105",0,0,0
"4436",1885,"106",0,0,0
"4437",1885,"107",0,0,0
"4438",1885,"108",0,0,0
"4439",1885,"109",0,0,0
"4440",1885,"110+",0,0,0
"4441",1886,"0",28131,29287,57418
"4442",1886,"1",26354,27452,53806
"4443",1886,"2",24981,25958,50939
"4444",1886,"3",23611,24637,48248
"4445",1886,"4",22425,23348,45773
"4446",1886,"5",22603,23369,45972
"4447",1886,"6",23229,24073,47302
"4448",1886,"7",22521,22979,45500
"4449",1886,"8",21880,22969,44849
"4450",1886,"9",21690,21938,43628
"4451",1886,"10",20770,21611,42381
"4452",1886,"11",20246,20704,40950
"4453",1886,"12",19482,19504,38986
"4454",1886,"13",19276,19466,38742
"4455",1886,"14",18689,19025,37714
"4456",1886,"15",18489,18483,36972
"4457",1886,"16",18164,18067,36231
"4458",1886,"17",17999,17906,35905
"4459",1886,"18",17994,17426,35420
"4460",1886,"19",18444,17511,35955
"4461",1886,"20",18126,16775,34901
"4462",1886,"21",17596,15888,33484
"4463",1886,"22",17508,15369,32877
"4464",1886,"23",16390,14277,30667
"4465",1886,"24",15150,12934,28084
"4466",1886,"25",15647,13494,29141
"4467",1886,"26",15718,13722,29440
"4468",1886,"27",14982,13110,28092
"4469",1886,"28",14516,12740,27256
"4470",1886,"29",14121,12379,26500
"4471",1886,"30",14537,12491,27028
"4472",1886,"31",14649,12787,27436
"4473",1886,"32",13594,11914,25508
"4474",1886,"33",13001,11178,24179
"4475",1886,"34",12895,11337,24232
"4476",1886,"35",12536,10852,23388
"4477",1886,"36",12315,10833,23148
"4478",1886,"37",11440,9798,21238
"4479",1886,"38",11251,9855,21106
"4480",1886,"39",11152,9827,20979
"4481",1886,"40",11022,9632,20654
"4482",1886,"41",10431,9275,19706
"4483",1886,"42",10221,9085,19306
"4484",1886,"43",10319,9243,19562
"4485",1886,"44",9837,8924,18761
"4486",1886,"45",9457,8311,17768
"4487",1886,"46",8631,7721,16352
"4488",1886,"47",8682,7842,16524
"4489",1886,"48",8798,7963,16761
"4490",1886,"49",8942,8127,17069
"4491",1886,"50",9506,8689,18195
"4492",1886,"51",9119,8395,17514
"4493",1886,"52",8510,7936,16446
"4494",1886,"53",8124,7552,15676
"4495",1886,"54",8206,7651,15857
"4496",1886,"55",8642,7830,16472
"4497",1886,"56",8620,7886,16506
"4498",1886,"57",8176,7384,15560
"4499",1886,"58",7908,7216,15124
"4500",1886,"59",8383,7725,16108
"4501",1886,"60",8263,7458,15721
"4502",1886,"61",7658,6893,14551
"4503",1886,"62",7395,6864,14259
"4504",1886,"63",7091,6515,13606
"4505",1886,"64",6919,6410,13329
"4506",1886,"65",6697,6118,12815
"4507",1886,"66",5930,5373,11303
"4508",1886,"67",5433,4917,10350
"4509",1886,"68",5260,4589,9849
"4510",1886,"69",5492,4770,10262
"4511",1886,"70",4717,4048,8765
"4512",1886,"71",3777,3253,7030
"4513",1886,"72",3564,3014,6578
"4514",1886,"73",3804,3245,7049
"4515",1886,"74",3385,2768,6153
"4516",1886,"75",3004,2487,5491
"4517",1886,"76",2311,1861,4172
"4518",1886,"77",2341,1801,4142
"4519",1886,"78",2279,1774,4053
"4520",1886,"79",2135,1682,3817
"4521",1886,"80",2010,1451,3461
"4522",1886,"81",1695,1285,2980
"4523",1886,"82",1514,1109,2623
"4524",1886,"83",1384,947,2331
"4525",1886,"84",1103,796,1899
"4526",1886,"85",1150,813,1963
"4527",1886,"86",684,526,1210
"4528",1886,"87",566,373,939
"4529",1886,"88",518,331,849
"4530",1886,"89",436,241,677
"4531",1886,"90",342,219,561
"4532",1886,"91",239,159,398
"4533",1886,"92",213,105,318
"4534",1886,"93",140,92,232
"4535",1886,"94",90,62,152
"4536",1886,"95",81,56,137
"4537",1886,"96",44,22,66
"4538",1886,"97",36,16,52
"4539",1886,"98",12,7,19
"4540",1886,"99",10,3,13
"4541",1886,"100",1,2,3
"4542",1886,"101",1,1,2
"4543",1886,"102",4,0,4
"4544",1886,"103",1,0,1
"4545",1886,"104",1,0,1
"4546",1886,"105",0,0,0
"4547",1886,"106",0,0,0
"4548",1886,"107",0,0,0
"4549",1886,"108",0,0,0
"4550",1886,"109",0,0,0
"4551",1886,"110+",0,0,0
"4552",1887,"0",27644,29122,56766
"4553",1887,"1",26684,27732,54416
"4554",1887,"2",25593,26669,52262
"4555",1887,"3",24480,25382,49862
"4556",1887,"4",23184,24189,47373
"4557",1887,"5",22097,22970,45067
"4558",1887,"6",22301,23077,45378
"4559",1887,"7",22967,23787,46754
"4560",1887,"8",22247,22743,44990
"4561",1887,"9",21676,22762,44438
"4562",1887,"10",21470,21758,43228
"4563",1887,"11",20598,21423,42021
"4564",1887,"12",20079,20537,40616
"4565",1887,"13",19342,19375,38717
"4566",1887,"14",19137,19293,38430
"4567",1887,"15",18564,18855,37419
"4568",1887,"16",18339,18224,36563
"4569",1887,"17",17985,17651,35636
"4570",1887,"18",17749,17335,35084
"4571",1887,"19",17674,16708,34382
"4572",1887,"20",18047,16692,34739
"4573",1887,"21",17742,15954,33696
"4574",1887,"22",17284,15203,32487
"4575",1887,"23",17175,14806,31981
"4576",1887,"24",16061,13844,29905
"4577",1887,"25",14844,12546,27390
"4578",1887,"26",15345,13067,28412
"4579",1887,"27",15427,13321,28748
"4580",1887,"28",14719,12766,27485
"4581",1887,"29",14231,12447,26678
"4582",1887,"30",13829,12117,25946
"4583",1887,"31",14268,12284,26552
"4584",1887,"32",14448,12578,27026
"4585",1887,"33",13340,11669,25009
"4586",1887,"34",12774,10974,23748
"4587",1887,"35",12672,11149,23821
"4588",1887,"36",12284,10668,22952
"4589",1887,"37",12101,10648,22749
"4590",1887,"38",11255,9665,20920
"4591",1887,"39",11077,9722,20799
"4592",1887,"40",10987,9679,20666
"4593",1887,"41",10886,9502,20388
"4594",1887,"42",10329,9175,19504
"4595",1887,"43",10117,8972,19089
"4596",1887,"44",10218,9124,19342
"4597",1887,"45",9719,8817,18536
"4598",1887,"46",9366,8207,17573
"4599",1887,"47",8546,7615,16161
"4600",1887,"48",8591,7733,16324
"4601",1887,"49",8713,7854,16567
"4602",1887,"50",8794,7974,16768
"4603",1887,"51",9365,8557,17922
"4604",1887,"52",8986,8287,17273
"4605",1887,"53",8381,7825,16206
"4606",1887,"54",8001,7418,15419
"4607",1887,"55",8043,7501,15544
"4608",1887,"56",8486,7661,16147
"4609",1887,"57",8460,7742,16202
"4610",1887,"58",8026,7256,15282
"4611",1887,"59",7780,7068,14848
"4612",1887,"60",8181,7492,15673
"4613",1887,"61",8106,7258,15364
"4614",1887,"62",7520,6735,14255
"4615",1887,"63",7223,6675,13898
"4616",1887,"64",6919,6324,13243
"4617",1887,"65",6738,6220,12958
"4618",1887,"66",6462,5890,12352
"4619",1887,"67",5739,5167,10906
"4620",1887,"68",5225,4729,9954
"4621",1887,"69",5072,4409,9481
"4622",1887,"70",5237,4540,9777
"4623",1887,"71",4570,3856,8426
"4624",1887,"72",3642,3081,6723
"4625",1887,"73",3394,2831,6225
"4626",1887,"74",3595,3053,6648
"4627",1887,"75",3159,2573,5732
"4628",1887,"76",2803,2296,5099
"4629",1887,"77",2146,1694,3840
"4630",1887,"78",2154,1650,3804
"4631",1887,"79",2112,1625,3737
"4632",1887,"80",1889,1418,3307
"4633",1887,"81",1828,1284,3112
"4634",1887,"82",1504,1134,2638
"4635",1887,"83",1326,951,2277
"4636",1887,"84",1197,783,1980
"4637",1887,"85",935,658,1593
"4638",1887,"86",929,646,1575
"4639",1887,"87",577,421,998
"4640",1887,"88",474,300,774
"4641",1887,"89",409,263,672
"4642",1887,"90",335,172,507
"4643",1887,"91",269,173,442
"4644",1887,"92",166,118,284
"4645",1887,"93",161,82,243
"4646",1887,"94",105,64,169
"4647",1887,"95",55,46,101
"4648",1887,"96",59,40,99
"4649",1887,"97",26,14,40
"4650",1887,"98",17,11,28
"4651",1887,"99",9,3,12
"4652",1887,"100",4,2,6
"4653",1887,"101",0,1,1
"4654",1887,"102",0,1,1
"4655",1887,"103",3,0,3
"4656",1887,"104",1,0,1
"4657",1887,"105",0,0,0
"4658",1887,"106",0,0,0
"4659",1887,"107",0,0,0
"4660",1887,"108",0,0,0
"4661",1887,"109",0,0,0
"4662",1887,"110+",0,0,0
"4663",1888,"0",28373,29817,58190
"4664",1888,"1",26273,27436,53709
"4665",1888,"2",25907,26908,52815
"4666",1888,"3",25030,26038,51068
"4667",1888,"4",24039,24925,48964
"4668",1888,"5",22837,23818,46655
"4669",1888,"6",21777,22631,44408
"4670",1888,"7",22063,22828,44891
"4671",1888,"8",22684,23499,46183
"4672",1888,"9",22008,22520,44528
"4673",1888,"10",21470,22566,44036
"4674",1888,"11",21283,21573,42856
"4675",1888,"12",20422,21211,41633
"4676",1888,"13",19920,20348,40268
"4677",1888,"14",19153,19214,38367
"4678",1888,"15",18998,19109,38107
"4679",1888,"16",18397,18552,36949
"4680",1888,"17",18086,17708,35794
"4681",1888,"18",17636,16880,34516
"4682",1888,"19",17376,16389,33765
"4683",1888,"20",17208,15601,32809
"4684",1888,"21",17559,15465,33024
"4685",1888,"22",17300,14876,32176
"4686",1888,"23",16836,14351,31187
"4687",1888,"24",16779,14073,30852
"4688",1888,"25",15632,13197,28829
"4689",1888,"26",14474,12008,26482
"4690",1888,"27",15022,12584,27606
"4691",1888,"28",15080,12815,27895
"4692",1888,"29",14426,12327,26753
"4693",1888,"30",13908,12040,25948
"4694",1888,"31",13539,11777,25316
"4695",1888,"32",14032,11984,26016
"4696",1888,"33",14193,12229,26422
"4697",1888,"34",13104,11356,24460
"4698",1888,"35",12539,10737,23276
"4699",1888,"36",12411,10873,23284
"4700",1888,"37",12051,10425,22476
"4701",1888,"38",11892,10449,22341
"4702",1888,"39",11085,9506,20591
"4703",1888,"40",10865,9508,20373
"4704",1888,"41",10816,9503,20319
"4705",1888,"42",10775,9370,20145
"4706",1888,"43",10231,9053,19284
"4707",1888,"44",10000,8835,18835
"4708",1888,"45",10104,8994,19098
"4709",1888,"46",9613,8680,18293
"4710",1888,"47",9260,8085,17345
"4711",1888,"48",8448,7472,15920
"4712",1888,"49",8472,7594,16066
"4713",1888,"50",8558,7692,16250
"4714",1888,"51",8663,7840,16503
"4715",1888,"52",9242,8422,17664
"4716",1888,"53",8862,8164,17026
"4717",1888,"54",8256,7682,15938
"4718",1888,"55",7861,7279,15140
"4719",1888,"56",7887,7328,15215
"4720",1888,"57",8341,7508,15849
"4721",1888,"58",8319,7586,15905
"4722",1888,"59",7885,7134,15019
"4723",1888,"60",7583,6867,14450
"4724",1888,"61",8023,7296,15319
"4725",1888,"62",7935,7073,15008
"4726",1888,"63",7350,6548,13898
"4727",1888,"64",7043,6487,13530
"4728",1888,"65",6729,6158,12887
"4729",1888,"66",6535,5993,12528
"4730",1888,"67",6250,5683,11933
"4731",1888,"68",5561,4966,10527
"4732",1888,"69",5072,4567,9639
"4733",1888,"70",4849,4199,9048
"4734",1888,"71",5044,4332,9376
"4735",1888,"72",4354,3656,8010
"4736",1888,"73",3479,2917,6396
"4737",1888,"74",3206,2656,5862
"4738",1888,"75",3402,2857,6259
"4739",1888,"76",2963,2388,5351
"4740",1888,"77",2611,2098,4709
"4741",1888,"78",1989,1552,3541
"4742",1888,"79",1982,1517,3499
"4743",1888,"80",1901,1382,3283
"4744",1888,"81",1727,1263,2990
"4745",1888,"82",1614,1131,2745
"4746",1888,"83",1318,977,2295
"4747",1888,"84",1162,817,1979
"4748",1888,"85",1021,659,1680
"4749",1888,"86",794,530,1324
"4750",1888,"87",765,516,1281
"4751",1888,"88",449,331,780
"4752",1888,"89",387,238,625
"4753",1888,"90",315,191,506
"4754",1888,"91",249,135,384
"4755",1888,"92",206,130,336
"4756",1888,"93",113,82,195
"4757",1888,"94",128,59,187
"4758",1888,"95",76,42,118
"4759",1888,"96",37,26,63
"4760",1888,"97",40,31,71
"4761",1888,"98",13,12,25
"4762",1888,"99",11,8,19
"4763",1888,"100",4,2,6
"4764",1888,"101",1,1,2
"4765",1888,"102",0,0,0
"4766",1888,"103",0,1,1
"4767",1888,"104",1,0,1
"4768",1888,"105",0,0,0
"4769",1888,"106",0,0,0
"4770",1888,"107",0,0,0
"4771",1888,"108",0,0,0
"4772",1888,"109",0,0,0
"4773",1888,"110+",0,0,0
"4774",1889,"0",27440,28738,56178
"4775",1889,"1",26874,28109,54983
"4776",1889,"2",25492,26556,52048
"4777",1889,"3",25261,26292,51553
"4778",1889,"4",24544,25506,50050
"4779",1889,"5",23683,24538,48221
"4780",1889,"6",22529,23454,45983
"4781",1889,"7",21516,22351,43867
"4782",1889,"8",21807,22593,44400
"4783",1889,"9",22440,23269,45709
"4784",1889,"10",21752,22312,44064
"4785",1889,"11",21274,22362,43636
"4786",1889,"12",21071,21402,42473
"4787",1889,"13",20238,21025,41263
"4788",1889,"14",19732,20166,39898
"4789",1889,"15",18978,19034,38012
"4790",1889,"16",18811,18784,37595
"4791",1889,"17",18143,18007,36150
"4792",1889,"18",17662,16813,34475
"4793",1889,"19",17235,15832,33067
"4794",1889,"20",16928,15221,32149
"4795",1889,"21",16730,14391,31121
"4796",1889,"22",17116,14408,31524
"4797",1889,"23",16835,13954,30789
"4798",1889,"24",16419,13566,29985
"4799",1889,"25",16341,13327,29668
"4800",1889,"26",15240,12566,27806
"4801",1889,"27",14187,11520,25707
"4802",1889,"28",14712,12150,26862
"4803",1889,"29",14795,12379,27174
"4804",1889,"30",14110,11881,25991
"4805",1889,"31",13607,11641,25248
"4806",1889,"32",13317,11475,24792
"4807",1889,"33",13754,11672,25426
"4808",1889,"34",13962,11912,25874
"4809",1889,"35",12834,11057,23891
"4810",1889,"36",12274,10466,22740
"4811",1889,"37",12172,10646,22818
"4812",1889,"38",11825,10215,22040
"4813",1889,"39",11695,10253,21948
"4814",1889,"40",10882,9282,20164
"4815",1889,"41",10673,9321,19994
"4816",1889,"42",10680,9383,20063
"4817",1889,"43",10652,9251,19903
"4818",1889,"44",10113,8940,19053
"4819",1889,"45",9877,8693,18570
"4820",1889,"46",9989,8844,18833
"4821",1889,"47",9499,8562,18061
"4822",1889,"48",9145,7963,17108
"4823",1889,"49",8340,7365,15705
"4824",1889,"50",8302,7428,15730
"4825",1889,"51",8422,7556,15978
"4826",1889,"52",8569,7709,16278
"4827",1889,"53",9117,8281,17398
"4828",1889,"54",8731,8030,16761
"4829",1889,"55",8102,7510,15612
"4830",1889,"56",7690,7135,14825
"4831",1889,"57",7742,7149,14891
"4832",1889,"58",8207,7343,15550
"4833",1889,"59",8158,7426,15584
"4834",1889,"60",7670,6902,14572
"4835",1889,"61",7383,6700,14083
"4836",1889,"62",7827,7124,14951
"4837",1889,"63",7729,6878,14607
"4838",1889,"64",7154,6348,13502
"4839",1889,"65",6852,6283,13135
"4840",1889,"66",6514,5900,12414
"4841",1889,"67",6307,5746,12053
"4842",1889,"68",6024,5448,11472
"4843",1889,"69",5373,4795,10168
"4844",1889,"70",4827,4354,9181
"4845",1889,"71",4669,4019,8688
"4846",1889,"72",4832,4106,8938
"4847",1889,"73",4146,3418,7564
"4848",1889,"74",3288,2705,5993
"4849",1889,"75",2997,2457,5454
"4850",1889,"76",3181,2620,5801
"4851",1889,"77",2744,2197,4941
"4852",1889,"78",2383,1917,4300
"4853",1889,"79",1814,1400,3214
"4854",1889,"80",1731,1323,3054
"4855",1889,"81",1706,1227,2933
"4856",1889,"82",1514,1100,2614
"4857",1889,"83",1397,976,2373
"4858",1889,"84",1101,826,1927
"4859",1889,"85",981,653,1634
"4860",1889,"86",838,529,1367
"4861",1889,"87",643,421,1064
"4862",1889,"88",581,403,984
"4863",1889,"89",357,268,625
"4864",1889,"90",293,169,462
"4865",1889,"91",237,139,376
"4866",1889,"92",176,109,285
"4867",1889,"93",155,86,241
"4868",1889,"94",79,51,130
"4869",1889,"95",88,41,129
"4870",1889,"96",46,29,75
"4871",1889,"97",22,16,38
"4872",1889,"98",20,14,34
"4873",1889,"99",6,7,13
"4874",1889,"100",5,4,9
"4875",1889,"101",3,1,4
"4876",1889,"102",1,1,2
"4877",1889,"103",0,0,0
"4878",1889,"104",0,0,0
"4879",1889,"105",0,0,0
"4880",1889,"106",0,0,0
"4881",1889,"107",0,0,0
"4882",1889,"108",0,0,0
"4883",1889,"109",0,0,0
"4884",1889,"110+",0,0,0
"4885",1890,"0",26691,28001,54692
"4886",1890,"1",25769,26926,52695
"4887",1890,"2",26025,27269,53294
"4888",1890,"3",24900,25986,50886
"4889",1890,"4",24780,25790,50570
"4890",1890,"5",24190,25109,49299
"4891",1890,"6",23376,24226,47602
"4892",1890,"7",22286,23241,45527
"4893",1890,"8",21315,22151,43466
"4894",1890,"9",21617,22407,44024
"4895",1890,"10",22244,23058,45302
"4896",1890,"11",21568,22140,43708
"4897",1890,"12",21099,22183,43282
"4898",1890,"13",20900,21248,42148
"4899",1890,"14",20087,20867,40954
"4900",1890,"15",19562,19975,39537
"4901",1890,"16",18779,18756,37535
"4902",1890,"17",18567,18363,36930
"4903",1890,"18",17868,17389,35257
"4904",1890,"19",17367,16070,33437
"4905",1890,"20",16871,15066,31937
"4906",1890,"21",16571,14454,31025
"4907",1890,"22",16425,13743,30168
"4908",1890,"23",16790,13820,30610
"4909",1890,"24",16556,13497,30053
"4910",1890,"25",16115,13131,29246
"4911",1890,"26",16057,12912,28969
"4912",1890,"27",14998,12253,27251
"4913",1890,"28",13985,11261,25246
"4914",1890,"29",14483,11891,26374
"4915",1890,"30",14536,12110,26646
"4916",1890,"31",13887,11650,25537
"4917",1890,"32",13433,11402,24835
"4918",1890,"33",13075,11238,24313
"4919",1890,"34",13526,11471,24997
"4920",1890,"35",13717,11704,25421
"4921",1890,"36",12623,10851,23474
"4922",1890,"37",12084,10298,22382
"4923",1890,"38",11973,10464,22437
"4924",1890,"39",11658,10068,21726
"4925",1890,"40",11476,10075,21551
"4926",1890,"41",10701,9153,19854
"4927",1890,"42",10531,9197,19728
"4928",1890,"43",10545,9297,19842
"4929",1890,"44",10551,9169,19720
"4930",1890,"45",10011,8840,18851
"4931",1890,"46",9777,8576,18353
"4932",1890,"47",9885,8752,18637
"4933",1890,"48",9399,8457,17856
"4934",1890,"49",9036,7869,16905
"4935",1890,"50",8208,7217,15425
"4936",1890,"51",8185,7307,15492
"4937",1890,"52",8318,7457,15775
"4938",1890,"53",8464,7592,16056
"4939",1890,"54",9014,8155,17169
"4940",1890,"55",8600,7870,16470
"4941",1890,"56",7953,7368,15321
"4942",1890,"57",7565,6982,14547
"4943",1890,"58",7611,6989,14600
"4944",1890,"59",8073,7190,15263
"4945",1890,"60",7950,7238,15188
"4946",1890,"61",7512,6750,14262
"4947",1890,"62",7207,6535,13742
"4948",1890,"63",7631,6957,14588
"4949",1890,"64",7536,6680,14216
"4950",1890,"65",6989,6183,13172
"4951",1890,"66",6661,6055,12716
"4952",1890,"67",6309,5691,12000
"4953",1890,"68",6114,5506,11620
"4954",1890,"69",5802,5214,11016
"4955",1890,"70",5130,4546,9676
"4956",1890,"71",4641,4152,8793
"4957",1890,"72",4476,3822,8298
"4958",1890,"73",4617,3861,8478
"4959",1890,"74",3921,3181,7102
"4960",1890,"75",3078,2507,5585
"4961",1890,"76",2814,2299,5113
"4962",1890,"77",2973,2404,5377
"4963",1890,"78",2523,2004,4527
"4964",1890,"79",2193,1740,3933
"4965",1890,"80",1613,1211,2824
"4966",1890,"81",1579,1175,2754
"4967",1890,"82",1522,1056,2578
"4968",1890,"83",1361,945,2306
"4969",1890,"84",1200,817,2017
"4970",1890,"85",926,686,1612
"4971",1890,"86",840,531,1371
"4972",1890,"87",678,409,1087
"4973",1890,"88",504,326,830
"4974",1890,"89",447,304,751
"4975",1890,"90",256,208,464
"4976",1890,"91",229,130,359
"4977",1890,"92",178,92,270
"4978",1890,"93",121,69,190
"4979",1890,"94",117,60,177
"4980",1890,"95",54,28,82
"4981",1890,"96",58,26,84
"4982",1890,"97",30,18,48
"4983",1890,"98",13,11,24
"4984",1890,"99",12,8,20
"4985",1890,"100",1,3,4
"4986",1890,"101",4,3,7
"4987",1890,"102",2,0,2
"4988",1890,"103",1,0,1
"4989",1890,"104",0,0,0
"4990",1890,"105",0,0,0
"4991",1890,"106",0,0,0
"4992",1890,"107",0,0,0
"4993",1890,"108",0,0,0
"4994",1890,"109",0,0,0
"4995",1890,"110+",0,0,0
"4996",1891,"0",28021,29223,57244
"4997",1891,"1",25243,26389,51632
"4998",1891,"2",25018,26066,51084
"4999",1891,"3",25430,26675,52105
"5000",1891,"4",24440,25529,49969
"5001",1891,"5",24420,25398,49818
"5002",1891,"6",23879,24790,48669
"5003",1891,"7",23141,23981,47122
"5004",1891,"8",22060,23019,45079
"5005",1891,"9",21143,21969,43112
"5006",1891,"10",21426,22230,43656
"5007",1891,"11",22040,22844,44884
"5008",1891,"12",21353,21948,43301
"5009",1891,"13",20933,22021,42954
"5010",1891,"14",20724,21082,41806
"5011",1891,"15",19928,20650,40578
"5012",1891,"16",19329,19691,39020
"5013",1891,"17",18513,18398,36911
"5014",1891,"18",18243,17807,36050
"5015",1891,"19",17559,16693,34252
"5016",1891,"20",16972,15337,32309
"5017",1891,"21",16515,14401,30916
"5018",1891,"22",16279,13905,30184
"5019",1891,"23",16183,13326,29509
"5020",1891,"24",16576,13469,30045
"5021",1891,"25",16287,13152,29439
"5022",1891,"26",15853,12788,28641
"5023",1891,"27",15827,12600,28427
"5024",1891,"28",14765,11976,26741
"5025",1891,"29",13788,11049,24837
"5026",1891,"30",14244,11675,25919
"5027",1891,"31",14300,11901,26201
"5028",1891,"32",13702,11452,25154
"5029",1891,"33",13247,11187,24434
"5030",1891,"34",12883,11051,23934
"5031",1891,"35",13323,11288,24611
"5032",1891,"36",13471,11490,24961
"5033",1891,"37",12408,10675,23083
"5034",1891,"38",11892,10154,22046
"5035",1891,"39",11759,10294,22053
"5036",1891,"40",11422,9923,21345
"5037",1891,"41",11280,9918,21198
"5038",1891,"42",10519,9051,19570
"5039",1891,"43",10381,9088,19469
"5040",1891,"44",10416,9204,19620
"5041",1891,"45",10417,9063,19480
"5042",1891,"46",9901,8731,18632
"5043",1891,"47",9663,8472,18135
"5044",1891,"48",9774,8638,18412
"5045",1891,"49",9305,8358,17663
"5046",1891,"50",8850,7730,16580
"5047",1891,"51",8087,7124,15211
"5048",1891,"52",8089,7199,15288
"5049",1891,"53",8201,7324,15525
"5050",1891,"54",8382,7446,15828
"5051",1891,"55",8872,8013,16885
"5052",1891,"56",8484,7712,16196
"5053",1891,"57",7833,7203,15036
"5054",1891,"58",7410,6842,14252
"5055",1891,"59",7464,6835,14299
"5056",1891,"60",7834,6993,14827
"5057",1891,"61",7789,7044,14833
"5058",1891,"62",7330,6572,13902
"5059",1891,"63",7018,6341,13359
"5060",1891,"64",7402,6764,14166
"5061",1891,"65",7311,6465,13776
"5062",1891,"66",6772,5971,12743
"5063",1891,"67",6469,5833,12302
"5064",1891,"68",6101,5476,11577
"5065",1891,"69",5924,5296,11220
"5066",1891,"70",5568,4930,10498
"5067",1891,"71",4918,4321,9239
"5068",1891,"72",4435,3904,8339
"5069",1891,"73",4253,3618,7871
"5070",1891,"74",4373,3621,7994
"5071",1891,"75",3692,2982,6674
"5072",1891,"76",2865,2318,5183
"5073",1891,"77",2622,2131,4753
"5074",1891,"78",2728,2179,4907
"5075",1891,"79",2296,1809,4105
"5076",1891,"80",2118,1583,3701
"5077",1891,"81",1443,1086,2529
"5078",1891,"82",1411,1044,2455
"5079",1891,"83",1327,922,2249
"5080",1891,"84",1169,792,1961
"5081",1891,"85",1021,688,1709
"5082",1891,"86",773,563,1336
"5083",1891,"87",710,420,1130
"5084",1891,"88",538,328,866
"5085",1891,"89",414,254,668
"5086",1891,"90",331,213,544
"5087",1891,"91",208,156,364
"5088",1891,"92",177,100,277
"5089",1891,"93",118,69,187
"5090",1891,"94",84,52,136
"5091",1891,"95",82,38,120
"5092",1891,"96",35,17,52
"5093",1891,"97",26,19,45
"5094",1891,"98",15,12,27
"5095",1891,"99",6,6,12
"5096",1891,"100",7,0,7
"5097",1891,"101",1,1,2
"5098",1891,"102",1,2,3
"5099",1891,"103",1,0,1
"5100",1891,"104",0,0,0
"5101",1891,"105",0,0,0
"5102",1891,"106",0,0,0
"5103",1891,"107",0,0,0
"5104",1891,"108",0,0,0
"5105",1891,"109",0,0,0
"5106",1891,"110+",0,0,0
"5107",1892,"0",28313,29485,57798
"5108",1892,"1",26561,27599,54160
"5109",1892,"2",24680,25764,50444
"5110",1892,"3",24612,25635,50247
"5111",1892,"4",25111,26322,51433
"5112",1892,"5",24143,25225,49368
"5113",1892,"6",24152,25106,49258
"5114",1892,"7",23649,24529,48178
"5115",1892,"8",22954,23751,46705
"5116",1892,"9",21908,22823,44731
"5117",1892,"10",21042,21838,42880
"5118",1892,"11",21300,22033,43333
"5119",1892,"12",21927,22654,44581
"5120",1892,"13",21230,21760,42990
"5121",1892,"14",20816,21823,42639
"5122",1892,"15",20605,20881,41486
"5123",1892,"16",19754,20372,40126
"5124",1892,"17",19101,19316,38417
"5125",1892,"18",18195,17857,36052
"5126",1892,"19",17918,17075,34993
"5127",1892,"20",17187,15923,33110
"5128",1892,"21",16569,14597,31166
"5129",1892,"22",16172,13787,29959
"5130",1892,"23",15922,13440,29362
"5131",1892,"24",15860,12985,28845
"5132",1892,"25",16238,13167,29405
"5133",1892,"26",15978,12880,28858
"5134",1892,"27",15605,12550,28155
"5135",1892,"28",15573,12416,27989
"5136",1892,"29",14542,11825,26367
"5137",1892,"30",13569,10906,24475
"5138",1892,"31",13993,11520,25513
"5139",1892,"32",14122,11778,25900
"5140",1892,"33",13489,11257,24746
"5141",1892,"34",13073,11042,24115
"5142",1892,"35",12730,10938,23668
"5143",1892,"36",13165,11160,24325
"5144",1892,"37",13306,11350,24656
"5145",1892,"38",12247,10541,22788
"5146",1892,"39",11757,10054,21811
"5147",1892,"40",11623,10201,21824
"5148",1892,"41",11267,9816,21083
"5149",1892,"42",11193,9831,21024
"5150",1892,"43",10425,8956,19381
"5151",1892,"44",10302,8987,19289
"5152",1892,"45",10273,9074,19347
"5153",1892,"46",10307,8977,19284
"5154",1892,"47",9809,8626,18435
"5155",1892,"48",9541,8363,17904
"5156",1892,"49",9576,8485,18061
"5157",1892,"50",9156,8211,17367
"5158",1892,"51",8683,7561,16244
"5159",1892,"52",7971,7022,14993
"5160",1892,"53",7926,7067,14993
"5161",1892,"54",8051,7172,15223
"5162",1892,"55",8250,7296,15546
"5163",1892,"56",8709,7821,16530
"5164",1892,"57",8358,7592,15950
"5165",1892,"58",7738,7074,14812
"5166",1892,"59",7314,6730,14044
"5167",1892,"60",7309,6670,13979
"5168",1892,"61",7647,6805,14452
"5169",1892,"62",7638,6873,14511
"5170",1892,"63",7131,6379,13510
"5171",1892,"64",6824,6124,12948
"5172",1892,"65",7207,6563,13770
"5173",1892,"66",7073,6223,13296
"5174",1892,"67",6552,5729,12281
"5175",1892,"68",6258,5585,11843
"5176",1892,"69",5897,5277,11174
"5177",1892,"70",5686,5046,10732
"5178",1892,"71",5370,4703,10073
"5179",1892,"72",4695,4126,8821
"5180",1892,"73",4188,3660,7848
"5181",1892,"74",4014,3366,7380
"5182",1892,"75",4070,3355,7425
"5183",1892,"76",3434,2770,6204
"5184",1892,"77",2646,2105,4751
"5185",1892,"78",2411,1952,4363
"5186",1892,"79",2495,1945,4440
"5187",1892,"80",1914,1530,3444
"5188",1892,"81",1889,1403,3292
"5189",1892,"82",1271,960,2231
"5190",1892,"83",1246,882,2128
"5191",1892,"84",1141,788,1929
"5192",1892,"85",956,649,1605
"5193",1892,"86",862,554,1416
"5194",1892,"87",642,450,1092
"5195",1892,"88",585,323,908
"5196",1892,"89",407,240,647
"5197",1892,"90",310,186,496
"5198",1892,"91",255,157,412
"5199",1892,"92",161,118,279
"5200",1892,"93",126,68,194
"5201",1892,"94",75,51,126
"5202",1892,"95",59,26,85
"5203",1892,"96",54,23,77
"5204",1892,"97",20,11,31
"5205",1892,"98",12,9,21
"5206",1892,"99",10,4,14
"5207",1892,"100",4,2,6
"5208",1892,"101",5,0,5
"5209",1892,"102",0,1,1
"5210",1892,"103",0,1,1
"5211",1892,"104",0,0,0
"5212",1892,"105",0,0,0
"5213",1892,"106",0,0,0
"5214",1892,"107",0,0,0
"5215",1892,"108",0,0,0
"5216",1892,"109",0,0,0
"5217",1892,"110+",0,0,0
"5218",1893,"0",27031,28817,55848
"5219",1893,"1",26769,27649,54418
"5220",1893,"2",25820,26797,52617
"5221",1893,"3",24261,25335,49596
"5222",1893,"4",24263,25288,49551
"5223",1893,"5",24815,26006,50821
"5224",1893,"6",23884,24941,48825
"5225",1893,"7",23913,24825,48738
"5226",1893,"8",23431,24262,47693
"5227",1893,"9",22782,23555,46337
"5228",1893,"10",21773,22618,44391
"5229",1893,"11",20960,21705,42665
"5230",1893,"12",21141,21811,42952
"5231",1893,"13",21795,22451,44246
"5232",1893,"14",21097,21539,42636
"5233",1893,"15",20678,21584,42262
"5234",1893,"16",20426,20552,40978
"5235",1893,"17",19480,19854,39334
"5236",1893,"18",18734,18504,37238
"5237",1893,"19",17830,16920,34750
"5238",1893,"20",17431,16084,33515
"5239",1893,"21",16715,14935,31650
"5240",1893,"22",16180,13809,29989
"5241",1893,"23",15806,13209,29015
"5242",1893,"24",15550,12996,28546
"5243",1893,"25",15458,12611,28069
"5244",1893,"26",15883,12816,28699
"5245",1893,"27",15689,12597,28286
"5246",1893,"28",15329,12338,27667
"5247",1893,"29",15334,12236,27570
"5248",1893,"30",14257,11597,25854
"5249",1893,"31",13391,10782,24173
"5250",1893,"32",13794,11374,25168
"5251",1893,"33",13911,11635,25546
"5252",1893,"34",13254,11058,24312
"5253",1893,"35",12879,10899,23778
"5254",1893,"36",12565,10794,23359
"5255",1893,"37",13016,11033,24049
"5256",1893,"38",13146,11206,24352
"5257",1893,"39",12100,10417,22517
"5258",1893,"40",11566,9876,21442
"5259",1893,"41",11509,10094,21603
"5260",1893,"42",11150,9702,20852
"5261",1893,"43",11116,9746,20862
"5262",1893,"44",10312,8862,19174
"5263",1893,"45",10200,8881,19081
"5264",1893,"46",10148,8945,19093
"5265",1893,"47",10220,8887,19107
"5266",1893,"48",9700,8505,18205
"5267",1893,"49",9411,8244,17655
"5268",1893,"50",9355,8284,17639
"5269",1893,"51",9003,8090,17093
"5270",1893,"52",8500,7415,15915
"5271",1893,"53",7848,6905,14753
"5272",1893,"54",7777,6901,14678
"5273",1893,"55",7922,7029,14951
"5274",1893,"56",8111,7149,15260
"5275",1893,"57",8571,7678,16249
"5276",1893,"58",8238,7440,15678
"5277",1893,"59",7656,6956,14612
"5278",1893,"60",7151,6543,13694
"5279",1893,"61",7174,6509,13683
"5280",1893,"62",7456,6621,14077
"5281",1893,"63",7446,6707,14153
"5282",1893,"64",6925,6152,13077
"5283",1893,"65",6633,5901,12534
"5284",1893,"66",6976,6311,13287
"5285",1893,"67",6816,5988,12804
"5286",1893,"68",6295,5494,11789
"5287",1893,"69",6051,5367,11418
"5288",1893,"70",5599,4999,10598
"5289",1893,"71",5447,4833,10280
"5290",1893,"72",5062,4414,9476
"5291",1893,"73",4444,3867,8311
"5292",1893,"74",3935,3398,7333
"5293",1893,"75",3724,3135,6859
"5294",1893,"76",3767,3073,6840
"5295",1893,"77",3159,2537,5696
"5296",1893,"78",2429,1914,4343
"5297",1893,"79",2221,1757,3978
"5298",1893,"80",2341,1818,4159
"5299",1893,"81",1720,1342,3062
"5300",1893,"82",1662,1199,2861
"5301",1893,"83",1110,807,1917
"5302",1893,"84",1057,722,1779
"5303",1893,"85",941,636,1577
"5304",1893,"86",774,535,1309
"5305",1893,"87",669,431,1100
"5306",1893,"88",511,341,852
"5307",1893,"89",433,232,665
"5308",1893,"90",320,163,483
"5309",1893,"91",227,138,365
"5310",1893,"92",175,109,284
"5311",1893,"93",112,82,194
"5312",1893,"94",84,38,122
"5313",1893,"95",55,34,89
"5314",1893,"96",34,20,54
"5315",1893,"97",35,16,51
"5316",1893,"98",12,5,17
"5317",1893,"99",8,6,14
"5318",1893,"100",6,1,7
"5319",1893,"101",3,0,3
"5320",1893,"102",3,0,3
"5321",1893,"103",0,0,0
"5322",1893,"104",0,0,0
"5323",1893,"105",0,0,0
"5324",1893,"106",0,0,0
"5325",1893,"107",0,0,0
"5326",1893,"108",0,0,0
"5327",1893,"109",0,0,0
"5328",1893,"110+",0,0,0
"5329",1894,"0",28189,29703,57892
"5330",1894,"1",25794,27364,53158
"5331",1894,"2",26141,26993,53134
"5332",1894,"3",25383,26293,51676
"5333",1894,"4",23938,24983,48921
"5334",1894,"5",24025,25006,49031
"5335",1894,"6",24572,25723,50295
"5336",1894,"7",23666,24703,48369
"5337",1894,"8",23706,24579,48285
"5338",1894,"9",23222,24047,47269
"5339",1894,"10",22623,23372,45995
"5340",1894,"11",21660,22451,44111
"5341",1894,"12",20860,21581,42441
"5342",1894,"13",21002,21617,42619
"5343",1894,"14",21668,22269,43937
"5344",1894,"15",20924,21308,42232
"5345",1894,"16",20475,21158,41633
"5346",1894,"17",20127,19931,40058
"5347",1894,"18",19106,18969,38075
"5348",1894,"19",18338,17516,35854
"5349",1894,"20",17360,15895,33255
"5350",1894,"21",16929,15022,31951
"5351",1894,"22",16283,14114,30397
"5352",1894,"23",15711,13205,28916
"5353",1894,"24",15376,12689,28065
"5354",1894,"25",15131,12507,27638
"5355",1894,"26",15066,12218,27284
"5356",1894,"27",15532,12531,28063
"5357",1894,"28",15374,12336,27710
"5358",1894,"29",15061,12107,27168
"5359",1894,"30",15065,12011,27076
"5360",1894,"31",14009,11400,25409
"5361",1894,"32",13235,10647,23882
"5362",1894,"33",13548,11161,24709
"5363",1894,"34",13729,11489,25218
"5364",1894,"35",13010,10878,23888
"5365",1894,"36",12668,10748,23416
"5366",1894,"37",12421,10633,23054
"5367",1894,"38",12889,10888,23777
"5368",1894,"39",12986,11051,24037
"5369",1894,"40",11927,10246,22173
"5370",1894,"41",11405,9732,21137
"5371",1894,"42",11401,9980,21381
"5372",1894,"43",11013,9587,20600
"5373",1894,"44",11048,9650,20698
"5374",1894,"45",10192,8762,18954
"5375",1894,"46",10072,8803,18875
"5376",1894,"47",10047,8832,18879
"5377",1894,"48",10124,8782,18906
"5378",1894,"49",9606,8400,18006
"5379",1894,"50",9254,8122,17376
"5380",1894,"51",9140,8098,17238
"5381",1894,"52",8874,7966,16840
"5382",1894,"53",8324,7256,15580
"5383",1894,"54",7729,6780,14509
"5384",1894,"55",7597,6742,14339
"5385",1894,"56",7771,6891,14662
"5386",1894,"57",7984,7006,14990
"5387",1894,"58",8439,7524,15963
"5388",1894,"59",8132,7317,15449
"5389",1894,"60",7501,6811,14312
"5390",1894,"61",7030,6398,13428
"5391",1894,"62",7046,6359,13405
"5392",1894,"63",7274,6435,13709
"5393",1894,"64",7305,6537,13842
"5394",1894,"65",6744,5947,12691
"5395",1894,"66",6441,5705,12146
"5396",1894,"67",6739,6113,12852
"5397",1894,"68",6569,5769,12338
"5398",1894,"69",6085,5271,11356
"5399",1894,"70",5777,5119,10896
"5400",1894,"71",5403,4805,10208
"5401",1894,"72",5205,4613,9818
"5402",1894,"73",4809,4163,8972
"5403",1894,"74",4235,3639,7874
"5404",1894,"75",3673,3151,6824
"5405",1894,"76",3491,2918,6409
"5406",1894,"77",3507,2836,6343
"5407",1894,"78",2920,2311,5231
"5408",1894,"79",2252,1748,4000
"5409",1894,"80",1848,1403,3251
"5410",1894,"81",2107,1618,3725
"5411",1894,"82",1521,1189,2710
"5412",1894,"83",1477,1044,2521
"5413",1894,"84",964,688,1652
"5414",1894,"85",922,621,1543
"5415",1894,"86",787,512,1299
"5416",1894,"87",639,433,1072
"5417",1894,"88",528,336,864
"5418",1894,"89",395,261,656
"5419",1894,"90",346,171,517
"5420",1894,"91",245,119,364
"5421",1894,"92",167,95,262
"5422",1894,"93",128,72,200
"5423",1894,"94",86,63,149
"5424",1894,"95",60,20,80
"5425",1894,"96",38,27,65
"5426",1894,"97",24,11,35
"5427",1894,"98",22,11,33
"5428",1894,"99",7,4,11
"5429",1894,"100",3,3,6
"5430",1894,"101",5,0,5
"5431",1894,"102",2,0,2
"5432",1894,"103",2,0,2
"5433",1894,"104",0,0,0
"5434",1894,"105",0,0,0
"5435",1894,"106",0,0,0
"5436",1894,"107",0,0,0
"5437",1894,"108",0,0,0
"5438",1894,"109",0,0,0
"5439",1894,"110+",0,0,0
"5440",1895,"0",27712,28985,56697
"5441",1895,"1",26703,27930,54633
"5442",1895,"2",25094,26616,51710
"5443",1895,"3",25695,26552,52247
"5444",1895,"4",25041,25911,50952
"5445",1895,"5",23713,24746,48459
"5446",1895,"6",23874,24828,48702
"5447",1895,"7",24419,25553,49972
"5448",1895,"8",23499,24552,48051
"5449",1895,"9",23577,24435,48012
"5450",1895,"10",23104,23905,47009
"5451",1895,"11",22516,23226,45742
"5452",1895,"12",21574,22356,43930
"5453",1895,"13",20838,21514,42352
"5454",1895,"14",20903,21473,42376
"5455",1895,"15",21552,22093,43645
"5456",1895,"16",20785,21111,41896
"5457",1895,"17",20334,20880,41214
"5458",1895,"18",19967,19563,39530
"5459",1895,"19",18956,18582,37538
"5460",1895,"20",18193,17186,35379
"5461",1895,"21",17197,15605,32802
"5462",1895,"22",16762,14756,31518
"5463",1895,"23",16122,13970,30092
"5464",1895,"24",15524,13092,28616
"5465",1895,"25",15199,12586,27785
"5466",1895,"26",14943,12405,27348
"5467",1895,"27",14881,12138,27019
"5468",1895,"28",15368,12474,27842
"5469",1895,"29",15213,12280,27493
"5470",1895,"30",14872,12055,26927
"5471",1895,"31",14923,11954,26877
"5472",1895,"32",13863,11323,25186
"5473",1895,"33",13123,10626,23749
"5474",1895,"34",13367,11088,24455
"5475",1895,"35",13607,11453,25060
"5476",1895,"36",12830,10803,23633
"5477",1895,"37",12558,10674,23232
"5478",1895,"38",12304,10576,22880
"5479",1895,"39",12773,10830,23603
"5480",1895,"40",12836,10934,23770
"5481",1895,"41",11818,10161,21979
"5482",1895,"42",11305,9635,20940
"5483",1895,"43",11347,9953,21300
"5484",1895,"44",10913,9515,20428
"5485",1895,"45",10994,9614,20608
"5486",1895,"46",10094,8689,18783
"5487",1895,"47",9997,8737,18734
"5488",1895,"48",9953,8719,18672
"5489",1895,"49",10041,8731,18772
"5490",1895,"50",9485,8281,17766
"5491",1895,"51",9147,8039,17186
"5492",1895,"52",8962,7959,16921
"5493",1895,"53",8758,7855,16613
"5494",1895,"54",8179,7120,15299
"5495",1895,"55",7609,6665,14274
"5496",1895,"56",7443,6589,14032
"5497",1895,"57",7662,6781,14443
"5498",1895,"58",7860,6889,14749
"5499",1895,"59",8329,7396,15725
"5500",1895,"60",8005,7170,15175
"5501",1895,"61",7412,6705,14117
"5502",1895,"62",6900,6254,13154
"5503",1895,"63",6914,6218,13132
"5504",1895,"64",7097,6249,13346
"5505",1895,"65",7152,6352,13504
"5506",1895,"66",6551,5766,12317
"5507",1895,"67",6268,5526,11794
"5508",1895,"68",6512,5872,12384
"5509",1895,"69",6365,5563,11928
"5510",1895,"70",5814,5013,10827
"5511",1895,"71",5583,4927,10510
"5512",1895,"72",5186,4559,9745
"5513",1895,"73",4973,4368,9341
"5514",1895,"74",4525,3921,8446
"5515",1895,"75",4001,3421,7422
"5516",1895,"76",3450,2947,6397
"5517",1895,"77",3219,2687,5906
"5518",1895,"78",3234,2580,5814
"5519",1895,"79",2699,2128,4827
"5520",1895,"80",2131,1662,3793
"5521",1895,"81",1678,1253,2931
"5522",1895,"82",1899,1418,3317
"5523",1895,"83",1326,1007,2333
"5524",1895,"84",1277,882,2159
"5525",1895,"85",820,566,1386
"5526",1895,"86",778,513,1291
"5527",1895,"87",660,406,1066
"5528",1895,"88",515,342,857
"5529",1895,"89",395,253,648
"5530",1895,"90",315,192,507
"5531",1895,"91",263,128,391
"5532",1895,"92",181,86,267
"5533",1895,"93",115,60,175
"5534",1895,"94",93,43,136
"5535",1895,"95",55,38,93
"5536",1895,"96",43,11,54
"5537",1895,"97",18,21,39
"5538",1895,"98",16,6,22
"5539",1895,"99",13,5,18
"5540",1895,"100",4,2,6
"5541",1895,"101",2,3,5
"5542",1895,"102",3,0,3
"5543",1895,"103",1,0,1
"5544",1895,"104",1,0,1
"5545",1895,"105",0,0,0
"5546",1895,"106",0,0,0
"5547",1895,"107",0,0,0
"5548",1895,"108",0,0,0
"5549",1895,"109",0,0,0
"5550",1895,"110+",0,0,0
"5551",1896,"0",28839,30440,59279
"5552",1896,"1",26489,27496,53985
"5553",1896,"2",26174,27369,53543
"5554",1896,"3",24835,26293,51128
"5555",1896,"4",25455,26300,51755
"5556",1896,"5",24850,25731,50581
"5557",1896,"6",23594,24635,48229
"5558",1896,"7",23780,24736,48516
"5559",1896,"8",24346,25437,49783
"5560",1896,"9",23410,24453,47863
"5561",1896,"10",23483,24316,47799
"5562",1896,"11",22999,23798,46797
"5563",1896,"12",22418,23136,45554
"5564",1896,"13",21509,22273,43782
"5565",1896,"14",20795,21446,42241
"5566",1896,"15",20793,21320,42113
"5567",1896,"16",21419,21873,43292
"5568",1896,"17",20622,20808,41430
"5569",1896,"18",20159,20516,40675
"5570",1896,"19",19817,19114,38931
"5571",1896,"20",18786,18186,36972
"5572",1896,"21",17971,16820,34791
"5573",1896,"22",17034,15283,32317
"5574",1896,"23",16582,14549,31131
"5575",1896,"24",15973,13848,29821
"5576",1896,"25",15328,12982,28310
"5577",1896,"26",14990,12493,27483
"5578",1896,"27",14716,12316,27032
"5579",1896,"28",14685,12046,26731
"5580",1896,"29",15190,12407,27597
"5581",1896,"30",15034,12214,27248
"5582",1896,"31",14724,11979,26703
"5583",1896,"32",14770,11901,26671
"5584",1896,"33",13710,11235,24945
"5585",1896,"34",13010,10599,23609
"5586",1896,"35",13234,11019,24253
"5587",1896,"36",13479,11411,24890
"5588",1896,"37",12658,10716,23374
"5589",1896,"38",12452,10604,23056
"5590",1896,"39",12205,10526,22731
"5591",1896,"40",12647,10754,23401
"5592",1896,"41",12707,10853,23560
"5593",1896,"42",11698,10085,21783
"5594",1896,"43",11204,9540,20744
"5595",1896,"44",11284,9903,21187
"5596",1896,"45",10809,9411,20220
"5597",1896,"46",10949,9594,20543
"5598",1896,"47",10004,8595,18599
"5599",1896,"48",9919,8674,18593
"5600",1896,"49",9843,8615,18458
"5601",1896,"50",9953,8629,18582
"5602",1896,"51",9387,8189,17576
"5603",1896,"52",9057,7956,17013
"5604",1896,"53",8781,7802,16583
"5605",1896,"54",8625,7765,16390
"5606",1896,"55",8005,6993,14998
"5607",1896,"56",7507,6565,14072
"5608",1896,"57",7291,6454,13745
"5609",1896,"58",7530,6677,14207
"5610",1896,"59",7726,6751,14477
"5611",1896,"60",8164,7247,15411
"5612",1896,"61",7895,7040,14935
"5613",1896,"62",7322,6593,13915
"5614",1896,"63",6755,6121,12876
"5615",1896,"64",6783,6074,12857
"5616",1896,"65",6909,6042,12951
"5617",1896,"66",6965,6163,13128
"5618",1896,"67",6363,5566,11929
"5619",1896,"68",6069,5325,11394
"5620",1896,"69",6323,5662,11985
"5621",1896,"70",6089,5320,11409
"5622",1896,"71",5592,4783,10375
"5623",1896,"72",5341,4699,10040
"5624",1896,"73",4908,4326,9234
"5625",1896,"74",4748,4120,8868
"5626",1896,"75",4255,3687,7942
"5627",1896,"76",3803,3176,6979
"5628",1896,"77",3209,2728,5937
"5629",1896,"78",3002,2469,5471
"5630",1896,"79",2975,2343,5318
"5631",1896,"80",2384,1860,4244
"5632",1896,"81",1935,1497,3432
"5633",1896,"82",1482,1116,2598
"5634",1896,"83",1648,1199,2847
"5635",1896,"84",1147,861,2008
"5636",1896,"85",1088,751,1839
"5637",1896,"86",684,481,1165
"5638",1896,"87",664,417,1081
"5639",1896,"88",525,318,843
"5640",1896,"89",407,271,678
"5641",1896,"90",327,187,514
"5642",1896,"91",248,152,400
"5643",1896,"92",193,83,276
"5644",1896,"93",127,60,187
"5645",1896,"94",77,40,117
"5646",1896,"95",64,28,92
"5647",1896,"96",36,25,61
"5648",1896,"97",30,7,37
"5649",1896,"98",14,12,26
"5650",1896,"99",8,4,12
"5651",1896,"100",5,3,8
"5652",1896,"101",2,2,4
"5653",1896,"102",2,2,4
"5654",1896,"103",1,0,1
"5655",1896,"104",1,0,1
"5656",1896,"105",0,0,0
"5657",1896,"106",0,0,0
"5658",1896,"107",0,0,0
"5659",1896,"108",0,0,0
"5660",1896,"109",0,0,0
"5661",1896,"110+",0,0,0
"5662",1897,"0",28874,30131,59005
"5663",1897,"1",27634,28954,56588
"5664",1897,"2",26071,26984,53055
"5665",1897,"3",25933,27085,53018
"5666",1897,"4",24653,26060,50713
"5667",1897,"5",25299,26132,51431
"5668",1897,"6",24722,25579,50301
"5669",1897,"7",23518,24556,48074
"5670",1897,"8",23704,24680,48384
"5671",1897,"9",24270,25363,49633
"5672",1897,"10",23316,24343,47659
"5673",1897,"11",23415,24203,47618
"5674",1897,"12",22913,23693,46606
"5675",1897,"13",22343,23051,45394
"5676",1897,"14",21422,22188,43610
"5677",1897,"15",20747,21321,42068
"5678",1897,"16",20648,21030,41678
"5679",1897,"17",21230,21464,42694
"5680",1897,"18",20420,20275,40695
"5681",1897,"19",20014,19922,39936
"5682",1897,"20",19636,18568,38204
"5683",1897,"21",18648,17709,36357
"5684",1897,"22",17805,16430,34235
"5685",1897,"23",16924,15020,31944
"5686",1897,"24",16456,14343,30799
"5687",1897,"25",15824,13713,29537
"5688",1897,"26",15186,12881,28067
"5689",1897,"27",14831,12433,27264
"5690",1897,"28",14543,12217,26760
"5691",1897,"29",14554,11981,26535
"5692",1897,"30",14982,12364,27346
"5693",1897,"31",14930,12142,27072
"5694",1897,"32",14588,11932,26520
"5695",1897,"33",14640,11878,26518
"5696",1897,"34",13599,11192,24791
"5697",1897,"35",12915,10577,23492
"5698",1897,"36",13092,10938,24030
"5699",1897,"37",13375,11369,24744
"5700",1897,"38",12485,10630,23115
"5701",1897,"39",12345,10563,22908
"5702",1897,"40",12081,10443,22524
"5703",1897,"41",12543,10699,23242
"5704",1897,"42",12584,10778,23362
"5705",1897,"43",11588,10017,21605
"5706",1897,"44",11084,9446,20530
"5707",1897,"45",11230,9862,21092
"5708",1897,"46",10724,9330,20054
"5709",1897,"47",10903,9557,20460
"5710",1897,"48",9930,8530,18460
"5711",1897,"49",9858,8615,18473
"5712",1897,"50",9723,8522,18245
"5713",1897,"51",9881,8581,18462
"5714",1897,"52",9297,8115,17412
"5715",1897,"53",8941,7877,16818
"5716",1897,"54",8613,7653,16266
"5717",1897,"55",8519,7656,16175
"5718",1897,"56",7864,6847,14711
"5719",1897,"57",7404,6454,13858
"5720",1897,"58",7147,6285,13432
"5721",1897,"59",7421,6565,13986
"5722",1897,"60",7577,6610,14187
"5723",1897,"61",8047,7116,15163
"5724",1897,"62",7791,6921,14712
"5725",1897,"63",7192,6456,13648
"5726",1897,"64",6603,5977,12580
"5727",1897,"65",6656,5920,12576
"5728",1897,"66",6725,5836,12561
"5729",1897,"67",6789,6007,12796
"5730",1897,"68",6170,5362,11532
"5731",1897,"69",5902,5159,11061
"5732",1897,"70",6087,5418,11505
"5733",1897,"71",5872,5109,10981
"5734",1897,"72",5372,4575,9947
"5735",1897,"73",5086,4444,9530
"5736",1897,"74",4656,4066,8722
"5737",1897,"75",4489,3880,8369
"5738",1897,"76",3979,3414,7393
"5739",1897,"77",3565,2951,6516
"5740",1897,"78",2963,2483,5446
"5741",1897,"79",2788,2240,5028
"5742",1897,"80",2589,2107,4696
"5743",1897,"81",2173,1679,3852
"5744",1897,"82",1731,1307,3038
"5745",1897,"83",1314,974,2288
"5746",1897,"84",1418,1039,2457
"5747",1897,"85",996,720,1716
"5748",1897,"86",913,642,1555
"5749",1897,"87",570,392,962
"5750",1897,"88",532,311,843
"5751",1897,"89",425,247,672
"5752",1897,"90",324,202,526
"5753",1897,"91",253,136,389
"5754",1897,"92",193,113,306
"5755",1897,"93",137,55,192
"5756",1897,"94",92,37,129
"5757",1897,"95",58,25,83
"5758",1897,"96",46,23,69
"5759",1897,"97",20,19,39
"5760",1897,"98",22,5,27
"5761",1897,"99",10,7,17
"5762",1897,"100",6,3,9
"5763",1897,"101",4,3,7
"5764",1897,"102",1,1,2
"5765",1897,"103",2,1,3
"5766",1897,"104",1,0,1
"5767",1897,"105",0,0,0
"5768",1897,"106",0,0,0
"5769",1897,"107",0,0,0
"5770",1897,"108",0,0,0
"5771",1897,"109",0,0,0
"5772",1897,"110+",0,0,0
"5773",1898,"0",29611,30538,60149
"5774",1898,"1",27661,28721,56382
"5775",1898,"2",27267,28488,55755
"5776",1898,"3",25866,26752,52618
"5777",1898,"4",25771,26915,52686
"5778",1898,"5",24530,25910,50440
"5779",1898,"6",25187,26025,51212
"5780",1898,"7",24614,25445,50059
"5781",1898,"8",23464,24512,47976
"5782",1898,"9",23654,24638,48292
"5783",1898,"10",24192,25286,49478
"5784",1898,"11",23215,24248,47463
"5785",1898,"12",23332,24112,47444
"5786",1898,"13",22827,23593,46420
"5787",1898,"14",22267,22959,45226
"5788",1898,"15",21341,22082,43423
"5789",1898,"16",20666,21152,41818
"5790",1898,"17",20474,20683,41157
"5791",1898,"18",21070,21062,42132
"5792",1898,"19",20248,19798,40046
"5793",1898,"20",19837,19482,39319
"5794",1898,"21",19501,18180,37681
"5795",1898,"22",18536,17365,35901
"5796",1898,"23",17700,16175,33875
"5797",1898,"24",16834,14868,31702
"5798",1898,"25",16349,14216,30565
"5799",1898,"26",15742,13634,29376
"5800",1898,"27",15033,12832,27865
"5801",1898,"28",14713,12399,27112
"5802",1898,"29",14408,12159,26567
"5803",1898,"30",14389,11944,26333
"5804",1898,"31",14867,12342,27209
"5805",1898,"32",14813,12155,26968
"5806",1898,"33",14459,11935,26394
"5807",1898,"34",14510,11843,26353
"5808",1898,"35",13488,11151,24639
"5809",1898,"36",12834,10582,23416
"5810",1898,"37",12953,10879,23832
"5811",1898,"38",13253,11333,24586
"5812",1898,"39",12343,10545,22888
"5813",1898,"40",12237,10526,22763
"5814",1898,"41",11995,10395,22390
"5815",1898,"42",12427,10649,23076
"5816",1898,"43",12472,10699,23171
"5817",1898,"44",11497,9953,21450
"5818",1898,"45",10978,9367,20345
"5819",1898,"46",11174,9821,20995
"5820",1898,"47",10646,9257,19903
"5821",1898,"48",10864,9532,20396
"5822",1898,"49",9863,8467,18330
"5823",1898,"50",9755,8541,18296
"5824",1898,"51",9631,8430,18061
"5825",1898,"52",9793,8508,18301
"5826",1898,"53",9192,7997,17189
"5827",1898,"54",8853,7795,16648
"5828",1898,"55",8430,7512,15942
"5829",1898,"56",8399,7560,15959
"5830",1898,"57",7733,6719,14452
"5831",1898,"58",7291,6328,13619
"5832",1898,"59",7004,6148,13152
"5833",1898,"60",7269,6434,13703
"5834",1898,"61",7439,6484,13923
"5835",1898,"62",7901,6963,14864
"5836",1898,"63",7663,6763,14426
"5837",1898,"64",7054,6308,13362
"5838",1898,"65",6453,5828,12281
"5839",1898,"66",6501,5761,12262
"5840",1898,"67",6530,5644,12174
"5841",1898,"68",6624,5794,12418
"5842",1898,"69",5994,5159,11153
"5843",1898,"70",5690,4912,10602
"5844",1898,"71",5860,5193,11053
"5845",1898,"72",5625,4827,10452
"5846",1898,"73",5118,4338,9456
"5847",1898,"74",4829,4200,9029
"5848",1898,"75",4351,3809,8160
"5849",1898,"76",4232,3636,7868
"5850",1898,"77",3689,3138,6827
"5851",1898,"78",3304,2719,6023
"5852",1898,"79",2735,2255,4990
"5853",1898,"80",2445,1847,4292
"5854",1898,"81",2355,1890,4245
"5855",1898,"82",1922,1468,3390
"5856",1898,"83",1533,1137,2670
"5857",1898,"84",1154,820,1974
"5858",1898,"85",1207,859,2066
"5859",1898,"86",843,590,1433
"5860",1898,"87",772,519,1291
"5861",1898,"88",470,309,779
"5862",1898,"89",425,240,665
"5863",1898,"90",345,182,527
"5864",1898,"91",255,149,404
"5865",1898,"92",190,90,280
"5866",1898,"93",143,83,226
"5867",1898,"94",99,38,137
"5868",1898,"95",65,23,88
"5869",1898,"96",34,19,53
"5870",1898,"97",32,15,47
"5871",1898,"98",8,13,21
"5872",1898,"99",10,5,15
"5873",1898,"100",7,4,11
"5874",1898,"101",4,2,6
"5875",1898,"102",3,3,6
"5876",1898,"103",1,0,1
"5877",1898,"104",1,0,1
"5878",1898,"105",0,0,0
"5879",1898,"106",0,0,0
"5880",1898,"107",0,0,0
"5881",1898,"108",0,0,0
"5882",1898,"109",0,0,0
"5883",1898,"110+",0,0,0
"5884",1899,"0",30304,31581,61885
"5885",1899,"1",28490,29102,57592
"5886",1899,"2",27272,28302,55574
"5887",1899,"3",27039,28261,55300
"5888",1899,"4",25701,26560,52261
"5889",1899,"5",25636,26777,52413
"5890",1899,"6",24412,25823,50235
"5891",1899,"7",25083,25911,50994
"5892",1899,"8",24536,25364,49900
"5893",1899,"9",23426,24476,47902
"5894",1899,"10",23613,24594,48207
"5895",1899,"11",24129,25230,49359
"5896",1899,"12",23124,24169,47293
"5897",1899,"13",23273,24009,47282
"5898",1899,"14",22712,23497,46209
"5899",1899,"15",22165,22846,45011
"5900",1899,"16",21211,21923,43134
"5901",1899,"17",20544,20877,41421
"5902",1899,"18",20279,20245,40524
"5903",1899,"19",20912,20514,41426
"5904",1899,"20",20044,19299,39343
"5905",1899,"21",19722,18958,38680
"5906",1899,"22",19408,17765,37173
"5907",1899,"23",18437,17074,35511
"5908",1899,"24",17564,15971,33535
"5909",1899,"25",16752,14699,31451
"5910",1899,"26",16249,14094,30343
"5911",1899,"27",15651,13599,29250
"5912",1899,"28",14891,12807,27698
"5913",1899,"29",14595,12363,26958
"5914",1899,"30",14266,12108,26374
"5915",1899,"31",14270,11937,26207
"5916",1899,"32",14732,12339,27071
"5917",1899,"33",14707,12162,26869
"5918",1899,"34",14341,11956,26297
"5919",1899,"35",14384,11856,26240
"5920",1899,"36",13387,11078,24465
"5921",1899,"37",12751,10584,23335
"5922",1899,"38",12820,10807,23627
"5923",1899,"39",13158,11326,24484
"5924",1899,"40",12167,10447,22614
"5925",1899,"41",12137,10484,22621
"5926",1899,"42",11879,10342,22221
"5927",1899,"43",12341,10603,22944
"5928",1899,"44",12374,10621,22995
"5929",1899,"45",11393,9886,21279
"5930",1899,"46",10872,9294,20166
"5931",1899,"47",11119,9779,20898
"5932",1899,"48",10568,9199,19767
"5933",1899,"49",10820,9492,20312
"5934",1899,"50",9781,8377,18158
"5935",1899,"51",9692,8478,18170
"5936",1899,"52",9524,8334,17858
"5937",1899,"53",9716,8448,18164
"5938",1899,"54",9094,7897,16991
"5939",1899,"55",8752,7714,16466
"5940",1899,"56",8248,7347,15595
"5941",1899,"57",8279,7448,15727
"5942",1899,"58",7578,6570,14148
"5943",1899,"59",7178,6220,13398
"5944",1899,"60",6805,5995,12800
"5945",1899,"61",7157,6318,13475
"5946",1899,"62",7310,6350,13660
"5947",1899,"63",7757,6776,14533
"5948",1899,"64",7536,6611,14147
"5949",1899,"65",6920,6157,13077
"5950",1899,"66",6278,5667,11945
"5951",1899,"67",6327,5571,11898
"5952",1899,"68",6328,5453,11781
"5953",1899,"69",6435,5614,12049
"5954",1899,"70",5697,4902,10599
"5955",1899,"71",5502,4749,10251
"5956",1899,"72",5580,4932,10512
"5957",1899,"73",5352,4533,9885
"5958",1899,"74",4827,4083,8910
"5959",1899,"75",4556,3940,8496
"5960",1899,"76",4077,3549,7626
"5961",1899,"77",3963,3401,7364
"5962",1899,"78",3391,2857,6248
"5963",1899,"79",3068,2506,5574
"5964",1899,"80",2711,2108,4819
"5965",1899,"81",2230,1658,3888
"5966",1899,"82",2137,1641,3778
"5967",1899,"83",1705,1263,2968
"5968",1899,"84",1331,977,2308
"5969",1899,"85",990,695,1685
"5970",1899,"86",1028,727,1755
"5971",1899,"87",690,472,1162
"5972",1899,"88",640,413,1053
"5973",1899,"89",379,225,604
"5974",1899,"90",332,179,511
"5975",1899,"91",257,136,393
"5976",1899,"92",198,104,302
"5977",1899,"93",138,66,204
"5978",1899,"94",95,50,145
"5979",1899,"95",64,25,89
"5980",1899,"96",42,14,56
"5981",1899,"97",20,9,29
"5982",1899,"98",26,10,36
"5983",1899,"99",5,7,12
"5984",1899,"100",4,2,6
"5985",1899,"101",6,1,7
"5986",1899,"102",0,0,0
"5987",1899,"103",1,2,3
"5988",1899,"104",1,0,1
"5989",1899,"105",1,0,1
"5990",1899,"106",0,0,0
"5991",1899,"107",0,0,0
"5992",1899,"108",0,0,0
"5993",1899,"109",0,0,0
"5994",1899,"110+",0,0,0
"5995",1900,"0",30070,31405,61475
"5996",1900,"1",28960,29887,58847
"5997",1900,"2",28043,28592,56635
"5998",1900,"3",27019,28032,55051
"5999",1900,"4",26854,28038,54892
"6000",1900,"5",25569,26419,51988
"6001",1900,"6",25534,26652,52186
"6002",1900,"7",24314,25740,50054
"6003",1900,"8",24979,25829,50808
"6004",1900,"9",24428,25263,49691
"6005",1900,"10",23375,24441,47816
"6006",1900,"11",23572,24556,48128
"6007",1900,"12",24047,25155,49202
"6008",1900,"13",23026,24071,47097
"6009",1900,"14",23176,23896,47072
"6010",1900,"15",22576,23338,45914
"6011",1900,"16",22008,22580,44588
"6012",1900,"17",21039,21592,42631
"6013",1900,"18",20396,20437,40833
"6014",1900,"19",20069,19642,39711
"6015",1900,"20",20690,19850,40540
"6016",1900,"21",19845,18679,38524
"6017",1900,"22",19583,18415,37998
"6018",1900,"23",19267,17379,36646
"6019",1900,"24",18308,16747,35055
"6020",1900,"25",17434,15740,33174
"6021",1900,"26",16679,14502,31181
"6022",1900,"27",16106,13927,30033
"6023",1900,"28",15539,13533,29072
"6024",1900,"29",14747,12760,27507
"6025",1900,"30",14422,12313,26735
"6026",1900,"31",14109,12031,26140
"6027",1900,"32",14106,11885,25991
"6028",1900,"33",14579,12342,26921
"6029",1900,"34",14569,12159,26728
"6030",1900,"35",14213,11917,26130
"6031",1900,"36",14230,11820,26050
"6032",1900,"37",13252,11016,24268
"6033",1900,"38",12641,10550,23191
"6034",1900,"39",12690,10764,23454
"6035",1900,"40",13019,11300,24319
"6036",1900,"41",12003,10378,22381
"6037",1900,"42",12013,10392,22405
"6038",1900,"43",11768,10273,22041
"6039",1900,"44",12233,10522,22755
"6040",1900,"45",12246,10533,22779
"6041",1900,"46",11298,9809,21107
"6042",1900,"47",10748,9209,19957
"6043",1900,"48",11062,9738,20800
"6044",1900,"49",10474,9106,19580
"6045",1900,"50",10739,9417,20156
"6046",1900,"51",9694,8306,18000
"6047",1900,"52",9608,8386,17994
"6048",1900,"53",9415,8212,17627
"6049",1900,"54",9631,8337,17968
"6050",1900,"55",8957,7782,16739
"6051",1900,"56",8641,7630,16271
"6052",1900,"57",8050,7162,15212
"6053",1900,"58",8143,7352,15495
"6054",1900,"59",7415,6422,13837
"6055",1900,"60",7024,6082,13106
"6056",1900,"61",6635,5849,12484
"6057",1900,"62",7020,6173,13193
"6058",1900,"63",7139,6177,13316
"6059",1900,"64",7570,6591,14161
"6060",1900,"65",7382,6468,13850
"6061",1900,"66",6743,5994,12737
"6062",1900,"67",6119,5477,11596
"6063",1900,"68",6138,5366,11504
"6064",1900,"69",6113,5242,11355
"6065",1900,"70",6177,5340,11517
"6066",1900,"71",5442,4689,10131
"6067",1900,"72",5250,4521,9771
"6068",1900,"73",5300,4668,9968
"6069",1900,"74",5035,4244,9279
"6070",1900,"75",4503,3790,8293
"6071",1900,"76",4258,3646,7904
"6072",1900,"77",3754,3207,6961
"6073",1900,"78",3659,3123,6782
"6074",1900,"79",3103,2612,5715
"6075",1900,"80",2555,2121,4676
"6076",1900,"81",2425,1866,4291
"6077",1900,"82",1960,1414,3374
"6078",1900,"83",1881,1396,3277
"6079",1900,"84",1437,1054,2491
"6080",1900,"85",1120,826,1946
"6081",1900,"86",833,587,1420
"6082",1900,"87",858,579,1437
"6083",1900,"88",523,345,868
"6084",1900,"89",518,308,826
"6085",1900,"90",300,171,471
"6086",1900,"91",251,127,378
"6087",1900,"92",186,98,284
"6088",1900,"93",138,69,207
"6089",1900,"94",94,41,135
"6090",1900,"95",61,34,95
"6091",1900,"96",44,18,62
"6092",1900,"97",21,9,30
"6093",1900,"98",9,7,16
"6094",1900,"99",14,8,22
"6095",1900,"100",2,3,5
"6096",1900,"101",3,1,4
"6097",1900,"102",3,1,4
"6098",1900,"103",0,0,0
"6099",1900,"104",1,1,2
"6100",1900,"105",0,0,0
"6101",1900,"106",0,0,0
"6102",1900,"107",0,0,0
"6103",1900,"108",0,0,0
"6104",1900,"109",0,0,0
"6105",1900,"110+",0,0,0
"6106",1901,"0",30653,31976,62629
"6107",1901,"1",28949,30016,58965
"6108",1901,"2",28588,29408,57996
"6109",1901,"3",27819,28324,56143
"6110",1901,"4",26856,27840,54696
"6111",1901,"5",26702,27883,54585
"6112",1901,"6",25452,26301,51753
"6113",1901,"7",25437,26546,51983
"6114",1901,"8",24217,25635,49852
"6115",1901,"9",24875,25742,50617
"6116",1901,"10",24331,25150,49481
"6117",1901,"11",23337,24382,47719
"6118",1901,"12",23511,24507,48018
"6119",1901,"13",23953,25066,49019
"6120",1901,"14",22903,23949,46852
"6121",1901,"15",23012,23710,46722
"6122",1901,"16",22339,23031,45370
"6123",1901,"17",21717,22075,43792
"6124",1901,"18",20729,20909,41638
"6125",1901,"19",20144,19643,39787
"6126",1901,"20",19703,18712,38415
"6127",1901,"21",20392,18978,39370
"6128",1901,"22",19574,17900,37474
"6129",1901,"23",19330,17836,37166
"6130",1901,"24",19075,16912,35987
"6131",1901,"25",18070,16339,34409
"6132",1901,"26",17248,15425,32673
"6133",1901,"27",16506,14244,30750
"6134",1901,"28",15939,13740,29679
"6135",1901,"29",15400,13450,28850
"6136",1901,"30",14553,12622,27175
"6137",1901,"31",14274,12244,26518
"6138",1901,"32",13916,11946,25862
"6139",1901,"33",13964,11810,25774
"6140",1901,"34",14439,12303,26742
"6141",1901,"35",14423,12119,26542
"6142",1901,"36",14072,11856,25928
"6143",1901,"37",14091,11761,25852
"6144",1901,"38",13127,10931,24058
"6145",1901,"39",12540,10512,23052
"6146",1901,"40",12520,10679,23199
"6147",1901,"41",12909,11258,24167
"6148",1901,"42",11849,10282,22131
"6149",1901,"43",11893,10338,22231
"6150",1901,"44",11660,10191,21851
"6151",1901,"45",12107,10450,22557
"6152",1901,"46",12107,10431,22538
"6153",1901,"47",11197,9725,20922
"6154",1901,"48",10640,9109,19749
"6155",1901,"49",10997,9673,20670
"6156",1901,"50",10326,8995,19321
"6157",1901,"51",10659,9368,20027
"6158",1901,"52",9588,8231,17819
"6159",1901,"53",9523,8303,17826
"6160",1901,"54",9287,8090,17377
"6161",1901,"55",9527,8224,17751
"6162",1901,"56",8829,7660,16489
"6163",1901,"57",8521,7512,16033
"6164",1901,"58",7845,6986,14831
"6165",1901,"59",8010,7220,15230
"6166",1901,"60",7222,6239,13461
"6167",1901,"61",6874,5962,12836
"6168",1901,"62",6466,5685,12151
"6169",1901,"63",6843,6017,12860
"6170",1901,"64",6963,6020,12983
"6171",1901,"65",7391,6401,13792
"6172",1901,"66",7188,6299,13487
"6173",1901,"67",6582,5818,12400
"6174",1901,"68",5918,5283,11201
"6175",1901,"69",5963,5163,11126
"6176",1901,"70",5850,4982,10832
"6177",1901,"71",5947,5119,11066
"6178",1901,"72",5161,4453,9614
"6179",1901,"73",4997,4245,9242
"6180",1901,"74",5027,4385,9412
"6181",1901,"75",4682,3932,8614
"6182",1901,"76",4176,3503,7679
"6183",1901,"77",3946,3329,7275
"6184",1901,"78",3431,2920,6351
"6185",1901,"79",3408,2838,6246
"6186",1901,"80",3138,2528,5666
"6187",1901,"81",2260,1870,4130
"6188",1901,"82",2108,1619,3727
"6189",1901,"83",1718,1229,2947
"6190",1901,"84",1602,1170,2772
"6191",1901,"85",1223,876,2099
"6192",1901,"86",926,648,1574
"6193",1901,"87",694,470,1164
"6194",1901,"88",664,417,1081
"6195",1901,"89",406,248,654
"6196",1901,"90",400,233,633
"6197",1901,"91",237,119,356
"6198",1901,"92",176,87,263
"6199",1901,"93",132,66,198
"6200",1901,"94",96,49,145
"6201",1901,"95",65,24,89
"6202",1901,"96",39,19,58
"6203",1901,"97",24,12,36
"6204",1901,"98",13,5,18
"6205",1901,"99",7,3,10
"6206",1901,"100",10,5,15
"6207",1901,"101",2,1,3
"6208",1901,"102",1,1,2
"6209",1901,"103",0,1,1
"6210",1901,"104",0,0,0
"6211",1901,"105",0,0,0
"6212",1901,"106",0,0,0
"6213",1901,"107",0,0,0
"6214",1901,"108",0,0,0
"6215",1901,"109",0,0,0
"6216",1901,"110+",0,0,0
"6217",1902,"0",30891,32143,63034
"6218",1902,"1",29309,30433,59742
"6219",1902,"2",28482,29544,58026
"6220",1902,"3",28331,29117,57448
"6221",1902,"4",27581,28092,55673
"6222",1902,"5",26714,27691,54405
"6223",1902,"6",26581,27742,54323
"6224",1902,"7",25359,26199,51558
"6225",1902,"8",25385,26438,51823
"6226",1902,"9",24162,25534,49696
"6227",1902,"10",24814,25691,50505
"6228",1902,"11",24185,25023,49208
"6229",1902,"12",23262,24304,47566
"6230",1902,"13",23426,24447,47873
"6231",1902,"14",23859,24981,48840
"6232",1902,"15",22778,23869,46647
"6233",1902,"16",22811,23482,46293
"6234",1902,"17",22102,22586,44688
"6235",1902,"18",21370,21382,42752
"6236",1902,"19",20360,20041,40401
"6237",1902,"20",19733,18819,38552
"6238",1902,"21",19376,17876,37252
"6239",1902,"22",20000,18273,38273
"6240",1902,"23",19215,17286,36501
"6241",1902,"24",18989,17283,36272
"6242",1902,"25",18704,16447,35151
"6243",1902,"26",17787,15946,33733
"6244",1902,"27",16990,15129,32119
"6245",1902,"28",16268,13989,30257
"6246",1902,"29",15753,13548,29301
"6247",1902,"30",15185,13268,28453
"6248",1902,"31",14403,12485,26888
"6249",1902,"32",14140,12121,26261
"6250",1902,"33",13779,11824,25603
"6251",1902,"34",13814,11701,25515
"6252",1902,"35",14281,12198,26479
"6253",1902,"36",14291,11977,26268
"6254",1902,"37",13938,11757,25695
"6255",1902,"38",13947,11651,25598
"6256",1902,"39",13008,10827,23835
"6257",1902,"40",12410,10385,22795
"6258",1902,"41",12427,10580,23007
"6259",1902,"42",12809,11162,23971
"6260",1902,"43",11775,10204,21979
"6261",1902,"44",11797,10250,22047
"6262",1902,"45",11555,10084,21639
"6263",1902,"46",11995,10338,22333
"6264",1902,"47",12013,10337,22350
"6265",1902,"48",11102,9622,20724
"6266",1902,"49",10503,8988,19491
"6267",1902,"50",10839,9537,20376
"6268",1902,"51",10185,8882,19067
"6269",1902,"52",10514,9228,19742
"6270",1902,"53",9452,8116,17568
"6271",1902,"54",9375,8150,17525
"6272",1902,"55",9153,7945,17098
"6273",1902,"56",9370,8061,17431
"6274",1902,"57",8697,7529,16226
"6275",1902,"58",8409,7388,15797
"6276",1902,"59",7759,6868,14627
"6277",1902,"60",7874,7065,14939
"6278",1902,"61",7115,6145,13260
"6279",1902,"62",6744,5822,12566
"6280",1902,"63",6353,5567,11920
"6281",1902,"64",6710,5876,12586
"6282",1902,"65",6800,5848,12648
"6283",1902,"66",7199,6227,13426
"6284",1902,"67",6985,6072,13057
"6285",1902,"68",6396,5644,12040
"6286",1902,"69",5741,5104,10845
"6287",1902,"70",5718,4957,10675
"6288",1902,"71",5644,4790,10434
"6289",1902,"72",5714,4862,10576
"6290",1902,"73",4929,4213,9142
"6291",1902,"74",4726,4004,8730
"6292",1902,"75",4743,4126,8869
"6293",1902,"76",4375,3637,8012
"6294",1902,"77",3883,3214,7097
"6295",1902,"78",3612,3056,6668
"6296",1902,"79",3147,2635,5782
"6297",1902,"80",2861,2354,5215
"6298",1902,"81",2861,2275,5136
"6299",1902,"82",1998,1631,3629
"6300",1902,"83",1865,1407,3272
"6301",1902,"84",1465,1009,2474
"6302",1902,"85",1370,983,2353
"6303",1902,"86",1028,718,1746
"6304",1902,"87",769,522,1291
"6305",1902,"88",565,373,938
"6306",1902,"89",518,307,825
"6307",1902,"90",313,194,507
"6308",1902,"91",309,179,488
"6309",1902,"92",159,73,232
"6310",1902,"93",135,67,202
"6311",1902,"94",87,44,131
"6312",1902,"95",67,33,100
"6313",1902,"96",47,18,65
"6314",1902,"97",24,6,30
"6315",1902,"98",16,8,24
"6316",1902,"99",9,3,12
"6317",1902,"100",5,2,7
"6318",1902,"101",2,4,6
"6319",1902,"102",0,0,0
"6320",1902,"103",0,1,1
"6321",1902,"104",0,0,0
"6322",1902,"105",0,0,0
"6323",1902,"106",0,0,0
"6324",1902,"107",0,0,0
"6325",1902,"108",0,0,0
"6326",1902,"109",0,0,0
"6327",1902,"110+",0,0,0
"6328",1903,"0",30791,32141,62932
"6329",1903,"1",29711,30751,60462
"6330",1903,"2",28865,29911,58776
"6331",1903,"3",28186,29224,57410
"6332",1903,"4",28049,28842,56891
"6333",1903,"5",27412,27949,55361
"6334",1903,"6",26597,27539,54136
"6335",1903,"7",26445,27588,54033
"6336",1903,"8",25273,26064,51337
"6337",1903,"9",25288,26339,51627
"6338",1903,"10",24064,25411,49475
"6339",1903,"11",24700,25566,50266
"6340",1903,"12",24099,24939,49038
"6341",1903,"13",23181,24216,47397
"6342",1903,"14",23317,24341,47658
"6343",1903,"15",23706,24786,48492
"6344",1903,"16",22518,23473,45991
"6345",1903,"17",22437,22756,45193
"6346",1903,"18",21663,21548,43211
"6347",1903,"19",20884,20133,41017
"6348",1903,"20",19858,18732,38590
"6349",1903,"21",19292,17617,36909
"6350",1903,"22",18902,16850,35752
"6351",1903,"23",19591,17420,37011
"6352",1903,"24",18770,16533,35303
"6353",1903,"25",18547,16593,35140
"6354",1903,"26",18356,15828,34184
"6355",1903,"27",17444,15465,32909
"6356",1903,"28",16678,14721,31399
"6357",1903,"29",15999,13674,29673
"6358",1903,"30",15488,13276,28764
"6359",1903,"31",14977,12991,27968
"6360",1903,"32",14187,12232,26419
"6361",1903,"33",13973,11902,25875
"6362",1903,"34",13616,11655,25271
"6363",1903,"35",13645,11529,25174
"6364",1903,"36",14110,12009,26119
"6365",1903,"37",14152,11796,25948
"6366",1903,"38",13782,11608,25390
"6367",1903,"39",13808,11503,25311
"6368",1903,"40",12866,10692,23558
"6369",1903,"41",12295,10266,22561
"6370",1903,"42",12307,10454,22761
"6371",1903,"43",12689,11040,23729
"6372",1903,"44",11696,10124,21820
"6373",1903,"45",11679,10107,21786
"6374",1903,"46",11455,10008,21463
"6375",1903,"47",11901,10242,22143
"6376",1903,"48",11896,10220,22116
"6377",1903,"49",10975,9501,20476
"6378",1903,"50",10371,8856,19227
"6379",1903,"51",10701,9392,20093
"6380",1903,"52",10035,8737,18772
"6381",1903,"53",10356,9072,19428
"6382",1903,"54",9309,7985,17294
"6383",1903,"55",9231,8012,17243
"6384",1903,"56",8979,7832,16811
"6385",1903,"57",9212,7946,17158
"6386",1903,"58",8556,7415,15971
"6387",1903,"59",8290,7245,15535
"6388",1903,"60",7644,6749,14393
"6389",1903,"61",7756,6919,14675
"6390",1903,"62",6988,6002,12990
"6391",1903,"63",6597,5700,12297
"6392",1903,"64",6208,5417,11625
"6393",1903,"65",6554,5741,12295
"6394",1903,"66",6621,5681,12302
"6395",1903,"67",6984,6046,13030
"6396",1903,"68",6765,5838,12603
"6397",1903,"69",6191,5423,11614
"6398",1903,"70",5564,4914,10478
"6399",1903,"71",5519,4778,10297
"6400",1903,"72",5402,4567,9969
"6401",1903,"73",5455,4655,10110
"6402",1903,"74",4703,3976,8679
"6403",1903,"75",4464,3770,8234
"6404",1903,"76",4470,3839,8309
"6405",1903,"77",4080,3371,7451
"6406",1903,"78",3572,2948,6520
"6407",1903,"79",3325,2788,6113
"6408",1903,"80",3013,2536,5549
"6409",1903,"81",2557,2096,4653
"6410",1903,"82",2573,2030,4603
"6411",1903,"83",1759,1414,3173
"6412",1903,"84",1638,1201,2839
"6413",1903,"85",1264,861,2125
"6414",1903,"86",1156,826,1982
"6415",1903,"87",848,585,1433
"6416",1903,"88",645,421,1066
"6417",1903,"89",434,266,700
"6418",1903,"90",439,252,691
"6419",1903,"91",241,144,385
"6420",1903,"92",237,130,367
"6421",1903,"93",121,49,170
"6422",1903,"94",88,37,125
"6423",1903,"95",60,29,89
"6424",1903,"96",48,19,67
"6425",1903,"97",26,12,38
"6426",1903,"98",17,2,19
"6427",1903,"99",10,4,14
"6428",1903,"100",8,3,11
"6429",1903,"101",3,1,4
"6430",1903,"102",1,2,3
"6431",1903,"103",0,0,0
"6432",1903,"104",0,0,0
"6433",1903,"105",0,0,0
"6434",1903,"106",0,0,0
"6435",1903,"107",0,0,0
"6436",1903,"108",0,0,0
"6437",1903,"109",0,0,0
"6438",1903,"110+",0,0,0
"6439",1904,"0",30330,31481,61811
"6440",1904,"1",29481,30701,60182
"6441",1904,"2",29132,30098,59230
"6442",1904,"3",28408,29450,57858
"6443",1904,"4",27854,28832,56686
"6444",1904,"5",27798,28558,56356
"6445",1904,"6",27229,27773,55002
"6446",1904,"7",26425,27347,53772
"6447",1904,"8",26271,27369,53640
"6448",1904,"9",25120,25888,51008
"6449",1904,"10",25150,26162,51312
"6450",1904,"11",23908,25231,49139
"6451",1904,"12",24604,25477,50081
"6452",1904,"13",23983,24827,48810
"6453",1904,"14",23045,24058,47103
"6454",1904,"15",23076,24084,47160
"6455",1904,"16",23356,24259,47615
"6456",1904,"17",22046,22604,44650
"6457",1904,"18",21818,21534,43352
"6458",1904,"19",21093,20056,41149
"6459",1904,"20",20251,18651,38902
"6460",1904,"21",19274,17298,36572
"6461",1904,"22",18744,16375,35119
"6462",1904,"23",18373,15909,34282
"6463",1904,"24",19002,16429,35431
"6464",1904,"25",18254,15655,33909
"6465",1904,"26",18060,15811,33871
"6466",1904,"27",17902,15166,33068
"6467",1904,"28",17016,14882,31898
"6468",1904,"29",16313,14245,30558
"6469",1904,"30",15672,13302,28974
"6470",1904,"31",15200,12942,28142
"6471",1904,"32",14701,12674,27375
"6472",1904,"33",13942,11933,25875
"6473",1904,"34",13782,11682,25464
"6474",1904,"35",13405,11433,24838
"6475",1904,"36",13441,11309,24750
"6476",1904,"37",13920,11770,25690
"6477",1904,"38",13973,11604,25577
"6478",1904,"39",13612,11421,25033
"6479",1904,"40",13617,11306,24923
"6480",1904,"41",12707,10532,23239
"6481",1904,"42",12141,10118,22259
"6482",1904,"43",12185,10329,22514
"6483",1904,"44",12583,10905,23488
"6484",1904,"45",11590,9998,21588
"6485",1904,"46",11579,9980,21559
"6486",1904,"47",11354,9877,21231
"6487",1904,"48",11786,10119,21905
"6488",1904,"49",11784,10087,21871
"6489",1904,"50",10812,9343,20155
"6490",1904,"51",10211,8690,18901
"6491",1904,"52",10536,9240,19776
"6492",1904,"53",9867,8590,18457
"6493",1904,"54",10188,8913,19101
"6494",1904,"55",9151,7879,17030
"6495",1904,"56",9092,7873,16965
"6496",1904,"57",8838,7698,16536
"6497",1904,"58",9050,7787,16837
"6498",1904,"59",8416,7262,15678
"6499",1904,"60",8142,7085,15227
"6500",1904,"61",7537,6618,14155
"6501",1904,"62",7613,6771,14384
"6502",1904,"63",6850,5838,12688
"6503",1904,"64",6445,5555,12000
"6504",1904,"65",6080,5262,11342
"6505",1904,"66",6386,5558,11944
"6506",1904,"67",6431,5490,11921
"6507",1904,"68",6758,5817,12575
"6508",1904,"69",6511,5565,12076
"6509",1904,"70",5961,5191,11152
"6510",1904,"71",5366,4698,10064
"6511",1904,"72",5294,4560,9854
"6512",1904,"73",5145,4284,9429
"6513",1904,"74",5176,4397,9573
"6514",1904,"75",4431,3714,8145
"6515",1904,"76",4184,3488,7672
"6516",1904,"77",4158,3550,7708
"6517",1904,"78",3769,3092,6861
"6518",1904,"79",3286,2676,5962
"6519",1904,"80",2968,2305,5273
"6520",1904,"81",2728,2279,5007
"6521",1904,"82",2272,1795,4067
"6522",1904,"83",2287,1759,4046
"6523",1904,"84",1488,1180,2668
"6524",1904,"85",1385,1007,2392
"6525",1904,"86",1053,721,1774
"6526",1904,"87",959,677,1636
"6527",1904,"88",656,470,1126
"6528",1904,"89",502,332,834
"6529",1904,"90",337,196,533
"6530",1904,"91",352,187,539
"6531",1904,"92",187,110,297
"6532",1904,"93",168,100,268
"6533",1904,"94",90,33,123
"6534",1904,"95",64,22,86
"6535",1904,"96",32,14,46
"6536",1904,"97",27,12,39
"6537",1904,"98",18,8,26
"6538",1904,"99",8,2,10
"6539",1904,"100",4,2,6
"6540",1904,"101",3,1,4
"6541",1904,"102",1,1,2
"6542",1904,"103",0,1,1
"6543",1904,"104",0,0,0
"6544",1904,"105",0,0,0
"6545",1904,"106",0,0,0
"6546",1904,"107",0,0,0
"6547",1904,"108",0,0,0
"6548",1904,"109",0,0,0
"6549",1904,"110+",0,0,0
"6550",1905,"0",29750,30878,60628
"6551",1905,"1",29179,30164,59343
"6552",1905,"2",28945,30172,59117
"6553",1905,"3",28777,29720,58497
"6554",1905,"4",28069,29056,57125
"6555",1905,"5",27640,28594,56234
"6556",1905,"6",27563,28348,55911
"6557",1905,"7",27039,27572,54611
"6558",1905,"8",26263,27148,53411
"6559",1905,"9",26101,27163,53264
"6560",1905,"10",24995,25730,50725
"6561",1905,"11",24997,25972,50969
"6562",1905,"12",23800,25129,48929
"6563",1905,"13",24524,25409,49933
"6564",1905,"14",23814,24679,48493
"6565",1905,"15",22821,23786,46607
"6566",1905,"16",22711,23588,46299
"6567",1905,"17",22886,23470,46356
"6568",1905,"18",21523,21641,43164
"6569",1905,"19",21271,20443,41714
"6570",1905,"20",20484,18983,39467
"6571",1905,"21",19745,17624,37369
"6572",1905,"22",18771,16424,35195
"6573",1905,"23",18314,15728,34042
"6574",1905,"24",17928,15290,33218
"6575",1905,"25",18529,15856,34385
"6576",1905,"26",17830,15183,33013
"6577",1905,"27",17640,15372,33012
"6578",1905,"28",17469,14828,32297
"6579",1905,"29",16682,14581,31263
"6580",1905,"30",15998,13908,29906
"6581",1905,"31",15388,13059,28447
"6582",1905,"32",14931,12716,27647
"6583",1905,"33",14427,12464,26891
"6584",1905,"34",13740,11760,25500
"6585",1905,"35",13596,11541,25137
"6586",1905,"36",13224,11268,24492
"6587",1905,"37",13245,11160,24405
"6588",1905,"38",13739,11604,25343
"6589",1905,"39",13809,11467,25276
"6590",1905,"40",13443,11266,24709
"6591",1905,"41",13466,11195,24661
"6592",1905,"42",12548,10391,22939
"6593",1905,"43",12001,9987,21988
"6594",1905,"44",12069,10220,22289
"6595",1905,"45",12464,10792,23256
"6596",1905,"46",11491,9903,21394
"6597",1905,"47",11462,9880,21342
"6598",1905,"48",11248,9770,21018
"6599",1905,"49",11662,9994,21656
"6600",1905,"50",11629,9962,21591
"6601",1905,"51",10653,9229,19882
"6602",1905,"52",10063,8570,18633
"6603",1905,"53",10374,9087,19461
"6604",1905,"54",9704,8442,18146
"6605",1905,"55",10001,8760,18761
"6606",1905,"56",8987,7734,16721
"6607",1905,"57",8949,7737,16686
"6608",1905,"58",8688,7550,16238
"6609",1905,"59",8881,7629,16510
"6610",1905,"60",8283,7126,15409
"6611",1905,"61",8023,6949,14972
"6612",1905,"62",7433,6496,13929
"6613",1905,"63",7457,6619,14076
"6614",1905,"64",6703,5703,12406
"6615",1905,"65",6299,5414,11713
"6616",1905,"66",5934,5104,11038
"6617",1905,"67",6209,5351,11560
"6618",1905,"68",6224,5280,11504
"6619",1905,"69",6508,5599,12107
"6620",1905,"70",6245,5331,11576
"6621",1905,"71",5731,4994,10725
"6622",1905,"72",5149,4467,9616
"6623",1905,"73",5036,4313,9349
"6624",1905,"74",4879,4043,8922
"6625",1905,"75",4875,4094,8969
"6626",1905,"76",4168,3467,7635
"6627",1905,"77",3884,3208,7092
"6628",1905,"78",3814,3251,7065
"6629",1905,"79",3462,2831,6293
"6630",1905,"80",3038,2404,5442
"6631",1905,"81",2696,2077,4773
"6632",1905,"82",2426,2004,4430
"6633",1905,"83",2014,1521,3535
"6634",1905,"84",1976,1494,3470
"6635",1905,"85",1258,1010,2268
"6636",1905,"86",1160,834,1994
"6637",1905,"87",895,589,1484
"6638",1905,"88",775,543,1318
"6639",1905,"89",514,344,858
"6640",1905,"90",393,257,650
"6641",1905,"91",261,140,401
"6642",1905,"92",253,124,377
"6643",1905,"93",134,85,219
"6644",1905,"94",121,75,196
"6645",1905,"95",68,22,90
"6646",1905,"96",40,14,54
"6647",1905,"97",23,11,34
"6648",1905,"98",22,6,28
"6649",1905,"99",11,3,14
"6650",1905,"100",3,0,3
"6651",1905,"101",2,2,4
"6652",1905,"102",1,1,2
"6653",1905,"103",1,1,2
"6654",1905,"104",0,0,0
"6655",1905,"105",0,0,0
"6656",1905,"106",0,0,0
"6657",1905,"107",0,0,0
"6658",1905,"108",0,0,0
"6659",1905,"109",0,0,0
"6660",1905,"110+",0,0,0
"6661",1906,"0",28853,29951,58804
"6662",1906,"1",28630,29560,58190
"6663",1906,"2",28607,29657,58264
"6664",1906,"3",28583,29790,58373
"6665",1906,"4",28442,29399,57841
"6666",1906,"5",27808,28795,56603
"6667",1906,"6",27438,28399,55837
"6668",1906,"7",27344,28134,55478
"6669",1906,"8",26871,27389,54260
"6670",1906,"9",26106,26985,53091
"6671",1906,"10",25928,26971,52899
"6672",1906,"11",24839,25519,50358
"6673",1906,"12",24917,25840,50757
"6674",1906,"13",23719,25038,48757
"6675",1906,"14",24398,25327,49725
"6676",1906,"15",23546,24420,47966
"6677",1906,"16",22490,23310,45800
"6678",1906,"17",22253,22792,45045
"6679",1906,"18",22341,22364,44705
"6680",1906,"19",20956,20434,41390
"6681",1906,"20",20737,19265,40002
"6682",1906,"21",19964,17939,37903
"6683",1906,"22",19235,16741,35976
"6684",1906,"23",18266,15821,34087
"6685",1906,"24",17890,15207,33097
"6686",1906,"25",17484,14790,32274
"6687",1906,"26",18099,15388,33487
"6688",1906,"27",17419,14760,32179
"6689",1906,"28",17227,14994,32221
"6690",1906,"29",17110,14514,31624
"6691",1906,"30",16348,14279,30627
"6692",1906,"31",15712,13651,29363
"6693",1906,"32",15108,12818,27926
"6694",1906,"33",14667,12474,27141
"6695",1906,"34",14180,12272,26452
"6696",1906,"35",13568,11602,25170
"6697",1906,"36",13400,11368,24768
"6698",1906,"37",13050,11108,24158
"6699",1906,"38",13077,10988,24065
"6700",1906,"39",13575,11454,25029
"6701",1906,"40",13626,11319,24945
"6702",1906,"41",13295,11144,24439
"6703",1906,"42",13298,11066,24364
"6704",1906,"43",12397,10284,22681
"6705",1906,"44",11859,9851,21710
"6706",1906,"45",11953,10104,22057
"6707",1906,"46",12354,10692,23046
"6708",1906,"47",11431,9798,21229
"6709",1906,"48",11360,9754,21114
"6710",1906,"49",11139,9649,20788
"6711",1906,"50",11542,9852,21394
"6712",1906,"51",11509,9840,21349
"6713",1906,"52",10533,9075,19608
"6714",1906,"53",9916,8428,18344
"6715",1906,"54",10222,8937,19159
"6716",1906,"55",9523,8289,17812
"6717",1906,"56",9819,8596,18415
"6718",1906,"57",8821,7577,16398
"6719",1906,"58",8773,7627,16400
"6720",1906,"59",8518,7420,15938
"6721",1906,"60",8711,7457,16168
"6722",1906,"61",8158,6995,15153
"6723",1906,"62",7894,6813,14707
"6724",1906,"63",7267,6341,13608
"6725",1906,"64",7286,6457,13743
"6726",1906,"65",6553,5535,12088
"6727",1906,"66",6153,5271,11424
"6728",1906,"67",5780,4955,10735
"6729",1906,"68",6019,5170,11189
"6730",1906,"69",6013,5080,11093
"6731",1906,"70",6269,5367,11636
"6732",1906,"71",5995,5083,11078
"6733",1906,"72",5472,4751,10223
"6734",1906,"73",4917,4247,9164
"6735",1906,"74",4784,4070,8854
"6736",1906,"75",4598,3797,8395
"6737",1906,"76",4574,3827,8401
"6738",1906,"77",3898,3214,7112
"6739",1906,"78",3585,2967,6552
"6740",1906,"79",3473,2954,6427
"6741",1906,"80",3123,2596,5719
"6742",1906,"81",2702,2135,4837
"6743",1906,"82",2413,1806,4219
"6744",1906,"83",2133,1718,3851
"6745",1906,"84",1735,1279,3014
"6746",1906,"85",1685,1255,2940
"6747",1906,"86",1076,834,1910
"6748",1906,"87",966,693,1659
"6749",1906,"88",746,459,1205
"6750",1906,"89",597,409,1006
"6751",1906,"90",383,245,628
"6752",1906,"91",298,181,479
"6753",1906,"92",190,97,287
"6754",1906,"93",173,91,264
"6755",1906,"94",78,62,140
"6756",1906,"95",80,51,131
"6757",1906,"96",50,15,65
"6758",1906,"97",24,9,33
"6759",1906,"98",12,3,15
"6760",1906,"99",12,3,15
"6761",1906,"100",1,3,4
"6762",1906,"101",1,0,1
"6763",1906,"102",1,1,2
"6764",1906,"103",1,0,1
"6765",1906,"104",1,1,2
"6766",1906,"105",0,0,0
"6767",1906,"106",0,0,0
"6768",1906,"107",0,0,0
"6769",1906,"108",0,0,0
"6770",1906,"109",0,0,0
"6771",1906,"110+",0,0,0
"6772",1907,"0",28865,30200,59065
"6773",1907,"1",27875,28870,56745
"6774",1907,"2",28204,29113,57317
"6775",1907,"3",28291,29353,57644
"6776",1907,"4",28299,29530,57829
"6777",1907,"5",28282,29176,57458
"6778",1907,"6",27630,28596,56226
"6779",1907,"7",27331,28256,55587
"6780",1907,"8",27216,27972,55188
"6781",1907,"9",26747,27241,53988
"6782",1907,"10",25956,26843,52799
"6783",1907,"11",25777,26771,52548
"6784",1907,"12",24688,25355,50043
"6785",1907,"13",24810,25717,50527
"6786",1907,"14",23591,24893,48484
"6787",1907,"15",24218,25132,49350
"6788",1907,"16",23178,23920,47098
"6789",1907,"17",21980,22503,44483
"6790",1907,"18",21726,21669,43395
"6791",1907,"19",21801,20948,42749
"6792",1907,"20",20376,19118,39494
"6793",1907,"21",20197,18102,38299
"6794",1907,"22",19479,16953,36432
"6795",1907,"23",18784,15986,34770
"6796",1907,"24",17841,15159,33000
"6797",1907,"25",17447,14598,32045
"6798",1907,"26",17086,14364,31450
"6799",1907,"27",17730,15006,32736
"6800",1907,"28",17066,14406,31472
"6801",1907,"29",16893,14668,31561
"6802",1907,"30",16796,14235,31031
"6803",1907,"31",16039,14015,30054
"6804",1907,"32",15433,13401,28834
"6805",1907,"33",14845,12603,27448
"6806",1907,"34",14421,12278,26699
"6807",1907,"35",13950,12086,26036
"6808",1907,"36",13383,11419,24802
"6809",1907,"37",13228,11238,24466
"6810",1907,"38",12898,10969,23867
"6811",1907,"39",12916,10845,23761
"6812",1907,"40",13348,11291,24639
"6813",1907,"41",13425,11186,24611
"6814",1907,"42",13099,11000,24099
"6815",1907,"43",13108,10898,24006
"6816",1907,"44",12238,10140,22378
"6817",1907,"45",11723,9703,21426
"6818",1907,"46",11820,9992,21812
"6819",1907,"47",12258,10559,22817
"6820",1907,"48",11351,9695,21046
"6821",1907,"49",11271,9641,20912
"6822",1907,"50",11026,9537,20563
"6823",1907,"51",11420,9712,21132
"6824",1907,"52",11384,9752,21136
"6825",1907,"53",10395,8957,19352
"6826",1907,"54",9771,8290,18061
"6827",1907,"55",10052,8764,18816
"6828",1907,"56",9391,8142,17533
"6829",1907,"57",9656,8423,18079
"6830",1907,"58",8680,7457,16137
"6831",1907,"59",8636,7496,16132
"6832",1907,"60",8363,7296,15659
"6833",1907,"61",8550,7305,15855
"6834",1907,"62",8018,6843,14861
"6835",1907,"63",7747,6652,14399
"6836",1907,"64",7123,6204,13327
"6837",1907,"65",7161,6293,13454
"6838",1907,"66",6402,5391,11793
"6839",1907,"67",5992,5097,11089
"6840",1907,"68",5608,4798,10406
"6841",1907,"69",5833,4964,10797
"6842",1907,"70",5827,4884,10711
"6843",1907,"71",6056,5142,11198
"6844",1907,"72",5758,4836,10594
"6845",1907,"73",5213,4485,9698
"6846",1907,"74",4705,4022,8727
"6847",1907,"75",4536,3854,8390
"6848",1907,"76",4326,3565,7891
"6849",1907,"77",4269,3561,7830
"6850",1907,"78",3599,2967,6566
"6851",1907,"79",3295,2702,5997
"6852",1907,"80",3178,2533,5711
"6853",1907,"81",2851,2349,5200
"6854",1907,"82",2441,1873,4314
"6855",1907,"83",2151,1596,3747
"6856",1907,"84",1892,1481,3373
"6857",1907,"85",1500,1100,2600
"6858",1907,"86",1419,1055,2474
"6859",1907,"87",898,687,1585
"6860",1907,"88",784,548,1332
"6861",1907,"89",611,361,972
"6862",1907,"90",467,323,790
"6863",1907,"91",286,184,470
"6864",1907,"92",228,125,353
"6865",1907,"93",134,68,202
"6866",1907,"94",125,60,185
"6867",1907,"95",51,41,92
"6868",1907,"96",52,37,89
"6869",1907,"97",34,9,43
"6870",1907,"98",16,7,23
"6871",1907,"99",6,1,7
"6872",1907,"100",8,2,10
"6873",1907,"101",0,2,2
"6874",1907,"102",1,0,1
"6875",1907,"103",0,1,1
"6876",1907,"104",0,0,0
"6877",1907,"105",1,1,2
"6878",1907,"106",0,0,0
"6879",1907,"107",0,0,0
"6880",1907,"108",0,0,0
"6881",1907,"109",0,0,0
"6882",1907,"110+",0,0,0
"6883",1908,"0",28647,29775,58422
"6884",1908,"1",27987,29138,57125
"6885",1908,"2",27505,28431,55936
"6886",1908,"3",27942,28851,56793
"6887",1908,"4",27991,29070,57061
"6888",1908,"5",28073,29326,57399
"6889",1908,"6",28082,29020,57102
"6890",1908,"7",27456,28391,55847
"6891",1908,"8",27168,28127,55295
"6892",1908,"9",27048,27810,54858
"6893",1908,"10",26597,27135,53732
"6894",1908,"11",25829,26663,52492
"6895",1908,"12",25643,26616,52259
"6896",1908,"13",24560,25248,49808
"6897",1908,"14",24707,25583,50290
"6898",1908,"15",23427,24682,48109
"6899",1908,"16",23892,24653,48545
"6900",1908,"17",22655,23032,45687
"6901",1908,"18",21459,21270,42729
"6902",1908,"19",21126,20180,41306
"6903",1908,"20",21146,19521,40667
"6904",1908,"21",19840,17769,37609
"6905",1908,"22",19645,16979,36624
"6906",1908,"23",18962,16173,35135
"6907",1908,"24",18331,15281,33612
"6908",1908,"25",17374,14536,31910
"6909",1908,"26",17048,14123,31171
"6910",1908,"27",16710,14003,30713
"6911",1908,"28",17393,14655,32048
"6912",1908,"29",16714,14107,30821
"6913",1908,"30",16571,14377,30948
"6914",1908,"31",16466,13987,30453
"6915",1908,"32",15738,13786,29524
"6916",1908,"33",15173,13188,28361
"6917",1908,"34",14630,12423,27053
"6918",1908,"35",14200,12079,26279
"6919",1908,"36",13751,11915,25666
"6920",1908,"37",13214,11237,24451
"6921",1908,"38",13068,11077,24145
"6922",1908,"39",12750,10820,23570
"6923",1908,"40",12768,10711,23479
"6924",1908,"41",13195,11169,24364
"6925",1908,"42",13278,11074,24352
"6926",1908,"43",12945,10869,23814
"6927",1908,"44",12951,10762,23713
"6928",1908,"45",12082,10002,22084
"6929",1908,"46",11625,9580,21205
"6930",1908,"47",11708,9864,21572
"6931",1908,"48",12154,10452,22606
"6932",1908,"49",11265,9618,20883
"6933",1908,"50",11161,9520,20681
"6934",1908,"51",10930,9407,20337
"6935",1908,"52",11301,9588,20889
"6936",1908,"53",11273,9636,20909
"6937",1908,"54",10256,8826,19082
"6938",1908,"55",9607,8121,17728
"6939",1908,"56",9903,8601,18504
"6940",1908,"57",9206,7983,17189
"6941",1908,"58",9462,8263,17725
"6942",1908,"59",8501,7299,15800
"6943",1908,"60",8468,7348,15816
"6944",1908,"61",8195,7144,15339
"6945",1908,"62",8396,7114,15510
"6946",1908,"63",7859,6664,14523
"6947",1908,"64",7595,6475,14070
"6948",1908,"65",6978,6056,13034
"6949",1908,"66",6946,6115,13061
"6950",1908,"67",6213,5231,11444
"6951",1908,"68",5823,4927,10750
"6952",1908,"69",5405,4602,10007
"6953",1908,"70",5613,4772,10385
"6954",1908,"71",5602,4686,10288
"6955",1908,"72",5782,4884,10666
"6956",1908,"73",5445,4574,10019
"6957",1908,"74",4934,4169,9103
"6958",1908,"75",4418,3775,8193
"6959",1908,"76",4284,3577,7861
"6960",1908,"77",3984,3272,7256
"6961",1908,"78",3946,3246,7192
"6962",1908,"79",3284,2698,5982
"6963",1908,"80",3055,2432,5487
"6964",1908,"81",2855,2266,5121
"6965",1908,"82",2496,2047,4543
"6966",1908,"83",2125,1615,3740
"6967",1908,"84",1838,1363,3201
"6968",1908,"85",1625,1251,2876
"6969",1908,"86",1239,875,2114
"6970",1908,"87",1148,838,1986
"6971",1908,"88",721,519,1240
"6972",1908,"89",608,435,1043
"6973",1908,"90",462,275,737
"6974",1908,"91",362,237,599
"6975",1908,"92",221,125,346
"6976",1908,"93",160,90,250
"6977",1908,"94",92,48,140
"6978",1908,"95",74,41,115
"6979",1908,"96",31,27,58
"6980",1908,"97",33,14,47
"6981",1908,"98",20,5,25
"6982",1908,"99",9,5,14
"6983",1908,"100",2,0,2
"6984",1908,"101",4,1,5
"6985",1908,"102",0,1,1
"6986",1908,"103",1,0,1
"6987",1908,"104",0,1,1
"6988",1908,"105",0,0,0
"6989",1908,"106",0,0,0
"6990",1908,"107",0,0,0
"6991",1908,"108",0,0,0
"6992",1908,"109",0,0,0
"6993",1908,"110+",0,0,0
"6994",1909,"0",28448,29967,58415
"6995",1909,"1",27697,28693,56390
"6996",1909,"2",27632,28796,56428
"6997",1909,"3",27276,28254,55530
"6998",1909,"4",27741,28689,56430
"6999",1909,"5",27853,28875,56728
"7000",1909,"6",27918,29193,57111
"7001",1909,"7",27957,28909,56866
"7002",1909,"8",27320,28257,55577
"7003",1909,"9",27080,28032,55112
"7004",1909,"10",26911,27695,54606
"7005",1909,"11",26474,27040,53514
"7006",1909,"12",25732,26558,52290
"7007",1909,"13",25539,26497,52036
"7008",1909,"14",24458,25142,49600
"7009",1909,"15",24562,25452,50014
"7010",1909,"16",23238,24425,47663
"7011",1909,"17",23634,24328,47962
"7012",1909,"18",22316,22551,44867
"7013",1909,"19",21122,20712,41834
"7014",1909,"20",20798,19730,40528
"7015",1909,"21",20814,19154,39968
"7016",1909,"22",19601,17486,37087
"7017",1909,"23",19454,16761,36215
"7018",1909,"24",18720,16052,34772
"7019",1909,"25",18094,15137,33231
"7020",1909,"26",17184,14440,31624
"7021",1909,"27",16858,14101,30959
"7022",1909,"28",16517,14034,30551
"7023",1909,"29",17191,14690,31881
"7024",1909,"30",16518,14128,30646
"7025",1909,"31",16371,14410,30781
"7026",1909,"32",16240,13988,30228
"7027",1909,"33",15541,13759,29300
"7028",1909,"34",14977,13150,28127
"7029",1909,"35",14446,12370,26816
"7030",1909,"36",14051,12026,26077
"7031",1909,"37",13589,11870,25459
"7032",1909,"38",13097,11214,24311
"7033",1909,"39",12946,11029,23975
"7034",1909,"40",12631,10760,23391
"7035",1909,"41",12640,10680,23320
"7036",1909,"42",13056,11112,24168
"7037",1909,"43",13160,11028,24188
"7038",1909,"44",12815,10807,23622
"7039",1909,"45",12829,10689,23518
"7040",1909,"46",12000,9940,21940
"7041",1909,"47",11534,9518,21052
"7042",1909,"48",11608,9798,21406
"7043",1909,"49",12048,10372,22420
"7044",1909,"50",11180,9563,20743
"7045",1909,"51",11054,9445,20499
"7046",1909,"52",10839,9324,20163
"7047",1909,"53",11201,9513,20714
"7048",1909,"54",11157,9506,20663
"7049",1909,"55",10112,8714,18826
"7050",1909,"56",9464,8001,17465
"7051",1909,"57",9761,8444,18205
"7052",1909,"58",9043,7837,16880
"7053",1909,"59",9280,8092,17372
"7054",1909,"60",8327,7164,15491
"7055",1909,"61",8307,7223,15530
"7056",1909,"62",8033,6992,15025
"7057",1909,"63",8234,6937,15171
"7058",1909,"64",7686,6460,14146
"7059",1909,"65",7448,6294,13742
"7060",1909,"66",6803,5899,12702
"7061",1909,"67",6755,5921,12676
"7062",1909,"68",6017,5034,11051
"7063",1909,"69",5626,4732,10358
"7064",1909,"70",5224,4414,9638
"7065",1909,"71",5411,4571,9982
"7066",1909,"72",5374,4471,9845
"7067",1909,"73",5507,4618,10125
"7068",1909,"74",5130,4325,9455
"7069",1909,"75",4658,3901,8559
"7070",1909,"76",4127,3492,7619
"7071",1909,"77",3990,3294,7284
"7072",1909,"78",3652,2983,6635
"7073",1909,"79",3627,2958,6585
"7074",1909,"80",3100,2467,5567
"7075",1909,"81",2774,2172,4946
"7076",1909,"82",2534,1974,4508
"7077",1909,"83",2178,1777,3955
"7078",1909,"84",1846,1382,3228
"7079",1909,"85",1555,1157,2712
"7080",1909,"86",1377,1017,2394
"7081",1909,"87",1028,707,1735
"7082",1909,"88",927,647,1574
"7083",1909,"89",562,413,975
"7084",1909,"90",471,326,797
"7085",1909,"91",375,206,581
"7086",1909,"92",261,172,433
"7087",1909,"93",137,82,219
"7088",1909,"94",110,65,175
"7089",1909,"95",66,29,95
"7090",1909,"96",55,22,77
"7091",1909,"97",22,16,38
"7092",1909,"98",23,9,32
"7093",1909,"99",12,2,14
"7094",1909,"100",3,4,7
"7095",1909,"101",2,0,2
"7096",1909,"102",2,1,3
"7097",1909,"103",0,0,0
"7098",1909,"104",1,0,1
"7099",1909,"105",0,0,0
"7100",1909,"106",0,0,0
"7101",1909,"107",0,0,0
"7102",1909,"108",0,0,0
"7103",1909,"109",0,0,0
"7104",1909,"110+",0,0,0
"7105",1910,"0",29449,30711,60160
"7106",1910,"1",27557,29000,56557
"7107",1910,"2",27357,28319,55676
"7108",1910,"3",27422,28589,56011
"7109",1910,"4",27101,28063,55164
"7110",1910,"5",27571,28551,56122
"7111",1910,"6",27691,28746,56437
"7112",1910,"7",27802,29083,56885
"7113",1910,"8",27840,28778,56618
"7114",1910,"9",27194,28108,55302
"7115",1910,"10",27012,27954,54966
"7116",1910,"11",26791,27562,54353
"7117",1910,"12",26362,26962,53324
"7118",1910,"13",25641,26461,52102
"7119",1910,"14",25414,26366,51780
"7120",1910,"15",24273,24962,49235
"7121",1910,"16",24309,25098,49407
"7122",1910,"17",22887,23805,46692
"7123",1910,"18",23209,23367,46576
"7124",1910,"19",21809,21422,43231
"7125",1910,"20",20662,19641,40303
"7126",1910,"21",20341,18705,39046
"7127",1910,"22",20391,18318,38709
"7128",1910,"23",19266,16946,36212
"7129",1910,"24",19160,16313,35473
"7130",1910,"25",18427,15651,34078
"7131",1910,"26",17801,14799,32600
"7132",1910,"27",16966,14180,31146
"7133",1910,"28",16623,13919,30542
"7134",1910,"29",16318,13894,30212
"7135",1910,"30",16983,14573,31556
"7136",1910,"31",16287,13968,30255
"7137",1910,"32",16153,14256,30409
"7138",1910,"33",15998,13880,29878
"7139",1910,"34",15316,13636,28952
"7140",1910,"35",14781,13026,27807
"7141",1910,"36",14269,12245,26514
"7142",1910,"37",13879,11893,25772
"7143",1910,"38",13438,11762,25200
"7144",1910,"39",12957,11132,24089
"7145",1910,"40",12812,10929,23741
"7146",1910,"41",12503,10660,23163
"7147",1910,"42",12509,10591,23100
"7148",1910,"43",12933,10986,23919
"7149",1910,"44",13045,10903,23948
"7150",1910,"45",12673,10702,23375
"7151",1910,"46",12705,10580,23285
"7152",1910,"47",11880,9847,21727
"7153",1910,"48",11414,9426,20840
"7154",1910,"49",11522,9711,21233
"7155",1910,"50",11946,10262,22208
"7156",1910,"51",11099,9468,20567
"7157",1910,"52",10946,9345,20291
"7158",1910,"53",10736,9207,19943
"7159",1910,"54",11101,9410,20511
"7160",1910,"55",11028,9381,20409
"7161",1910,"56",9980,8570,18550
"7162",1910,"57",9295,7878,17173
"7163",1910,"58",9586,8294,17880
"7164",1910,"59",8910,7681,16591
"7165",1910,"60",9114,7917,17031
"7166",1910,"61",8164,7031,15195
"7167",1910,"62",8135,7091,15226
"7168",1910,"63",7850,6828,14678
"7169",1910,"64",8054,6746,14800
"7170",1910,"65",7484,6267,13751
"7171",1910,"66",7289,6124,13413
"7172",1910,"67",6646,5723,12369
"7173",1910,"68",6585,5719,12304
"7174",1910,"69",5822,4845,10667
"7175",1910,"70",5418,4533,9951
"7176",1910,"71",5029,4225,9254
"7177",1910,"72",5178,4356,9534
"7178",1910,"73",5117,4245,9362
"7179",1910,"74",5202,4341,9543
"7180",1910,"75",4836,4071,8907
"7181",1910,"76",4383,3627,8010
"7182",1910,"77",3854,3238,7092
"7183",1910,"78",3663,3022,6685
"7184",1910,"79",3373,2709,6082
"7185",1910,"80",3093,2575,5668
"7186",1910,"81",2796,2216,5012
"7187",1910,"82",2498,1923,4421
"7188",1910,"83",2263,1735,3998
"7189",1910,"84",1900,1510,3410
"7190",1910,"85",1592,1167,2759
"7191",1910,"86",1335,967,2302
"7192",1910,"87",1118,836,1954
"7193",1910,"88",821,562,1383
"7194",1910,"89",745,510,1255
"7195",1910,"90",446,306,752
"7196",1910,"91",377,249,626
"7197",1910,"92",299,144,443
"7198",1910,"93",191,134,325
"7199",1910,"94",95,55,150
"7200",1910,"95",84,44,128
"7201",1910,"96",43,20,63
"7202",1910,"97",30,13,43
"7203",1910,"98",14,11,25
"7204",1910,"99",15,4,19
"7205",1910,"100",5,0,5
"7206",1910,"101",2,2,4
"7207",1910,"102",2,0,2
"7208",1910,"103",0,1,1
"7209",1910,"104",0,0,0
"7210",1910,"105",1,0,1
"7211",1910,"106",0,0,0
"7212",1910,"107",0,0,0
"7213",1910,"108",0,0,0
"7214",1910,"109",0,0,0
"7215",1910,"110+",0,0,0
"7216",1911,"0",28634,29803,58437
"7217",1911,"1",28657,29793,58450
"7218",1911,"2",27277,28689,55966
"7219",1911,"3",27161,28094,55255
"7220",1911,"4",27254,28406,55660
"7221",1911,"5",26943,27900,54843
"7222",1911,"6",27428,28403,55831
"7223",1911,"7",27548,28615,56163
"7224",1911,"8",27658,28955,56613
"7225",1911,"9",27719,28663,56382
"7226",1911,"10",27050,27956,55006
"7227",1911,"11",26920,27840,54760
"7228",1911,"12",26661,27445,54106
"7229",1911,"13",26249,26871,53120
"7230",1911,"14",25533,26339,51872
"7231",1911,"15",25267,26168,51435
"7232",1911,"16",24028,24529,48557
"7233",1911,"17",23947,24328,48275
"7234",1911,"18",22418,22620,45038
"7235",1911,"19",22714,21898,44612
"7236",1911,"20",21251,19948,41199
"7237",1911,"21",20185,18362,38547
"7238",1911,"22",19874,17687,37561
"7239",1911,"23",20054,17515,37569
"7240",1911,"24",18919,16398,35317
"7241",1911,"25",18852,15862,34714
"7242",1911,"26",18168,15244,33412
"7243",1911,"27",17513,14477,31990
"7244",1911,"28",16729,13960,30689
"7245",1911,"29",16385,13753,30138
"7246",1911,"30",16111,13718,29829
"7247",1911,"31",16734,14386,31120
"7248",1911,"32",16070,13762,29832
"7249",1911,"33",15909,14118,30027
"7250",1911,"34",15789,13709,29498
"7251",1911,"35",15097,13490,28587
"7252",1911,"36",14576,12889,27465
"7253",1911,"37",14097,12114,26211
"7254",1911,"38",13706,11775,25481
"7255",1911,"39",13277,11628,24905
"7256",1911,"40",12827,11026,23853
"7257",1911,"41",12689,10804,23493
"7258",1911,"42",12380,10541,22921
"7259",1911,"43",12373,10465,22838
"7260",1911,"44",12810,10873,23683
"7261",1911,"45",12917,10772,23689
"7262",1911,"46",12583,10562,23145
"7263",1911,"47",12578,10479,23057
"7264",1911,"48",11757,9774,21531
"7265",1911,"49",11292,9313,20605
"7266",1911,"50",11420,9609,21029
"7267",1911,"51",11843,10133,21976
"7268",1911,"52",10989,9372,20361
"7269",1911,"53",10846,9230,20076
"7270",1911,"54",10631,9101,19732
"7271",1911,"55",10977,9289,20266
"7272",1911,"56",10891,9246,20137
"7273",1911,"57",9836,8444,18280
"7274",1911,"58",9132,7742,16874
"7275",1911,"59",9381,8105,17486
"7276",1911,"60",8733,7523,16256
"7277",1911,"61",8928,7744,16672
"7278",1911,"62",7981,6861,14842
"7279",1911,"63",7950,6917,14867
"7280",1911,"64",7652,6671,14323
"7281",1911,"65",7848,6563,14411
"7282",1911,"66",7321,6063,13384
"7283",1911,"67",7110,5930,13040
"7284",1911,"68",6500,5525,12025
"7285",1911,"69",6356,5490,11846
"7286",1911,"70",5634,4669,10303
"7287",1911,"71",5217,4348,9565
"7288",1911,"72",4813,4042,8855
"7289",1911,"73",4936,4142,9078
"7290",1911,"74",4844,3998,8842
"7291",1911,"75",4870,4054,8924
"7292",1911,"76",4553,3769,8322
"7293",1911,"77",4040,3350,7390
"7294",1911,"78",3542,2959,6501
"7295",1911,"79",3341,2722,6063
"7296",1911,"80",3449,2698,6147
"7297",1911,"81",2797,2260,5057
"7298",1911,"82",2468,1940,4408
"7299",1911,"83",2207,1650,3857
"7300",1911,"84",1955,1472,3427
"7301",1911,"85",1639,1259,2898
"7302",1911,"86",1357,966,2323
"7303",1911,"87",1104,770,1874
"7304",1911,"88",900,674,1574
"7305",1911,"89",649,443,1092
"7306",1911,"90",586,389,975
"7307",1911,"91",340,236,576
"7308",1911,"92",280,173,453
"7309",1911,"93",206,100,306
"7310",1911,"94",136,78,214
"7311",1911,"95",68,37,105
"7312",1911,"96",55,30,85
"7313",1911,"97",28,11,39
"7314",1911,"98",16,8,24
"7315",1911,"99",10,7,17
"7316",1911,"100",10,2,12
"7317",1911,"101",4,0,4
"7318",1911,"102",0,2,2
"7319",1911,"103",0,0,0
"7320",1911,"104",0,0,0
"7321",1911,"105",0,0,0
"7322",1911,"106",0,0,0
"7323",1911,"107",0,0,0
"7324",1911,"108",0,0,0
"7325",1911,"109",0,0,0
"7326",1911,"110+",0,0,0
"7327",1912,"0",28513,29901,58414
"7328",1912,"1",27862,28872,56734
"7329",1912,"2",28354,29478,57832
"7330",1912,"3",27127,28517,55644
"7331",1912,"4",27070,27969,55039
"7332",1912,"5",27140,28276,55416
"7333",1912,"6",26861,27798,54659
"7334",1912,"7",27345,28281,55626
"7335",1912,"8",27468,28467,55935
"7336",1912,"9",27576,28786,56362
"7337",1912,"10",27636,28497,56133
"7338",1912,"11",26954,27767,54721
"7339",1912,"12",26821,27637,54458
"7340",1912,"13",26562,27257,53819
"7341",1912,"14",26161,26684,52845
"7342",1912,"15",25411,26151,51562
"7343",1912,"16",25026,25860,50886
"7344",1912,"17",23680,24039,47719
"7345",1912,"18",23549,23496,47045
"7346",1912,"19",21992,21752,43744
"7347",1912,"20",22240,21010,43250
"7348",1912,"21",20807,19136,39943
"7349",1912,"22",19821,17720,37541
"7350",1912,"23",19512,17223,36735
"7351",1912,"24",19699,17133,36832
"7352",1912,"25",18614,16106,34720
"7353",1912,"26",18560,15638,34198
"7354",1912,"27",17895,15041,32936
"7355",1912,"28",17295,14357,31652
"7356",1912,"29",16512,13828,30340
"7357",1912,"30",16180,13609,29789
"7358",1912,"31",15971,13624,29595
"7359",1912,"32",16575,14276,30851
"7360",1912,"33",15922,13691,29613
"7361",1912,"34",15777,14055,29832
"7362",1912,"35",15631,13619,29250
"7363",1912,"36",14974,13410,28384
"7364",1912,"37",14431,12815,27246
"7365",1912,"38",13964,12036,26000
"7366",1912,"39",13613,11722,25335
"7367",1912,"40",13164,11540,24704
"7368",1912,"41",12733,10937,23670
"7369",1912,"42",12587,10736,23323
"7370",1912,"43",12293,10482,22775
"7371",1912,"44",12282,10400,22682
"7372",1912,"45",12719,10793,23512
"7373",1912,"46",12823,10693,23516
"7374",1912,"47",12492,10493,22985
"7375",1912,"48",12485,10391,22876
"7376",1912,"49",11667,9673,21340
"7377",1912,"50",11161,9211,20372
"7378",1912,"51",11296,9499,20795
"7379",1912,"52",11695,9989,21684
"7380",1912,"53",10897,9248,20145
"7381",1912,"54",10729,9138,19867
"7382",1912,"55",10507,8977,19484
"7383",1912,"56",10809,9154,19963
"7384",1912,"57",10737,9104,19841
"7385",1912,"58",9726,8325,18051
"7386",1912,"59",9008,7611,16619
"7387",1912,"60",9209,7931,17140
"7388",1912,"61",8608,7391,15999
"7389",1912,"62",8760,7581,16341
"7390",1912,"63",7853,6718,14571
"7391",1912,"64",7792,6731,14523
"7392",1912,"65",7474,6505,13979
"7393",1912,"66",7661,6363,14024
"7394",1912,"67",7130,5866,12996
"7395",1912,"68",6913,5724,12637
"7396",1912,"69",6336,5357,11693
"7397",1912,"70",6136,5230,11366
"7398",1912,"71",5453,4482,9935
"7399",1912,"72",4989,4133,9122
"7400",1912,"73",4602,3861,8463
"7401",1912,"74",4677,3890,8567
"7402",1912,"75",4573,3740,8313
"7403",1912,"76",4592,3785,8377
"7404",1912,"77",4262,3491,7753
"7405",1912,"78",3786,3064,6850
"7406",1912,"79",3279,2701,5980
"7407",1912,"80",2773,2221,4994
"7408",1912,"81",3140,2413,5553
"7409",1912,"82",2516,2002,4518
"7410",1912,"83",2189,1675,3864
"7411",1912,"84",1940,1426,3366
"7412",1912,"85",1697,1234,2931
"7413",1912,"86",1397,1045,2442
"7414",1912,"87",1142,794,1936
"7415",1912,"88",905,608,1513
"7416",1912,"89",729,538,1267
"7417",1912,"90",515,338,853
"7418",1912,"91",450,289,739
"7419",1912,"92",260,179,439
"7420",1912,"93",208,131,339
"7421",1912,"94",143,59,202
"7422",1912,"95",98,49,147
"7423",1912,"96",41,21,62
"7424",1912,"97",39,18,57
"7425",1912,"98",18,8,26
"7426",1912,"99",13,3,16
"7427",1912,"100",7,4,11
"7428",1912,"101",4,1,5
"7429",1912,"102",2,0,2
"7430",1912,"103",0,1,1
"7431",1912,"104",0,0,0
"7432",1912,"105",0,0,0
"7433",1912,"106",0,0,0
"7434",1912,"107",0,0,0
"7435",1912,"108",0,0,0
"7436",1912,"109",0,0,0
"7437",1912,"110+",0,0,0
"7438",1913,"0",28799,30239,59038
"7439",1913,"1",27756,28963,56719
"7440",1913,"2",27631,28607,56238
"7441",1913,"3",28196,29273,57469
"7442",1913,"4",27011,28406,55417
"7443",1913,"5",27010,27888,54898
"7444",1913,"6",27061,28183,55244
"7445",1913,"7",26817,27709,54526
"7446",1913,"8",27282,28167,55449
"7447",1913,"9",27403,28347,55750
"7448",1913,"10",27509,28650,56159
"7449",1913,"11",27546,28324,55870
"7450",1913,"12",26862,27592,54454
"7451",1913,"13",26710,27432,54142
"7452",1913,"14",26473,27041,53514
"7453",1913,"15",26052,26446,52498
"7454",1913,"16",25193,25825,51018
"7455",1913,"17",24706,25394,50100
"7456",1913,"18",23333,23481,46814
"7457",1913,"19",23185,22909,46094
"7458",1913,"20",21634,21109,42743
"7459",1913,"21",21883,20472,42355
"7460",1913,"22",20518,18739,39257
"7461",1913,"23",19499,17443,36942
"7462",1913,"24",19250,16970,36220
"7463",1913,"25",19426,16927,36353
"7464",1913,"26",18362,15986,34348
"7465",1913,"27",18361,15513,33874
"7466",1913,"28",17711,14949,32660
"7467",1913,"29",17139,14293,31432
"7468",1913,"30",16352,13752,30104
"7469",1913,"31",15993,13518,29511
"7470",1913,"32",15818,13558,29376
"7471",1913,"33",16434,14219,30653
"7472",1913,"34",15793,13632,29425
"7473",1913,"35",15668,13992,29660
"7474",1913,"36",15510,13551,29061
"7475",1913,"37",14843,13354,28197
"7476",1913,"38",14293,12752,27045
"7477",1913,"39",13837,11990,25827
"7478",1913,"40",13509,11680,25189
"7479",1913,"41",13050,11463,24513
"7480",1913,"42",12629,10870,23499
"7481",1913,"43",12487,10650,23137
"7482",1913,"44",12206,10431,22637
"7483",1913,"45",12174,10337,22511
"7484",1913,"46",12626,10705,23331
"7485",1913,"47",12698,10627,23325
"7486",1913,"48",12398,10418,22816
"7487",1913,"49",12352,10303,22655
"7488",1913,"50",11549,9589,21138
"7489",1913,"51",11011,9113,20124
"7490",1913,"52",11147,9371,20518
"7491",1913,"53",11548,9852,21400
"7492",1913,"54",10777,9149,19926
"7493",1913,"55",10602,9044,19646
"7494",1913,"56",10350,8832,19182
"7495",1913,"57",10635,8993,19628
"7496",1913,"58",10599,8962,19561
"7497",1913,"59",9614,8183,17797
"7498",1913,"60",8862,7484,16346
"7499",1913,"61",9050,7795,16845
"7500",1913,"62",8457,7229,15686
"7501",1913,"63",8579,7386,15965
"7502",1913,"64",7689,6545,14234
"7503",1913,"65",7631,6545,14176
"7504",1913,"66",7318,6291,13609
"7505",1913,"67",7453,6142,13595
"7506",1913,"68",6900,5684,12584
"7507",1913,"69",6677,5509,12186
"7508",1913,"70",6099,5128,11227
"7509",1913,"71",5905,4983,10888
"7510",1913,"72",5238,4268,9506
"7511",1913,"73",4769,3901,8670
"7512",1913,"74",4364,3630,7994
"7513",1913,"75",4411,3661,8072
"7514",1913,"76",4313,3487,7800
"7515",1913,"77",4260,3516,7776
"7516",1913,"78",3938,3171,7109
"7517",1913,"79",3478,2809,6287
"7518",1913,"80",3074,2556,5630
"7519",1913,"81",2499,1979,4478
"7520",1913,"82",2807,2106,4913
"7521",1913,"83",2194,1732,3926
"7522",1913,"84",1891,1443,3334
"7523",1913,"85",1675,1222,2897
"7524",1913,"86",1440,1003,2443
"7525",1913,"87",1171,837,2008
"7526",1913,"88",922,628,1550
"7527",1913,"89",715,474,1189
"7528",1913,"90",585,399,984
"7529",1913,"91",409,242,651
"7530",1913,"92",343,220,563
"7531",1913,"93",186,125,311
"7532",1913,"94",137,85,222
"7533",1913,"95",102,38,140
"7534",1913,"96",59,32,91
"7535",1913,"97",29,16,45
"7536",1913,"98",27,7,34
"7537",1913,"99",8,5,13
"7538",1913,"100",4,0,4
"7539",1913,"101",2,2,4
"7540",1913,"102",1,1,2
"7541",1913,"103",1,0,1
"7542",1913,"104",0,0,0
"7543",1913,"105",0,0,0
"7544",1913,"106",0,0,0
"7545",1913,"107",0,0,0
"7546",1913,"108",0,0,0
"7547",1913,"109",0,0,0
"7548",1913,"110+",0,0,0
"7549",1914,"0",28791,30146,58937
"7550",1914,"1",28098,29310,57408
"7551",1914,"2",27582,28713,56295
"7552",1914,"3",27502,28501,56003
"7553",1914,"4",28086,29151,57237
"7554",1914,"5",26947,28316,55263
"7555",1914,"6",26968,27832,54800
"7556",1914,"7",27008,28107,55115
"7557",1914,"8",26787,27626,54413
"7558",1914,"9",27198,28073,55271
"7559",1914,"10",27354,28235,55589
"7560",1914,"11",27450,28490,55940
"7561",1914,"12",27472,28189,55661
"7562",1914,"13",26792,27415,54207
"7563",1914,"14",26586,27216,53802
"7564",1914,"15",26345,26821,53166
"7565",1914,"16",25824,26108,51932
"7566",1914,"17",24878,25311,50189
"7567",1914,"18",24388,24687,49075
"7568",1914,"19",23039,22719,45758
"7569",1914,"20",22848,22120,44968
"7570",1914,"21",21347,20444,41791
"7571",1914,"22",21568,19936,41504
"7572",1914,"23",20238,18368,38606
"7573",1914,"24",19279,17139,36418
"7574",1914,"25",19025,16757,35782
"7575",1914,"26",19196,16705,35901
"7576",1914,"27",18174,15830,34004
"7577",1914,"28",18172,15370,33542
"7578",1914,"29",17529,14845,32374
"7579",1914,"30",16991,14165,31156
"7580",1914,"31",16208,13711,29919
"7581",1914,"32",15836,13441,29277
"7582",1914,"33",15680,13479,29159
"7583",1914,"34",16291,14123,30414
"7584",1914,"35",15672,13555,29227
"7585",1914,"36",15544,13937,29481
"7586",1914,"37",15397,13468,28865
"7587",1914,"38",14735,13264,27999
"7588",1914,"39",14172,12693,26865
"7589",1914,"40",13718,11911,25629
"7590",1914,"41",13415,11630,25045
"7591",1914,"42",12940,11398,24338
"7592",1914,"43",12537,10795,23332
"7593",1914,"44",12371,10566,22937
"7594",1914,"45",12116,10378,22494
"7595",1914,"46",12074,10260,22334
"7596",1914,"47",12536,10624,23160
"7597",1914,"48",12598,10521,23119
"7598",1914,"49",12311,10327,22638
"7599",1914,"50",12231,10209,22440
"7600",1914,"51",11409,9497,20906
"7601",1914,"52",10880,8985,19865
"7602",1914,"53",11028,9262,20290
"7603",1914,"54",11391,9705,21096
"7604",1914,"55",10648,9043,19691
"7605",1914,"56",10443,8913,19356
"7606",1914,"57",10196,8696,18892
"7607",1914,"58",10469,8844,19313
"7608",1914,"59",10444,8807,19251
"7609",1914,"60",9487,8036,17523
"7610",1914,"61",8751,7329,16080
"7611",1914,"62",8913,7641,16554
"7612",1914,"63",8317,7058,15375
"7613",1914,"64",8401,7206,15607
"7614",1914,"65",7525,6392,13917
"7615",1914,"66",7406,6359,13765
"7616",1914,"67",7123,6063,13186
"7617",1914,"68",7232,5928,13160
"7618",1914,"69",6680,5472,12152
"7619",1914,"70",6434,5299,11733
"7620",1914,"71",5881,4917,10798
"7621",1914,"72",5652,4756,10408
"7622",1914,"73",4992,4057,9049
"7623",1914,"74",4530,3666,8196
"7624",1914,"75",4115,3409,7524
"7625",1914,"76",4128,3429,7557
"7626",1914,"77",4015,3221,7236
"7627",1914,"78",3941,3227,7168
"7628",1914,"79",3638,2868,6506
"7629",1914,"80",3241,2592,5833
"7630",1914,"81",2780,2290,5070
"7631",1914,"82",2227,1727,3954
"7632",1914,"83",2456,1799,4255
"7633",1914,"84",1895,1465,3360
"7634",1914,"85",1600,1206,2806
"7635",1914,"86",1418,1002,2420
"7636",1914,"87",1196,812,2008
"7637",1914,"88",925,664,1589
"7638",1914,"89",738,468,1206
"7639",1914,"90",550,367,917
"7640",1914,"91",445,286,731
"7641",1914,"92",305,175,480
"7642",1914,"93",246,147,393
"7643",1914,"94",124,86,210
"7644",1914,"95",87,45,132
"7645",1914,"96",71,26,97
"7646",1914,"97",46,22,68
"7647",1914,"98",13,7,20
"7648",1914,"99",18,5,23
"7649",1914,"100",4,2,6
"7650",1914,"101",1,0,1
"7651",1914,"102",1,2,3
"7652",1914,"103",1,1,2
"7653",1914,"104",0,0,0
"7654",1914,"105",0,0,0
"7655",1914,"106",0,0,0
"7656",1914,"107",0,0,0
"7657",1914,"108",0,0,0
"7658",1914,"109",0,0,0
"7659",1914,"110+",0,0,0
"7660",1915,"0",28782,30543,59325
"7661",1915,"1",28002,29180,57182
"7662",1915,"2",27891,29075,56966
"7663",1915,"3",27485,28557,56042
"7664",1915,"4",27416,28392,55808
"7665",1915,"5",28017,29079,57096
"7666",1915,"6",26914,28289,55203
"7667",1915,"7",26943,27787,54730
"7668",1915,"8",26966,28053,55019
"7669",1915,"9",26775,27561,54336
"7670",1915,"10",27146,27992,55138
"7671",1915,"11",27302,28116,55418
"7672",1915,"12",27384,28326,55710
"7673",1915,"13",27413,28052,55465
"7674",1915,"14",26682,27235,53917
"7675",1915,"15",26453,26978,53431
"7676",1915,"16",26108,26450,52558
"7677",1915,"17",25535,25572,51107
"7678",1915,"18",24551,24656,49207
"7679",1915,"19",24032,23916,47948
"7680",1915,"20",22685,22039,44724
"7681",1915,"21",22511,21536,44047
"7682",1915,"22",21037,20012,41049
"7683",1915,"23",21256,19608,40864
"7684",1915,"24",19971,18140,38111
"7685",1915,"25",19013,16952,35965
"7686",1915,"26",18805,16615,35420
"7687",1915,"27",18991,16580,35571
"7688",1915,"28",17985,15754,33739
"7689",1915,"29",17980,15294,33274
"7690",1915,"30",17367,14795,32162
"7691",1915,"31",16836,14150,30986
"7692",1915,"32",16068,13677,29745
"7693",1915,"33",15713,13408,29121
"7694",1915,"34",15556,13427,28983
"7695",1915,"35",16162,14084,30246
"7696",1915,"36",15562,13516,29078
"7697",1915,"37",15410,13903,29313
"7698",1915,"38",15284,13415,28699
"7699",1915,"39",14647,13208,27855
"7700",1915,"40",14024,12617,26641
"7701",1915,"41",13599,11859,25458
"7702",1915,"42",13299,11577,24876
"7703",1915,"43",12824,11325,24149
"7704",1915,"44",12465,10723,23188
"7705",1915,"45",12278,10486,22764
"7706",1915,"46",12044,10315,22359
"7707",1915,"47",11986,10193,22179
"7708",1915,"48",12416,10552,22968
"7709",1915,"49",12494,10435,22929
"7710",1915,"50",12194,10230,22424
"7711",1915,"51",12112,10132,22244
"7712",1915,"52",11301,9396,20697
"7713",1915,"53",10742,8873,19615
"7714",1915,"54",10906,9133,20039
"7715",1915,"55",11222,9550,20772
"7716",1915,"56",10509,8917,19426
"7717",1915,"57",10303,8776,19079
"7718",1915,"58",10046,8538,18584
"7719",1915,"59",10329,8695,19024
"7720",1915,"60",10288,8632,18920
"7721",1915,"61",9357,7898,17255
"7722",1915,"62",8621,7180,15801
"7723",1915,"63",8731,7463,16194
"7724",1915,"64",8167,6901,15068
"7725",1915,"65",8197,7026,15223
"7726",1915,"66",7355,6228,13583
"7727",1915,"67",7175,6159,13334
"7728",1915,"68",6914,5840,12754
"7729",1915,"69",6997,5705,12702
"7730",1915,"70",6412,5240,11652
"7731",1915,"71",6185,5067,11252
"7732",1915,"72",5657,4664,10321
"7733",1915,"73",5364,4506,9870
"7734",1915,"74",4760,3816,8576
"7735",1915,"75",4259,3412,7671
"7736",1915,"76",3873,3166,7039
"7737",1915,"77",3832,3167,6999
"7738",1915,"78",3712,2927,6639
"7739",1915,"79",3620,2946,6566
"7740",1915,"80",3136,2415,5551
"7741",1915,"81",2913,2319,5232
"7742",1915,"82",2498,2009,4507
"7743",1915,"83",1959,1501,3460
"7744",1915,"84",2129,1536,3665
"7745",1915,"85",1612,1224,2836
"7746",1915,"86",1328,999,2327
"7747",1915,"87",1172,849,2021
"7748",1915,"88",969,617,1586
"7749",1915,"89",751,518,1269
"7750",1915,"90",566,361,927
"7751",1915,"91",410,277,687
"7752",1915,"92",317,206,523
"7753",1915,"93",205,121,326
"7754",1915,"94",178,107,285
"7755",1915,"95",83,46,129
"7756",1915,"96",58,30,88
"7757",1915,"97",50,10,60
"7758",1915,"98",34,12,46
"7759",1915,"99",7,2,9
"7760",1915,"100",13,4,17
"7761",1915,"101",2,0,2
"7762",1915,"102",1,0,1
"7763",1915,"103",1,1,2
"7764",1915,"104",0,0,0
"7765",1915,"105",0,0,0
"7766",1915,"106",0,0,0
"7767",1915,"107",0,0,0
"7768",1915,"108",0,0,0
"7769",1915,"109",0,0,0
"7770",1915,"110+",0,0,0
"7771",1916,"0",27442,28344,55786
"7772",1916,"1",28061,29678,57739
"7773",1916,"2",27839,29021,56860
"7774",1916,"3",27821,28995,56816
"7775",1916,"4",27440,28511,55951
"7776",1916,"5",27350,28329,55679
"7777",1916,"6",27962,29045,57007
"7778",1916,"7",26905,28280,55185
"7779",1916,"8",26925,27768,54693
"7780",1916,"9",26944,28016,54960
"7781",1916,"10",26764,27526,54290
"7782",1916,"11",27103,27922,55025
"7783",1916,"12",27275,28020,55295
"7784",1916,"13",27329,28205,55534
"7785",1916,"14",27325,27929,55254
"7786",1916,"15",26589,27048,53637
"7787",1916,"16",26304,26676,52980
"7788",1916,"17",25889,26069,51958
"7789",1916,"18",25287,25147,50434
"7790",1916,"19",24281,24168,48449
"7791",1916,"20",23789,23456,47245
"7792",1916,"21",22457,21717,44174
"7793",1916,"22",22274,21305,43579
"7794",1916,"23",20832,19849,40681
"7795",1916,"24",21019,19489,40508
"7796",1916,"25",19760,18067,37827
"7797",1916,"26",18833,16887,35720
"7798",1916,"27",18655,16572,35227
"7799",1916,"28",18830,16556,35386
"7800",1916,"29",17843,15736,33579
"7801",1916,"30",17841,15282,33123
"7802",1916,"31",17243,14778,32021
"7803",1916,"32",16718,14128,30846
"7804",1916,"33",15962,13652,29614
"7805",1916,"34",15590,13375,28965
"7806",1916,"35",15446,13400,28846
"7807",1916,"36",16045,14051,30096
"7808",1916,"37",15461,13491,28952
"7809",1916,"38",15299,13854,29153
"7810",1916,"39",15164,13380,28544
"7811",1916,"40",15541,13153,28694
"7812",1916,"41",13917,12566,26483
"7813",1916,"42",13477,11808,25285
"7814",1916,"43",13188,11510,24698
"7815",1916,"44",12699,11260,23959
"7816",1916,"45",12377,10660,23037
"7817",1916,"46",12211,10408,22619
"7818",1916,"47",11959,10249,22208
"7819",1916,"48",11901,10119,22020
"7820",1916,"49",12325,10477,22802
"7821",1916,"50",12385,10336,22721
"7822",1916,"51",12104,10139,22243
"7823",1916,"52",12003,10007,22010
"7824",1916,"53",11186,9287,20473
"7825",1916,"54",10605,8753,19358
"7826",1916,"55",10775,8991,19766
"7827",1916,"56",11071,9384,20455
"7828",1916,"57",10386,8805,19191
"7829",1916,"58",10135,8655,18790
"7830",1916,"59",9883,8375,18258
"7831",1916,"60",10156,8509,18665
"7832",1916,"61",10129,8457,18586
"7833",1916,"62",9203,7753,16956
"7834",1916,"63",8473,7048,15521
"7835",1916,"64",8548,7286,15834
"7836",1916,"65",7989,6716,14705
"7837",1916,"66",8012,6819,14831
"7838",1916,"67",7167,6035,13202
"7839",1916,"68",6965,5936,12901
"7840",1916,"69",6691,5593,12284
"7841",1916,"70",6708,5453,12161
"7842",1916,"71",6158,5042,11200
"7843",1916,"72",5889,4793,10682
"7844",1916,"73",5379,4416,9795
"7845",1916,"74",5053,4245,9298
"7846",1916,"75",4492,3580,8072
"7847",1916,"76",3974,3142,7116
"7848",1916,"77",3600,2900,6500
"7849",1916,"78",3514,2874,6388
"7850",1916,"79",3423,2627,6050
"7851",1916,"80",3283,2665,5948
"7852",1916,"81",2825,2137,4962
"7853",1916,"82",2606,2047,4653
"7854",1916,"83",2180,1722,3902
"7855",1916,"84",1650,1248,2898
"7856",1916,"85",1789,1253,3042
"7857",1916,"86",1337,994,2331
"7858",1916,"87",1081,781,1862
"7859",1916,"88",928,653,1581
"7860",1916,"89",761,475,1236
"7861",1916,"90",581,380,961
"7862",1916,"91",436,254,690
"7863",1916,"92",302,190,492
"7864",1916,"93",228,133,361
"7865",1916,"94",139,87,226
"7866",1916,"95",113,72,185
"7867",1916,"96",56,31,87
"7868",1916,"97",38,19,57
"7869",1916,"98",36,6,42
"7870",1916,"99",23,5,28
"7871",1916,"100",3,1,4
"7872",1916,"101",7,3,10
"7873",1916,"102",1,0,1
"7874",1916,"103",0,0,0
"7875",1916,"104",0,0,0
"7876",1916,"105",0,0,0
"7877",1916,"106",0,0,0
"7878",1916,"107",0,0,0
"7879",1916,"108",0,0,0
"7880",1916,"109",0,0,0
"7881",1916,"110+",0,0,0
"7882",1917,"0",28574,29790,58364
"7883",1917,"1",26681,27451,54132
"7884",1917,"2",27883,29465,57348
"7885",1917,"3",27742,28897,56639
"7886",1917,"4",27770,28916,56686
"7887",1917,"5",27401,28465,55866
"7888",1917,"6",27303,28265,55568
"7889",1917,"7",27919,28990,56909
"7890",1917,"8",26872,28260,55132
"7891",1917,"9",26883,27743,54626
"7892",1917,"10",26892,27959,54851
"7893",1917,"11",26755,27460,54215
"7894",1917,"12",27041,27841,54882
"7895",1917,"13",27227,27924,55151
"7896",1917,"14",27220,28057,55277
"7897",1917,"15",27188,27748,54936
"7898",1917,"16",26392,26732,53124
"7899",1917,"17",26050,26246,52296
"7900",1917,"18",25601,25552,51153
"7901",1917,"19",25015,24575,49590
"7902",1917,"20",24005,23701,47706
"7903",1917,"21",23519,23186,46705
"7904",1917,"22",22214,21510,43724
"7905",1917,"23",22049,21099,43148
"7906",1917,"24",20610,19673,40283
"7907",1917,"25",20776,19353,40129
"7908",1917,"26",19585,18008,37593
"7909",1917,"27",18649,16811,35460
"7910",1917,"28",18508,16486,34994
"7911",1917,"29",18646,16531,35177
"7912",1917,"30",17689,15702,33391
"7913",1917,"31",17694,15251,32945
"7914",1917,"32",17087,14746,31833
"7915",1917,"33",16588,14114,30702
"7916",1917,"34",16859,13640,30499
"7917",1917,"35",15453,13338,28791
"7918",1917,"36",15321,13356,28677
"7919",1917,"37",15931,14001,29932
"7920",1917,"38",15360,13447,28807
"7921",1917,"39",15174,13788,28962
"7922",1917,"40",15051,13298,28349
"7923",1917,"41",14449,13087,27536
"7924",1917,"42",13805,12518,26323
"7925",1917,"43",13375,11742,25117
"7926",1917,"44",13093,11459,24552
"7927",1917,"45",12592,11172,23764
"7928",1917,"46",12263,10585,22848
"7929",1917,"47",12095,10313,22408
"7930",1917,"48",11874,10175,22049
"7931",1917,"49",11808,10035,21843
"7932",1917,"50",12205,10391,22596
"7933",1917,"51",12277,10255,22532
"7934",1917,"52",11969,10044,22013
"7935",1917,"53",11861,9927,21788
"7936",1917,"54",11055,9178,20233
"7937",1917,"55",10466,8614,19080
"7938",1917,"56",10623,8852,19475
"7939",1917,"57",10926,9237,20163
"7940",1917,"58",10229,8647,18876
"7941",1917,"59",9986,8514,18500
"7942",1917,"60",9722,8204,17926
"7943",1917,"61",9986,8325,18311
"7944",1917,"62",9956,8288,18244
"7945",1917,"63",9022,7574,16596
"7946",1917,"64",8309,6870,15179
"7947",1917,"65",8357,7089,15446
"7948",1917,"66",7777,6513,14290
"7949",1917,"67",7806,6595,14401
"7950",1917,"68",6968,5850,12818
"7951",1917,"69",6759,5710,12469
"7952",1917,"70",6424,5342,11766
"7953",1917,"71",6434,5202,11636
"7954",1917,"72",5881,4788,10669
"7955",1917,"73",5594,4516,10110
"7956",1917,"74",5096,4153,9249
"7957",1917,"75",4716,3947,8663
"7958",1917,"76",4202,3306,7508
"7959",1917,"77",3662,2884,6546
"7960",1917,"78",3310,2630,5940
"7961",1917,"79",3239,2595,5834
"7962",1917,"80",3199,2382,5581
"7963",1917,"81",2932,2339,5271
"7964",1917,"82",2468,1856,4324
"7965",1917,"83",2268,1786,4054
"7966",1917,"84",1839,1463,3302
"7967",1917,"85",1419,1048,2467
"7968",1917,"86",1464,1030,2494
"7969",1917,"87",1102,771,1873
"7970",1917,"88",857,610,1467
"7971",1917,"89",728,499,1227
"7972",1917,"90",596,358,954
"7973",1917,"91",450,268,718
"7974",1917,"92",315,172,487
"7975",1917,"93",217,136,353
"7976",1917,"94",150,85,235
"7977",1917,"95",91,62,153
"7978",1917,"96",77,46,123
"7979",1917,"97",31,17,48
"7980",1917,"98",26,13,39
"7981",1917,"99",19,5,24
"7982",1917,"100",12,1,13
"7983",1917,"101",1,0,1
"7984",1917,"102",4,2,6
"7985",1917,"103",0,0,0
"7986",1917,"104",0,0,0
"7987",1917,"105",0,0,0
"7988",1917,"106",0,0,0
"7989",1917,"107",0,0,0
"7990",1917,"108",0,0,0
"7991",1917,"109",0,0,0
"7992",1917,"110+",0,0,0
"7993",1918,"0",29863,31186,61049
"7994",1918,"1",27894,28932,56826
"7995",1918,"2",26641,27301,53942
"7996",1918,"3",27897,29478,57375
"7997",1918,"4",27704,28856,56560
"7998",1918,"5",27745,28877,56622
"7999",1918,"6",27377,28445,55822
"8000",1918,"7",27240,28225,55465
"8001",1918,"8",27888,28952,56840
"8002",1918,"9",26835,28242,55077
"8003",1918,"10",26864,27708,54572
"8004",1918,"11",26874,27931,54805
"8005",1918,"12",26755,27426,54181
"8006",1918,"13",26978,27779,54757
"8007",1918,"14",27168,27802,54970
"8008",1918,"15",27124,27885,55009
"8009",1918,"16",27048,27539,54587
"8010",1918,"17",26246,26407,52653
"8011",1918,"18",25876,25871,51747
"8012",1918,"19",25440,25161,50601
"8013",1918,"20",24870,24241,49111
"8014",1918,"21",23851,23441,47292
"8015",1918,"22",23353,22913,46266
"8016",1918,"23",22077,21310,43387
"8017",1918,"24",21918,20900,42818
"8018",1918,"25",20477,19505,39982
"8019",1918,"26",20638,19247,39885
"8020",1918,"27",19472,17939,37411
"8021",1918,"28",18525,16741,35266
"8022",1918,"29",18389,16441,34830
"8023",1918,"30",18543,16515,35058
"8024",1918,"31",17561,15659,33220
"8025",1918,"32",17569,15268,32837
"8026",1918,"33",16974,14745,31719
"8027",1918,"34",16500,14105,30605
"8028",1918,"35",15744,13631,29375
"8029",1918,"36",15324,13302,28626
"8030",1918,"37",15210,13326,28536
"8031",1918,"38",15804,13968,29772
"8032",1918,"39",15268,13415,28683
"8033",1918,"40",15059,13738,28797
"8034",1918,"41",14952,13254,28206
"8035",1918,"42",14346,13042,27388
"8036",1918,"43",13711,12459,26170
"8037",1918,"44",13247,11685,24932
"8038",1918,"45",13011,11416,24427
"8039",1918,"46",12490,11092,23582
"8040",1918,"47",12177,10515,22692
"8041",1918,"48",11996,10235,22231
"8042",1918,"49",11795,10127,21922
"8043",1918,"50",11684,9959,21643
"8044",1918,"51",12088,10310,22398
"8045",1918,"52",12168,10151,22319
"8046",1918,"53",11876,9953,21829
"8047",1918,"54",11718,9819,21537
"8048",1918,"55",10911,9061,19972
"8049",1918,"56",10330,8448,18778
"8050",1918,"57",10460,8709,19169
"8051",1918,"58",10743,9086,19829
"8052",1918,"59",10048,8485,18533
"8053",1918,"60",9813,8344,18157
"8054",1918,"61",9521,8036,17557
"8055",1918,"62",9791,8167,17958
"8056",1918,"63",9765,8108,17873
"8057",1918,"64",8863,7402,16265
"8058",1918,"65",8136,6692,14828
"8059",1918,"66",8162,6882,15044
"8060",1918,"67",7574,6307,13881
"8061",1918,"68",7577,6353,13930
"8062",1918,"69",6743,5641,12384
"8063",1918,"70",6530,5456,11986
"8064",1918,"71",6143,5103,11246
"8065",1918,"72",6141,4933,11074
"8066",1918,"73",5597,4544,10141
"8067",1918,"74",5318,4238,9556
"8068",1918,"75",4794,3888,8682
"8069",1918,"76",4407,3679,8086
"8070",1918,"77",3889,3043,6932
"8071",1918,"78",3359,2625,5984
"8072",1918,"79",3038,2351,5389
"8073",1918,"80",2822,2191,5013
"8074",1918,"81",2855,2110,4965
"8075",1918,"82",2612,2027,4639
"8076",1918,"83",2138,1580,3718
"8077",1918,"84",1944,1509,3453
"8078",1918,"85",1547,1230,2777
"8079",1918,"86",1180,859,2039
"8080",1918,"87",1192,821,2013
"8081",1918,"88",878,590,1468
"8082",1918,"89",661,458,1119
"8083",1918,"90",575,373,948
"8084",1918,"91",450,273,723
"8085",1918,"92",317,195,512
"8086",1918,"93",212,117,329
"8087",1918,"94",155,95,250
"8088",1918,"95",82,51,133
"8089",1918,"96",63,41,104
"8090",1918,"97",47,26,73
"8091",1918,"98",20,8,28
"8092",1918,"99",17,4,21
"8093",1918,"100",11,1,12
"8094",1918,"101",8,0,8
"8095",1918,"102",0,0,0
"8096",1918,"103",3,2,5
"8097",1918,"104",0,0,0
"8098",1918,"105",0,0,0
"8099",1918,"106",0,0,0
"8100",1918,"107",0,0,0
"8101",1918,"108",0,0,0
"8102",1918,"109",0,0,0
"8103",1918,"110+",0,0,0
"8104",1919,"0",29494,30788,60282
"8105",1919,"1",29099,30335,59434
"8106",1919,"2",27781,28842,56623
"8107",1919,"3",26618,27222,53840
"8108",1919,"4",27861,29465,57326
"8109",1919,"5",27635,28784,56419
"8110",1919,"6",27691,28844,56535
"8111",1919,"7",27336,28414,55750
"8112",1919,"8",27186,28163,55349
"8113",1919,"9",27841,28904,56745
"8114",1919,"10",26763,28194,54957
"8115",1919,"11",26817,27663,54480
"8116",1919,"12",26808,27870,54678
"8117",1919,"13",26682,27350,54032
"8118",1919,"14",26876,27674,54550
"8119",1919,"15",27003,27619,54622
"8120",1919,"16",26920,27594,54514
"8121",1919,"17",26835,27213,54048
"8122",1919,"18",25976,25945,51921
"8123",1919,"19",25595,25382,50977
"8124",1919,"20",25124,24643,49767
"8125",1919,"21",24571,23721,48292
"8126",1919,"22",23516,22973,46489
"8127",1919,"23",23022,22451,45473
"8128",1919,"24",21777,20882,42659
"8129",1919,"25",21621,20530,42151
"8130",1919,"26",20155,19217,39372
"8131",1919,"27",20332,18912,39244
"8132",1919,"28",19181,17637,36818
"8133",1919,"29",18281,16534,34815
"8134",1919,"30",18132,16254,34386
"8135",1919,"31",18298,16347,34645
"8136",1919,"32",17324,15483,32807
"8137",1919,"33",17367,15095,32462
"8138",1919,"34",16776,14610,31386
"8139",1919,"35",16324,14014,30338
"8140",1919,"36",15565,13559,29124
"8141",1919,"37",15132,13212,28344
"8142",1919,"38",15075,13223,28298
"8143",1919,"39",15641,13869,29510
"8144",1919,"40",15108,13324,28432
"8145",1919,"41",14935,13664,28599
"8146",1919,"42",14823,13161,27984
"8147",1919,"43",14222,12960,27182
"8148",1919,"44",13562,12364,25926
"8149",1919,"45",13113,11605,24718
"8150",1919,"46",12898,11341,24239
"8151",1919,"47",12369,10988,23357
"8152",1919,"48",12046,10434,22480
"8153",1919,"49",11881,10134,22015
"8154",1919,"50",11667,10025,21692
"8155",1919,"51",11568,9871,21439
"8156",1919,"52",11936,10209,22145
"8157",1919,"53",12032,10040,22072
"8158",1919,"54",11733,9832,21565
"8159",1919,"55",11578,9709,21287
"8160",1919,"56",10767,8924,19691
"8161",1919,"57",10156,8306,18462
"8162",1919,"58",10274,8535,18809
"8163",1919,"59",10539,8912,19451
"8164",1919,"60",9843,8303,18146
"8165",1919,"61",9601,8198,17799
"8166",1919,"62",9326,7861,17187
"8167",1919,"63",9469,7965,17434
"8168",1919,"64",9555,7894,17449
"8169",1919,"65",8668,7204,15872
"8170",1919,"66",7952,6499,14451
"8171",1919,"67",7919,6650,14569
"8172",1919,"68",7344,6071,13415
"8173",1919,"69",7337,6133,13470
"8174",1919,"70",6470,5410,11880
"8175",1919,"71",6275,5199,11474
"8176",1919,"72",5887,4843,10730
"8177",1919,"73",5801,4665,10466
"8178",1919,"74",5262,4271,9533
"8179",1919,"75",5007,3982,8989
"8180",1919,"76",4509,3614,8123
"8181",1919,"77",4126,3384,7510
"8182",1919,"78",3594,2779,6373
"8183",1919,"79",3104,2385,5489
"8184",1919,"80",2732,2145,4877
"8185",1919,"81",2555,1967,4522
"8186",1919,"82",2527,1840,4367
"8187",1919,"83",2283,1739,4022
"8188",1919,"84",1862,1338,3200
"8189",1919,"85",1685,1273,2958
"8190",1919,"86",1313,1029,2342
"8191",1919,"87",1012,697,1709
"8192",1919,"88",954,649,1603
"8193",1919,"89",696,487,1183
"8194",1919,"90",538,360,898
"8195",1919,"91",446,288,734
"8196",1919,"92",338,206,544
"8197",1919,"93",237,148,385
"8198",1919,"94",150,76,226
"8199",1919,"95",110,64,174
"8200",1919,"96",57,32,89
"8201",1919,"97",39,32,71
"8202",1919,"98",36,16,52
"8203",1919,"99",10,4,14
"8204",1919,"100",11,2,13
"8205",1919,"101",7,1,8
"8206",1919,"102",1,0,1
"8207",1919,"103",0,0,0
"8208",1919,"104",1,0,1
"8209",1919,"105",0,0,0
"8210",1919,"106",0,0,0
"8211",1919,"107",0,0,0
"8212",1919,"108",0,0,0
"8213",1919,"109",0,0,0
"8214",1919,"110+",0,0,0
"8215",1920,"0",27216,29245,56461
"8216",1920,"1",28817,29959,58776
"8217",1920,"2",28972,30128,59100
"8218",1920,"3",27782,28846,56628
"8219",1920,"4",26665,27189,53854
"8220",1920,"5",27862,29461,57323
"8221",1920,"6",27575,28751,56326
"8222",1920,"7",27660,28808,56468
"8223",1920,"8",27317,28380,55697
"8224",1920,"9",27138,28123,55261
"8225",1920,"10",27796,28869,56665
"8226",1920,"11",26734,28162,54896
"8227",1920,"12",26783,27651,54434
"8228",1920,"13",26749,27841,54590
"8229",1920,"14",26638,27305,53943
"8230",1920,"15",26774,27572,54346
"8231",1920,"16",26913,27426,54339
"8232",1920,"17",26775,27334,54109
"8233",1920,"18",26664,26913,53577
"8234",1920,"19",25784,25606,51390
"8235",1920,"20",25414,24975,50389
"8236",1920,"21",24921,24301,49222
"8237",1920,"22",24381,23387,47768
"8238",1920,"23",23323,22677,46000
"8239",1920,"24",22861,22203,45064
"8240",1920,"25",21608,20689,42297
"8241",1920,"26",21443,20349,41792
"8242",1920,"27",19999,19065,39064
"8243",1920,"28",20139,18799,38938
"8244",1920,"29",19057,17573,36630
"8245",1920,"30",18137,16483,34620
"8246",1920,"31",18009,16220,34229
"8247",1920,"32",18156,16309,34465
"8248",1920,"33",17166,15444,32610
"8249",1920,"34",17239,15066,32305
"8250",1920,"35",16672,14586,31258
"8251",1920,"36",16225,14008,30233
"8252",1920,"37",15447,13549,28996
"8253",1920,"38",15006,13181,28187
"8254",1920,"39",14942,13195,28137
"8255",1920,"40",15523,13848,29371
"8256",1920,"41",14992,13313,28305
"8257",1920,"42",14841,13622,28463
"8258",1920,"43",14718,13118,27836
"8259",1920,"44",14098,12915,27013
"8260",1920,"45",13441,12310,25751
"8261",1920,"46",12967,11557,24524
"8262",1920,"47",12780,11296,24076
"8263",1920,"48",12269,10898,23167
"8264",1920,"49",11939,10353,22292
"8265",1920,"50",11761,10040,21801
"8266",1920,"51",11575,9956,21531
"8267",1920,"52",11441,9786,21227
"8268",1920,"53",11815,10095,21910
"8269",1920,"54",11905,9951,21856
"8270",1920,"55",11595,9726,21321
"8271",1920,"56",11423,9590,21013
"8272",1920,"57",10630,8822,19452
"8273",1920,"58",9973,8169,18142
"8274",1920,"59",10108,8382,18490
"8275",1920,"60",10344,8735,19079
"8276",1920,"61",9660,8149,17809
"8277",1920,"62",9413,8032,17445
"8278",1920,"63",9122,7716,16838
"8279",1920,"64",9250,7787,17037
"8280",1920,"65",9340,7661,17001
"8281",1920,"66",8465,6988,15453
"8282",1920,"67",7769,6333,14102
"8283",1920,"68",7688,6414,14102
"8284",1920,"69",7098,5849,12947
"8285",1920,"70",7056,5885,12941
"8286",1920,"71",6253,5224,11477
"8287",1920,"72",6025,4910,10935
"8288",1920,"73",5609,4569,10178
"8289",1920,"74",5490,4395,9885
"8290",1920,"75",4943,3978,8921
"8291",1920,"76",4681,3687,8368
"8292",1920,"77",4199,3308,7507
"8293",1920,"78",3819,3102,6921
"8294",1920,"79",3289,2520,5809
"8295",1920,"80",2780,1986,4766
"8296",1920,"81",2473,1903,4376
"8297",1920,"82",2282,1701,3983
"8298",1920,"83",2233,1608,3841
"8299",1920,"84",1972,1454,3426
"8300",1920,"85",1600,1127,2727
"8301",1920,"86",1417,1054,2471
"8302",1920,"87",1101,831,1932
"8303",1920,"88",830,552,1382
"8304",1920,"89",741,490,1231
"8305",1920,"90",547,352,899
"8306",1920,"91",418,276,694
"8307",1920,"92",320,212,532
"8308",1920,"93",245,135,380
"8309",1920,"94",175,104,279
"8310",1920,"95",94,46,140
"8311",1920,"96",67,45,112
"8312",1920,"97",41,20,61
"8313",1920,"98",22,21,43
"8314",1920,"99",23,11,34
"8315",1920,"100",8,2,10
"8316",1920,"101",5,1,6
"8317",1920,"102",3,1,4
"8318",1920,"103",0,0,0
"8319",1920,"104",0,0,0
"8320",1920,"105",1,0,1
"8321",1920,"106",0,0,0
"8322",1920,"107",0,0,0
"8323",1920,"108",0,0,0
"8324",1920,"109",0,0,0
"8325",1920,"110+",0,0,0
"8326",1921,"0",32263,33742,66005
"8327",1921,"1",26574,28361,54935
"8328",1921,"2",28623,29750,58373
"8329",1921,"3",28978,30105,59083
"8330",1921,"4",27850,28933,56783
"8331",1921,"5",26763,27209,53972
"8332",1921,"6",27931,29509,57440
"8333",1921,"7",27578,28754,56332
"8334",1921,"8",27656,28803,56459
"8335",1921,"9",27310,28372,55682
"8336",1921,"10",27114,28094,55208
"8337",1921,"11",27770,28849,56619
"8338",1921,"12",26711,28173,54884
"8339",1921,"13",26768,27644,54412
"8340",1921,"14",26695,27802,54497
"8341",1921,"15",26578,27235,53813
"8342",1921,"16",26634,27442,54076
"8343",1921,"17",26739,27173,53912
"8344",1921,"18",26514,26933,53447
"8345",1921,"19",26393,26409,52802
"8346",1921,"20",25506,25077,50583
"8347",1921,"21",25122,24475,49597
"8348",1921,"22",24660,23798,48458
"8349",1921,"23",24143,22993,47136
"8350",1921,"24",23102,22285,45387
"8351",1921,"25",22646,21903,44549
"8352",1921,"26",21409,20429,41838
"8353",1921,"27",21256,20163,41419
"8354",1921,"28",19834,18908,38742
"8355",1921,"29",19978,18655,38633
"8356",1921,"30",18945,17510,36455
"8357",1921,"31",17981,16422,34403
"8358",1921,"32",17894,16175,34069
"8359",1921,"33",18024,16263,34287
"8360",1921,"34",17053,15413,32466
"8361",1921,"35",17091,15023,32114
"8362",1921,"36",16563,14583,31146
"8363",1921,"37",16100,14007,30107
"8364",1921,"38",16348,13545,29893
"8365",1921,"39",14894,13147,28041
"8366",1921,"40",14842,13170,28012
"8367",1921,"41",15409,13810,29219
"8368",1921,"42",14899,13289,28188
"8369",1921,"43",14733,13579,28312
"8370",1921,"44",14601,13054,27655
"8371",1921,"45",14011,12839,26850
"8372",1921,"46",13339,12244,25583
"8373",1921,"47",12867,11490,24357
"8374",1921,"48",12674,11250,23924
"8375",1921,"49",12181,10826,23007
"8376",1921,"50",11847,10295,22142
"8377",1921,"51",11655,9975,21630
"8378",1921,"52",11464,9907,21371
"8379",1921,"53",11341,9705,21046
"8380",1921,"54",11722,10000,21722
"8381",1921,"55",11765,9849,21614
"8382",1921,"56",11449,9625,21074
"8383",1921,"57",11288,9485,20773
"8384",1921,"58",10478,8700,19178
"8385",1921,"59",9806,8039,17845
"8386",1921,"60",9941,8208,18149
"8387",1921,"61",10147,8569,18716
"8388",1921,"62",9490,7984,17474
"8389",1921,"63",9246,7828,17074
"8390",1921,"64",8926,7545,16471
"8391",1921,"65",9063,7570,16633
"8392",1921,"66",9108,7459,16567
"8393",1921,"67",8260,6775,15035
"8394",1921,"68",7560,6149,13709
"8395",1921,"69",7446,6180,13626
"8396",1921,"70",6825,5622,12447
"8397",1921,"71",6802,5610,12412
"8398",1921,"72",6011,5006,11017
"8399",1921,"73",5774,4641,10415
"8400",1921,"74",5344,4293,9637
"8401",1921,"75",5153,4112,9265
"8402",1921,"76",4638,3681,8319
"8403",1921,"77",4342,3417,7759
"8404",1921,"78",3845,3049,6894
"8405",1921,"79",3502,2805,6307
"8406",1921,"80",3243,2477,5720
"8407",1921,"81",2544,1785,4329
"8408",1921,"82",2198,1692,3890
"8409",1921,"83",2008,1463,3471
"8410",1921,"84",1929,1361,3290
"8411",1921,"85",1709,1218,2927
"8412",1921,"86",1354,942,2296
"8413",1921,"87",1166,833,1999
"8414",1921,"88",881,653,1534
"8415",1921,"89",647,441,1088
"8416",1921,"90",587,360,947
"8417",1921,"91",412,270,682
"8418",1921,"92",319,208,527
"8419",1921,"93",229,147,376
"8420",1921,"94",169,100,269
"8421",1921,"95",116,73,189
"8422",1921,"96",71,36,107
"8423",1921,"97",37,32,69
"8424",1921,"98",28,10,38
"8425",1921,"99",12,13,25
"8426",1921,"100",12,6,18
"8427",1921,"101",6,1,7
"8428",1921,"102",4,1,5
"8429",1921,"103",2,0,2
"8430",1921,"104",0,0,0
"8431",1921,"105",0,0,0
"8432",1921,"106",1,0,1
"8433",1921,"107",0,0,0
"8434",1921,"108",0,0,0
"8435",1921,"109",0,0,0
"8436",1921,"110+",0,0,0
"8437",1922,"0",30510,31666,62176
"8438",1922,"1",31684,32951,64635
"8439",1922,"2",26435,28188,54623
"8440",1922,"3",28542,29620,58162
"8441",1922,"4",28853,29969,58822
"8442",1922,"5",27761,28818,56579
"8443",1922,"6",26709,27149,53858
"8444",1922,"7",27852,29391,57243
"8445",1922,"8",27504,28676,56180
"8446",1922,"9",27573,28700,56273
"8447",1922,"10",27214,28251,55465
"8448",1922,"11",27013,27962,54975
"8449",1922,"12",27651,28689,56340
"8450",1922,"13",26603,28019,54622
"8451",1922,"14",26644,27477,54121
"8452",1922,"15",26541,27626,54167
"8453",1922,"16",26372,27047,53419
"8454",1922,"17",26407,27189,53596
"8455",1922,"18",26485,26877,53362
"8456",1922,"19",26273,26582,52855
"8457",1922,"20",26093,26065,52158
"8458",1922,"21",25255,24786,50041
"8459",1922,"22",24885,24214,49099
"8460",1922,"23",24418,23538,47956
"8461",1922,"24",23880,22779,46659
"8462",1922,"25",22861,22093,44954
"8463",1922,"26",22424,21748,44172
"8464",1922,"27",21200,20276,41476
"8465",1922,"28",21058,19985,41043
"8466",1922,"29",19649,18782,38431
"8467",1922,"30",19814,18530,38344
"8468",1922,"31",18780,17381,36161
"8469",1922,"32",17843,16313,34156
"8470",1922,"33",17744,16086,33830
"8471",1922,"34",17883,16179,34062
"8472",1922,"35",16933,15342,32275
"8473",1922,"36",16962,14937,31899
"8474",1922,"37",16422,14499,30921
"8475",1922,"38",15997,13921,29918
"8476",1922,"39",16122,13465,29587
"8477",1922,"40",14818,13086,27904
"8478",1922,"41",14735,13105,27840
"8479",1922,"42",15304,13720,29024
"8480",1922,"43",14790,13222,28012
"8481",1922,"44",14649,13490,28139
"8482",1922,"45",14512,12976,27488
"8483",1922,"46",13901,12730,26631
"8484",1922,"47",13242,12141,25383
"8485",1922,"48",12770,11413,24183
"8486",1922,"49",12560,11141,23701
"8487",1922,"50",12068,10705,22773
"8488",1922,"51",11754,10207,21961
"8489",1922,"52",11521,9860,21381
"8490",1922,"53",11348,9813,21161
"8491",1922,"54",11206,9592,20798
"8492",1922,"55",11593,9884,21477
"8493",1922,"56",11642,9714,21356
"8494",1922,"57",11312,9476,20788
"8495",1922,"58",11155,9356,20511
"8496",1922,"59",10364,8562,18926
"8497",1922,"60",9672,7899,17571
"8498",1922,"61",9773,8052,17825
"8499",1922,"62",9970,8398,18368
"8500",1922,"63",9318,7818,17136
"8501",1922,"64",9077,7625,16702
"8502",1922,"65",8716,7333,16049
"8503",1922,"66",8854,7345,16199
"8504",1922,"67",8895,7226,16121
"8505",1922,"68",8069,6564,14633
"8506",1922,"69",7347,5940,13287
"8507",1922,"70",7184,5935,13119
"8508",1922,"71",6592,5376,11968
"8509",1922,"72",6555,5366,11921
"8510",1922,"73",5756,4740,10496
"8511",1922,"74",5506,4409,9915
"8512",1922,"75",5067,4047,9114
"8513",1922,"76",4871,3833,8704
"8514",1922,"77",4320,3400,7720
"8515",1922,"78",4042,3136,7178
"8516",1922,"79",3586,2777,6363
"8517",1922,"80",2997,2408,5405
"8518",1922,"81",2923,2212,5135
"8519",1922,"82",2299,1596,3895
"8520",1922,"83",1958,1469,3427
"8521",1922,"84",1765,1270,3035
"8522",1922,"85",1687,1138,2825
"8523",1922,"86",1445,1007,2452
"8524",1922,"87",1142,771,1913
"8525",1922,"88",981,665,1646
"8526",1922,"89",687,515,1202
"8527",1922,"90",528,327,855
"8528",1922,"91",446,273,719
"8529",1922,"92",325,204,529
"8530",1922,"93",231,136,367
"8531",1922,"94",168,105,273
"8532",1922,"95",113,69,182
"8533",1922,"96",71,44,115
"8534",1922,"97",47,18,65
"8535",1922,"98",25,23,48
"8536",1922,"99",16,8,24
"8537",1922,"100",8,6,14
"8538",1922,"101",5,2,7
"8539",1922,"102",1,1,2
"8540",1922,"103",3,0,3
"8541",1922,"104",2,0,2
"8542",1922,"105",0,0,0
"8543",1922,"106",0,0,0
"8544",1922,"107",0,0,0
"8545",1922,"108",0,0,0
"8546",1922,"109",0,0,0
"8547",1922,"110+",0,0,0
"8548",1923,"0",29765,30721,60486
"8549",1923,"1",29847,30859,60706
"8550",1923,"2",31453,32718,64171
"8551",1923,"3",26370,28078,54448
"8552",1923,"4",28471,29524,57995
"8553",1923,"5",28750,29846,58596
"8554",1923,"6",27695,28717,56412
"8555",1923,"7",26637,27082,53719
"8556",1923,"8",27790,29296,57086
"8557",1923,"9",27428,28579,56007
"8558",1923,"10",27497,28605,56102
"8559",1923,"11",27116,28134,55250
"8560",1923,"12",26917,27804,54721
"8561",1923,"13",27517,28534,56051
"8562",1923,"14",26478,27855,54333
"8563",1923,"15",26479,27294,53773
"8564",1923,"16",26335,27412,53747
"8565",1923,"17",26136,26764,52900
"8566",1923,"18",26141,26815,52956
"8567",1923,"19",26186,26413,52599
"8568",1923,"20",25968,26074,52042
"8569",1923,"21",25776,25696,51472
"8570",1923,"22",24971,24442,49413
"8571",1923,"23",24625,23869,48494
"8572",1923,"24",24161,23217,47378
"8573",1923,"25",23635,22488,46123
"8574",1923,"26",22630,21877,44507
"8575",1923,"27",22217,21481,43698
"8576",1923,"28",20995,20082,41077
"8577",1923,"29",20849,19802,40651
"8578",1923,"30",19468,18605,38073
"8579",1923,"31",19656,18379,38035
"8580",1923,"32",18624,17234,35858
"8581",1923,"33",17682,16172,33854
"8582",1923,"34",17580,15959,33539
"8583",1923,"35",17750,16082,33832
"8584",1923,"36",16797,15208,32005
"8585",1923,"37",16846,14808,31654
"8586",1923,"38",16269,14374,30643
"8587",1923,"39",15880,13811,29691
"8588",1923,"40",15917,13370,29287
"8589",1923,"41",14717,12977,27694
"8590",1923,"42",14630,13005,27635
"8591",1923,"43",15205,13634,28839
"8592",1923,"44",14672,13108,27780
"8593",1923,"45",14553,13396,27949
"8594",1923,"46",14412,12857,27269
"8595",1923,"47",13797,12601,26398
"8596",1923,"48",13145,12027,25172
"8597",1923,"49",12676,11294,23970
"8598",1923,"50",12427,11028,23455
"8599",1923,"51",11956,10599,22555
"8600",1923,"52",11642,10078,21720
"8601",1923,"53",11387,9734,21121
"8602",1923,"54",11228,9718,20946
"8603",1923,"55",11047,9467,20514
"8604",1923,"56",11446,9760,21206
"8605",1923,"57",11487,9582,21069
"8606",1923,"58",11180,9340,20520
"8607",1923,"59",10997,9209,20206
"8608",1923,"60",10209,8415,18624
"8609",1923,"61",9503,7751,17254
"8610",1923,"62",9621,7872,17493
"8611",1923,"63",9794,8195,17989
"8612",1923,"64",9112,7628,16740
"8613",1923,"65",8885,7435,16320
"8614",1923,"66",8464,7126,15590
"8615",1923,"67",8616,7114,15730
"8616",1923,"68",8635,6968,15603
"8617",1923,"69",7789,6343,14132
"8618",1923,"70",7074,5702,12776
"8619",1923,"71",6902,5677,12579
"8620",1923,"72",6312,5115,11427
"8621",1923,"73",6234,5086,11320
"8622",1923,"74",5455,4430,9885
"8623",1923,"75",5181,4131,9312
"8624",1923,"76",4773,3750,8523
"8625",1923,"77",4519,3534,8053
"8626",1923,"78",3968,3095,7063
"8627",1923,"79",3717,2871,6588
"8628",1923,"80",3451,2604,6055
"8629",1923,"81",2702,2152,4854
"8630",1923,"82",2606,1932,4538
"8631",1923,"83",2033,1376,3409
"8632",1923,"84",1681,1237,2918
"8633",1923,"85",1523,1099,2622
"8634",1923,"86",1429,943,2372
"8635",1923,"87",1173,831,2004
"8636",1923,"88",925,607,1532
"8637",1923,"89",794,500,1294
"8638",1923,"90",530,397,927
"8639",1923,"91",407,235,642
"8640",1923,"92",342,187,529
"8641",1923,"93",227,148,375
"8642",1923,"94",173,97,270
"8643",1923,"95",114,76,190
"8644",1923,"96",72,49,121
"8645",1923,"97",41,30,71
"8646",1923,"98",29,10,39
"8647",1923,"99",14,14,28
"8648",1923,"100",6,3,9
"8649",1923,"101",1,0,1
"8650",1923,"102",2,0,2
"8651",1923,"103",0,1,1
"8652",1923,"104",2,0,2
"8653",1923,"105",2,0,2
"8654",1923,"106",0,0,0
"8655",1923,"107",0,0,0
"8656",1923,"108",0,0,0
"8657",1923,"109",0,0,0
"8658",1923,"110+",0,0,0
"8659",1924,"0",28981,30517,59498
"8660",1924,"1",29126,29967,59093
"8661",1924,"2",29591,30581,60172
"8662",1924,"3",31294,32528,63822
"8663",1924,"4",26292,27974,54266
"8664",1924,"5",28378,29391,57769
"8665",1924,"6",28645,29743,58388
"8666",1924,"7",27601,28607,56208
"8667",1924,"8",26559,27027,53586
"8668",1924,"9",27704,29212,56916
"8669",1924,"10",27352,28479,55831
"8670",1924,"11",27412,28484,55896
"8671",1924,"12",27038,28016,55054
"8672",1924,"13",26821,27639,54460
"8673",1924,"14",27345,28374,55719
"8674",1924,"15",26317,27656,53973
"8675",1924,"16",26249,26954,53203
"8676",1924,"17",26020,26910,52930
"8677",1924,"18",25738,26001,51739
"8678",1924,"19",25753,25871,51624
"8679",1924,"20",25749,25313,51062
"8680",1924,"21",25479,25084,50563
"8681",1924,"22",25330,24640,49970
"8682",1924,"23",24547,23471,48018
"8683",1924,"24",24257,22952,47209
"8684",1924,"25",23786,22415,46201
"8685",1924,"26",23314,21795,45109
"8686",1924,"27",22301,21295,43596
"8687",1924,"28",21901,20960,42861
"8688",1924,"29",20729,19618,40347
"8689",1924,"30",20569,19361,39930
"8690",1924,"31",19238,18242,37480
"8691",1924,"32",19427,18010,37437
"8692",1924,"33",18448,16919,35367
"8693",1924,"34",17524,15856,33380
"8694",1924,"35",17421,15722,33143
"8695",1924,"36",17589,15862,33451
"8696",1924,"37",16659,15006,31665
"8697",1924,"38",16726,14613,31339
"8698",1924,"39",16090,14172,30262
"8699",1924,"40",15756,13567,29323
"8700",1924,"41",15682,13199,28881
"8701",1924,"42",14619,12798,27417
"8702",1924,"43",14515,12815,27330
"8703",1924,"44",15107,13457,28564
"8704",1924,"45",14548,12924,27472
"8705",1924,"46",14446,13257,27703
"8706",1924,"47",14316,12686,27002
"8707",1924,"48",13671,12421,26092
"8708",1924,"49",13045,11853,24898
"8709",1924,"50",12581,11153,23734
"8710",1924,"51",12292,10854,23146
"8711",1924,"52",11828,10462,22290
"8712",1924,"53",11512,9963,21475
"8713",1924,"54",11258,9566,20824
"8714",1924,"55",11128,9607,20735
"8715",1924,"56",10903,9339,20242
"8716",1924,"57",11297,9602,20899
"8717",1924,"58",11326,9400,20726
"8718",1924,"59",11015,9148,20163
"8719",1924,"60",10854,9020,19874
"8720",1924,"61",10050,8272,18322
"8721",1924,"62",9337,7579,16916
"8722",1924,"63",9464,7697,17161
"8723",1924,"64",9608,7994,17602
"8724",1924,"65",8922,7423,16345
"8725",1924,"66",8654,7225,15879
"8726",1924,"67",8239,6901,15140
"8727",1924,"68",8366,6880,15246
"8728",1924,"69",8356,6747,15103
"8729",1924,"70",7513,6088,13601
"8730",1924,"71",6810,5446,12256
"8731",1924,"72",6603,5395,11998
"8732",1924,"73",6002,4847,10849
"8733",1924,"74",5918,4805,10723
"8734",1924,"75",5152,4139,9291
"8735",1924,"76",4866,3852,8718
"8736",1924,"77",4452,3457,7909
"8737",1924,"78",4183,3239,7422
"8738",1924,"79",3655,2797,6452
"8739",1924,"80",3206,2355,5561
"8740",1924,"81",3079,2319,5398
"8741",1924,"82",2401,1873,4274
"8742",1924,"83",2292,1670,3962
"8743",1924,"84",1761,1159,2920
"8744",1924,"85",1452,1036,2488
"8745",1924,"86",1269,930,2199
"8746",1924,"87",1193,768,1961
"8747",1924,"88",939,660,1599
"8748",1924,"89",720,467,1187
"8749",1924,"90",607,381,988
"8750",1924,"91",419,285,704
"8751",1924,"92",301,179,480
"8752",1924,"93",247,119,366
"8753",1924,"94",158,101,259
"8754",1924,"95",124,60,184
"8755",1924,"96",78,48,126
"8756",1924,"97",49,27,76
"8757",1924,"98",25,19,44
"8758",1924,"99",20,4,24
"8759",1924,"100",8,9,17
"8760",1924,"101",3,2,5
"8761",1924,"102",0,0,0
"8762",1924,"103",2,0,2
"8763",1924,"104",0,0,0
"8764",1924,"105",0,0,0
"8765",1924,"106",0,0,0
"8766",1924,"107",0,0,0
"8767",1924,"108",0,0,0
"8768",1924,"109",0,0,0
"8769",1924,"110+",0,0,0
"8770",1925,"0",27121,28826,55947
"8771",1925,"1",28439,29872,58311
"8772",1925,"2",28928,29735,58663
"8773",1925,"3",29456,30409,59865
"8774",1925,"4",31234,32428,63662
"8775",1925,"5",26242,27937,54179
"8776",1925,"6",28325,29339,57664
"8777",1925,"7",28567,29625,58192
"8778",1925,"8",27534,28518,56052
"8779",1925,"9",26510,26976,53486
"8780",1925,"10",27635,29133,56768
"8781",1925,"11",27298,28417,55715
"8782",1925,"12",27333,28376,55709
"8783",1925,"13",26934,27918,54852
"8784",1925,"14",26703,27488,54191
"8785",1925,"15",27186,28213,55399
"8786",1925,"16",26144,27419,53563
"8787",1925,"17",26023,26630,52653
"8788",1925,"18",25791,26494,52285
"8789",1925,"19",25460,25508,50968
"8790",1925,"20",25474,25307,50781
"8791",1925,"21",25446,24765,50211
"8792",1925,"22",25198,24461,49659
"8793",1925,"23",25033,24080,49113
"8794",1925,"24",24284,22946,47230
"8795",1925,"25",23982,22548,46530
"8796",1925,"26",23524,22042,45566
"8797",1925,"27",23104,21452,44556
"8798",1925,"28",22097,20978,43075
"8799",1925,"29",21671,20705,42376
"8800",1925,"30",20530,19388,39918
"8801",1925,"31",20399,19170,39569
"8802",1925,"32",19075,18058,37133
"8803",1925,"33",19279,17833,37112
"8804",1925,"34",18298,16761,35059
"8805",1925,"35",17412,15712,33124
"8806",1925,"36",17291,15574,32865
"8807",1925,"37",17468,15710,33178
"8808",1925,"38",16520,14883,31403
"8809",1925,"39",16619,14474,31093
"8810",1925,"40",15945,14032,29977
"8811",1925,"41",15654,13469,29123
"8812",1925,"42",15475,13081,28556
"8813",1925,"43",14534,12692,27226
"8814",1925,"44",14418,12697,27115
"8815",1925,"45",15038,13354,28392
"8816",1925,"46",14452,12792,27244
"8817",1925,"47",14358,13138,27496
"8818",1925,"48",14227,12585,26812
"8819",1925,"49",13548,12287,25835
"8820",1925,"50",12926,11748,24674
"8821",1925,"51",12475,11052,23527
"8822",1925,"52",12163,10705,22868
"8823",1925,"53",11707,10329,22036
"8824",1925,"54",11372,9830,21202
"8825",1925,"55",11116,9422,20538
"8826",1925,"56",11012,9487,20499
"8827",1925,"57",10757,9202,19959
"8828",1925,"58",11128,9455,20583
"8829",1925,"59",11176,9249,20425
"8830",1925,"60",10852,8980,19832
"8831",1925,"61",10718,8863,19581
"8832",1925,"62",9885,8100,17985
"8833",1925,"63",9151,7422,16573
"8834",1925,"64",9249,7495,16744
"8835",1925,"65",9421,7783,17204
"8836",1925,"66",8718,7234,15952
"8837",1925,"67",8448,7024,15472
"8838",1925,"68",8005,6690,14695
"8839",1925,"69",8129,6643,14772
"8840",1925,"70",8045,6471,14516
"8841",1925,"71",7254,5814,13068
"8842",1925,"72",6559,5218,11777
"8843",1925,"73",6324,5092,11416
"8844",1925,"74",5689,4570,10259
"8845",1925,"75",5609,4515,10124
"8846",1925,"76",4842,3828,8670
"8847",1925,"77",4565,3562,8127
"8848",1925,"78",4142,3181,7323
"8849",1925,"79",3863,2961,6824
"8850",1925,"80",3592,2751,6343
"8851",1925,"81",2910,2101,5011
"8852",1925,"82",2758,2044,4802
"8853",1925,"83",2144,1633,3777
"8854",1925,"84",2005,1438,3443
"8855",1925,"85",1540,979,2519
"8856",1925,"86",1234,872,2106
"8857",1925,"87",1049,767,1816
"8858",1925,"88",970,608,1578
"8859",1925,"89",755,528,1283
"8860",1925,"90",552,359,911
"8861",1925,"91",474,289,763
"8862",1925,"92",316,211,527
"8863",1925,"93",214,132,346
"8864",1925,"94",165,72,237
"8865",1925,"95",110,68,178
"8866",1925,"96",96,38,134
"8867",1925,"97",55,32,87
"8868",1925,"98",34,19,53
"8869",1925,"99",14,11,25
"8870",1925,"100",10,3,13
"8871",1925,"101",3,4,7
"8872",1925,"102",2,0,2
"8873",1925,"103",0,0,0
"8874",1925,"104",0,0,0
"8875",1925,"105",0,0,0
"8876",1925,"106",0,0,0
"8877",1925,"107",0,0,0
"8878",1925,"108",0,0,0
"8879",1925,"109",0,0,0
"8880",1925,"110+",0,0,0
"8881",1926,"0",25513,26648,52161
"8882",1926,"1",26691,28251,54942
"8883",1926,"2",28252,29649,57901
"8884",1926,"3",28795,29569,58364
"8885",1926,"4",29352,30281,59633
"8886",1926,"5",31187,32361,63548
"8887",1926,"6",26216,27880,54096
"8888",1926,"7",28293,29290,57583
"8889",1926,"8",28497,29549,58046
"8890",1926,"9",27466,28431,55897
"8891",1926,"10",26459,26912,53371
"8892",1926,"11",27579,29056,56635
"8893",1926,"12",27252,28329,55581
"8894",1926,"13",27240,28271,55511
"8895",1926,"14",26822,27793,54615
"8896",1926,"15",26568,27333,53901
"8897",1926,"16",27004,27977,54981
"8898",1926,"17",25928,27095,53023
"8899",1926,"18",25755,26218,51973
"8900",1926,"19",25499,26027,51526
"8901",1926,"20",25134,25008,50142
"8902",1926,"21",25178,24852,50030
"8903",1926,"22",25119,24314,49433
"8904",1926,"23",24866,24021,48887
"8905",1926,"24",24710,23714,48424
"8906",1926,"25",24002,22646,46648
"8907",1926,"26",23712,22315,46027
"8908",1926,"27",23276,21779,45055
"8909",1926,"28",22850,21277,44127
"8910",1926,"29",21873,20790,42663
"8911",1926,"30",21493,20517,42010
"8912",1926,"31",20354,19268,39622
"8913",1926,"32",20227,19056,39283
"8914",1926,"33",18906,17949,36855
"8915",1926,"34",19125,17732,36857
"8916",1926,"35",18176,16640,34816
"8917",1926,"36",17268,15625,32893
"8918",1926,"37",17183,15476,32659
"8919",1926,"38",17343,15620,32963
"8920",1926,"39",16428,14799,31227
"8921",1926,"40",16497,14366,30863
"8922",1926,"41",15814,13905,29719
"8923",1926,"42",15550,13363,28913
"8924",1926,"43",15275,12990,28265
"8925",1926,"44",14437,12597,27034
"8926",1926,"45",14301,12623,26924
"8927",1926,"46",14964,13248,28212
"8928",1926,"47",14335,12705,27040
"8929",1926,"48",14254,13029,27283
"8930",1926,"49",14135,12489,26624
"8931",1926,"50",13424,12178,25602
"8932",1926,"51",12802,11609,24411
"8933",1926,"52",12378,10945,23323
"8934",1926,"53",12025,10591,22616
"8935",1926,"54",11598,10205,21803
"8936",1926,"55",11233,9716,20949
"8937",1926,"56",10966,9285,20251
"8938",1926,"57",10892,9373,20265
"8939",1926,"58",10621,9032,19653
"8940",1926,"59",11009,9297,20306
"8941",1926,"60",11025,9074,20099
"8942",1926,"61",10674,8801,19475
"8943",1926,"62",10551,8699,19250
"8944",1926,"63",9697,7907,17604
"8945",1926,"64",8974,7253,16227
"8946",1926,"65",9076,7312,16388
"8947",1926,"66",9208,7561,16769
"8948",1926,"67",8511,6994,15505
"8949",1926,"68",8211,6800,15011
"8950",1926,"69",7772,6433,14205
"8951",1926,"70",7806,6375,14181
"8952",1926,"71",7750,6199,13949
"8953",1926,"72",6955,5551,12506
"8954",1926,"73",6284,4930,11214
"8955",1926,"74",6040,4820,10860
"8956",1926,"75",5408,4282,9690
"8957",1926,"76",5289,4223,9512
"8958",1926,"77",4533,3515,8048
"8959",1926,"78",4241,3281,7522
"8960",1926,"79",3828,2908,6736
"8961",1926,"80",3445,2535,5980
"8962",1926,"81",3286,2455,5741
"8963",1926,"82",2620,1849,4469
"8964",1926,"83",2412,1768,4180
"8965",1926,"84",1864,1423,3287
"8966",1926,"85",1711,1214,2925
"8967",1926,"86",1299,831,2130
"8968",1926,"87",1036,721,1757
"8969",1926,"88",871,637,1508
"8970",1926,"89",794,483,1277
"8971",1926,"90",592,411,1003
"8972",1926,"91",425,281,706
"8973",1926,"92",334,216,550
"8974",1926,"93",238,144,382
"8975",1926,"94",161,93,254
"8976",1926,"95",117,45,162
"8977",1926,"96",84,47,131
"8978",1926,"97",66,22,88
"8979",1926,"98",36,21,57
"8980",1926,"99",21,15,36
"8981",1926,"100",6,5,11
"8982",1926,"101",5,1,6
"8983",1926,"102",3,3,6
"8984",1926,"103",2,0,2
"8985",1926,"104",0,0,0
"8986",1926,"105",0,0,0
"8987",1926,"106",0,0,0
"8988",1926,"107",0,0,0
"8989",1926,"108",0,0,0
"8990",1926,"109",0,0,0
"8991",1926,"110+",0,0,0
"8992",1927,"0",25570,26761,52331
"8993",1927,"1",25142,26211,51353
"8994",1927,"2",26568,28077,54645
"8995",1927,"3",28134,29479,57613
"8996",1927,"4",28684,29471,58155
"8997",1927,"5",29259,30172,59431
"8998",1927,"6",31139,32287,63426
"8999",1927,"7",26162,27844,54006
"9000",1927,"8",28234,29230,57464
"9001",1927,"9",28434,29469,57903
"9002",1927,"10",27416,28338,55754
"9003",1927,"11",26412,26851,53263
"9004",1927,"12",27527,28967,56494
"9005",1927,"13",27183,28244,55427
"9006",1927,"14",27147,28181,55328
"9007",1927,"15",26720,27673,54393
"9008",1927,"16",26439,27112,53551
"9009",1927,"17",26774,27649,54423
"9010",1927,"18",25685,26630,52315
"9011",1927,"19",25491,25624,51115
"9012",1927,"20",25213,25389,50602
"9013",1927,"21",24856,24429,49285
"9014",1927,"22",24904,24262,49166
"9015",1927,"23",24791,23721,48512
"9016",1927,"24",24540,23482,48022
"9017",1927,"25",24451,23259,47710
"9018",1927,"26",23705,22253,45958
"9019",1927,"27",23427,21969,45396
"9020",1927,"28",23053,21481,44534
"9021",1927,"29",22608,21022,43630
"9022",1927,"30",21654,20580,42234
"9023",1927,"31",21305,20340,41645
"9024",1927,"32",20171,19116,39287
"9025",1927,"33",20065,18910,38975
"9026",1927,"34",18772,17822,36594
"9027",1927,"35",18992,17608,36600
"9028",1927,"36",18025,16519,34544
"9029",1927,"37",17148,15502,32650
"9030",1927,"38",17064,15360,32424
"9031",1927,"39",17222,15504,32726
"9032",1927,"40",16322,14699,31021
"9033",1927,"41",16400,14286,30686
"9034",1927,"42",15679,13783,29462
"9035",1927,"43",15428,13256,28684
"9036",1927,"44",15069,12895,27964
"9037",1927,"45",14328,12479,26807
"9038",1927,"46",14185,12490,26675
"9039",1927,"47",14852,13148,28000
"9040",1927,"48",14191,12610,26801
"9041",1927,"49",14152,12920,27072
"9042",1927,"50",14047,12376,26423
"9043",1927,"51",13302,12045,25347
"9044",1927,"52",12692,11479,24171
"9045",1927,"53",12285,10839,23124
"9046",1927,"54",11878,10451,22329
"9047",1927,"55",11474,10071,21545
"9048",1927,"56",11087,9593,20680
"9049",1927,"57",10821,9161,19982
"9050",1927,"58",10748,9233,19981
"9051",1927,"59",10457,8868,19325
"9052",1927,"60",10857,9140,19997
"9053",1927,"61",10835,8905,19740
"9054",1927,"62",10498,8625,19123
"9055",1927,"63",10357,8493,18850
"9056",1927,"64",9503,7734,17237
"9057",1927,"65",8786,7059,15845
"9058",1927,"66",8870,7144,16014
"9059",1927,"67",8979,7364,16343
"9060",1927,"68",8271,6763,15034
"9061",1927,"69",7966,6546,14512
"9062",1927,"70",7488,6167,13655
"9063",1927,"71",7540,6128,13668
"9064",1927,"72",7444,5923,13367
"9065",1927,"73",6607,5281,11888
"9066",1927,"74",5996,4654,10650
"9067",1927,"75",5736,4539,10275
"9068",1927,"76",5086,4021,9107
"9069",1927,"77",4935,3894,8829
"9070",1927,"78",4199,3207,7406
"9071",1927,"79",3938,3026,6964
"9072",1927,"80",3414,2675,6089
"9073",1927,"81",3118,2266,5384
"9074",1927,"82",2937,2172,5109
"9075",1927,"83",2305,1631,3936
"9076",1927,"84",2111,1519,3630
"9077",1927,"85",1603,1214,2817
"9078",1927,"86",1462,1021,2483
"9079",1927,"87",1095,692,1787
"9080",1927,"88",859,588,1447
"9081",1927,"89",712,491,1203
"9082",1927,"90",625,386,1011
"9083",1927,"91",452,313,765
"9084",1927,"92",319,211,530
"9085",1927,"93",244,148,392
"9086",1927,"94",173,89,262
"9087",1927,"95",122,67,189
"9088",1927,"96",87,33,120
"9089",1927,"97",50,29,79
"9090",1927,"98",46,7,53
"9091",1927,"99",24,13,37
"9092",1927,"100",11,6,17
"9093",1927,"101",2,3,5
"9094",1927,"102",3,0,3
"9095",1927,"103",2,1,3
"9096",1927,"104",2,0,2
"9097",1927,"105",0,0,0
"9098",1927,"106",0,0,0
"9099",1927,"107",0,0,0
"9100",1927,"108",0,0,0
"9101",1927,"109",0,0,0
"9102",1927,"110+",0,0,0
"9103",1928,"0",23746,24762,48508
"9104",1928,"1",25211,26247,51458
"9105",1928,"2",25032,26019,51051
"9106",1928,"3",26479,27969,54448
"9107",1928,"4",28022,29318,57340
"9108",1928,"5",28588,29359,57947
"9109",1928,"6",29156,30071,59227
"9110",1928,"7",31088,32229,63317
"9111",1928,"8",26129,27794,53923
"9112",1928,"9",28186,29164,57350
"9113",1928,"10",28360,29383,57743
"9114",1928,"11",27359,28251,55610
"9115",1928,"12",26369,26802,53171
"9116",1928,"13",27445,28883,56328
"9117",1928,"14",27119,28160,55279
"9118",1928,"15",27023,28062,55085
"9119",1928,"16",26567,27488,54055
"9120",1928,"17",26241,26790,53031
"9121",1928,"18",26479,27117,53596
"9122",1928,"19",25413,25934,51347
"9123",1928,"20",25169,24840,50009
"9124",1928,"21",24897,24524,49421
"9125",1928,"22",24576,23618,48194
"9126",1928,"23",24574,23503,48077
"9127",1928,"24",24491,23032,47523
"9128",1928,"25",24233,22811,47044
"9129",1928,"26",24112,22733,46845
"9130",1928,"27",23434,21817,45251
"9131",1928,"28",23161,21610,44771
"9132",1928,"29",22825,21174,43999
"9133",1928,"30",22387,20737,43124
"9134",1928,"31",21476,20314,41790
"9135",1928,"32",21109,20148,41257
"9136",1928,"33",19988,18907,38895
"9137",1928,"34",19903,18758,38661
"9138",1928,"35",18617,17649,36266
"9139",1928,"36",18853,17444,36297
"9140",1928,"37",17901,16353,34254
"9141",1928,"38",17011,15375,32386
"9142",1928,"39",16949,15257,32206
"9143",1928,"40",17090,15393,32483
"9144",1928,"41",16216,14598,30814
"9145",1928,"42",16289,14164,30453
"9146",1928,"43",15516,13650,29166
"9147",1928,"44",15339,13123,28462
"9148",1928,"45",14873,12778,27651
"9149",1928,"46",14228,12368,26596
"9150",1928,"47",14060,12363,26423
"9151",1928,"48",14753,13038,27791
"9152",1928,"49",14067,12489,26556
"9153",1928,"50",14044,12782,26826
"9154",1928,"51",13943,12268,26211
"9155",1928,"52",13171,11904,25075
"9156",1928,"53",12580,11324,23904
"9157",1928,"54",12167,10704,22871
"9158",1928,"55",11735,10299,22034
"9159",1928,"56",11343,9930,21273
"9160",1928,"57",10932,9467,20399
"9161",1928,"58",10676,9034,19710
"9162",1928,"59",10616,9104,19720
"9163",1928,"60",10263,8692,18955
"9164",1928,"61",10700,8987,19687
"9165",1928,"62",10642,8728,19370
"9166",1928,"63",10315,8422,18737
"9167",1928,"64",10141,8264,18405
"9168",1928,"65",9292,7539,16831
"9169",1928,"66",8581,6851,15432
"9170",1928,"67",8641,6915,15556
"9171",1928,"68",8731,7095,15826
"9172",1928,"69",8018,6515,14533
"9173",1928,"70",7683,6294,13977
"9174",1928,"71",7226,5911,13137
"9175",1928,"72",7254,5849,13103
"9176",1928,"73",7102,5592,12694
"9177",1928,"74",6288,4962,11250
"9178",1928,"75",5664,4358,10022
"9179",1928,"76",5402,4255,9657
"9180",1928,"77",4745,3700,8445
"9181",1928,"78",4571,3584,8155
"9182",1928,"79",3845,2922,6767
"9183",1928,"80",3654,2685,6339
"9184",1928,"81",3040,2403,5443
"9185",1928,"82",2783,1986,4769
"9186",1928,"83",2593,1894,4487
"9187",1928,"84",1985,1392,3377
"9188",1928,"85",1764,1257,3021
"9189",1928,"86",1355,998,2353
"9190",1928,"87",1220,826,2046
"9191",1928,"88",895,561,1456
"9192",1928,"89",674,469,1143
"9193",1928,"90",536,358,894
"9194",1928,"91",461,273,734
"9195",1928,"92",345,230,575
"9196",1928,"93",234,149,383
"9197",1928,"94",173,86,259
"9198",1928,"95",117,66,183
"9199",1928,"96",77,38,115
"9200",1928,"97",54,16,70
"9201",1928,"98",29,15,44
"9202",1928,"99",31,1,32
"9203",1928,"100",13,7,20
"9204",1928,"101",8,3,11
"9205",1928,"102",0,1,1
"9206",1928,"103",0,0,0
"9207",1928,"104",1,1,2
"9208",1928,"105",0,0,0
"9209",1928,"106",0,0,0
"9210",1928,"107",0,0,0
"9211",1928,"108",0,0,0
"9212",1928,"109",0,0,0
"9213",1928,"110+",0,0,0
"9214",1929,"0",23624,24490,48114
"9215",1929,"1",23441,24353,47794
"9216",1929,"2",25135,26177,51312
"9217",1929,"3",24941,25906,50847
"9218",1929,"4",26397,27881,54278
"9219",1929,"5",27914,29159,57073
"9220",1929,"6",28502,29265,57767
"9221",1929,"7",29051,29966,59017
"9222",1929,"8",31047,32186,63233
"9223",1929,"9",26120,27740,53860
"9224",1929,"10",28136,29108,57244
"9225",1929,"11",28313,29295,57608
"9226",1929,"12",27299,28171,55470
"9227",1929,"13",26307,26761,53068
"9228",1929,"14",27376,28774,56150
"9229",1929,"15",27038,28055,55093
"9230",1929,"16",26904,27908,54812
"9231",1929,"17",26389,27247,53636
"9232",1929,"18",26001,26410,52411
"9233",1929,"19",26172,26555,52727
"9234",1929,"20",25111,25337,50448
"9235",1929,"21",24829,24315,49144
"9236",1929,"22",24573,23960,48533
"9237",1929,"23",24262,23133,47395
"9238",1929,"24",24246,23042,47288
"9239",1929,"25",24152,22595,46747
"9240",1929,"26",23913,22443,46356
"9241",1929,"27",23818,22376,46194
"9242",1929,"28",23170,21583,44753
"9243",1929,"29",22923,21418,44341
"9244",1929,"30",22610,20974,43584
"9245",1929,"31",22176,20588,42764
"9246",1929,"32",21286,20177,41463
"9247",1929,"33",20930,19998,40928
"9248",1929,"34",19823,18768,38591
"9249",1929,"35",19737,18645,38382
"9250",1929,"36",18475,17550,36025
"9251",1929,"37",18724,17356,36080
"9252",1929,"38",17774,16281,34055
"9253",1929,"39",16898,15288,32186
"9254",1929,"40",16837,15160,31997
"9255",1929,"41",16977,15312,32289
"9256",1929,"42",16101,14509,30610
"9257",1929,"43",16181,14058,30239
"9258",1929,"44",15361,13553,28914
"9259",1929,"45",15222,13030,28252
"9260",1929,"46",14662,12690,27352
"9261",1929,"47",14141,12299,26440
"9262",1929,"48",13956,12248,26204
"9263",1929,"49",14652,12936,27588
"9264",1929,"50",13943,12370,26313
"9265",1929,"51",13939,12684,26623
"9266",1929,"52",13831,12159,25990
"9267",1929,"53",13021,11786,24807
"9268",1929,"54",12471,11199,23670
"9269",1929,"55",12056,10568,22624
"9270",1929,"56",11574,10157,21731
"9271",1929,"57",11211,9790,21001
"9272",1929,"58",10789,9326,20115
"9273",1929,"59",10525,8884,19409
"9274",1929,"60",10472,8955,19427
"9275",1929,"61",10083,8539,18622
"9276",1929,"62",10516,8813,19329
"9277",1929,"63",10442,8513,18955
"9278",1929,"64",10117,8205,18322
"9279",1929,"65",9914,8061,17975
"9280",1929,"66",9054,7344,16398
"9281",1929,"67",8352,6647,14999
"9282",1929,"68",8396,6673,15069
"9283",1929,"69",8473,6825,15298
"9284",1929,"70",7767,6231,13998
"9285",1929,"71",7409,6033,13442
"9286",1929,"72",6945,5628,12573
"9287",1929,"73",6958,5539,12497
"9288",1929,"74",6749,5282,12031
"9289",1929,"75",5915,4642,10557
"9290",1929,"76",5331,4078,9409
"9291",1929,"77",5050,3951,9001
"9292",1929,"78",4397,3386,7783
"9293",1929,"79",4230,3273,7503
"9294",1929,"80",3679,2731,6410
"9295",1929,"81",3282,2393,5675
"9296",1929,"82",2720,2138,4858
"9297",1929,"83",2456,1701,4157
"9298",1929,"84",2304,1642,3946
"9299",1929,"85",1732,1169,2901
"9300",1929,"86",1503,1049,2552
"9301",1929,"87",1120,823,1943
"9302",1929,"88",999,675,1674
"9303",1929,"89",725,449,1174
"9304",1929,"90",529,358,887
"9305",1929,"91",424,255,679
"9306",1929,"92",333,199,532
"9307",1929,"93",259,179,438
"9308",1929,"94",154,100,254
"9309",1929,"95",118,64,182
"9310",1929,"96",82,48,130
"9311",1929,"97",46,24,70
"9312",1929,"98",33,12,45
"9313",1929,"99",17,8,25
"9314",1929,"100",15,0,15
"9315",1929,"101",9,5,14
"9316",1929,"102",3,2,5
"9317",1929,"103",0,1,1
"9318",1929,"104",0,0,0
"9319",1929,"105",0,1,1
"9320",1929,"106",0,0,0
"9321",1929,"107",0,0,0
"9322",1929,"108",0,0,0
"9323",1929,"109",0,0,0
"9324",1929,"110+",0,0,0
"9325",1930,"0",22568,23811,46379
"9326",1930,"1",23272,23999,47271
"9327",1930,"2",23355,24256,47611
"9328",1930,"3",25111,26166,51277
"9329",1930,"4",24884,25812,50696
"9330",1930,"5",26333,27788,54121
"9331",1930,"6",27803,29025,56828
"9332",1930,"7",28417,29170,57587
"9333",1930,"8",28961,29870,58831
"9334",1930,"9",30985,32113,63098
"9335",1930,"10",26082,27707,53789
"9336",1930,"11",28104,29048,57152
"9337",1930,"12",28239,29213,57452
"9338",1930,"13",27230,28083,55313
"9339",1930,"14",26225,26706,52931
"9340",1930,"15",27280,28654,55934
"9341",1930,"16",26876,27896,54772
"9342",1930,"17",26724,27694,54418
"9343",1930,"18",26181,26861,53042
"9344",1930,"19",25745,25880,51625
"9345",1930,"20",25842,25984,51826
"9346",1930,"21",24802,24775,49577
"9347",1930,"22",24537,23808,48345
"9348",1930,"23",24292,23496,47788
"9349",1930,"24",23965,22664,46629
"9350",1930,"25",23964,22621,46585
"9351",1930,"26",23879,22225,46104
"9352",1930,"27",23636,22109,45745
"9353",1930,"28",23528,22102,45630
"9354",1930,"29",22928,21395,44323
"9355",1930,"30",22712,21269,43981
"9356",1930,"31",22416,20804,43220
"9357",1930,"32",21972,20477,42449
"9358",1930,"33",21116,20053,41169
"9359",1930,"34",20758,19891,40649
"9360",1930,"35",19656,18667,38323
"9361",1930,"36",19596,18541,38137
"9362",1930,"37",18331,17479,35810
"9363",1930,"38",18575,17254,35829
"9364",1930,"39",17634,16164,33798
"9365",1930,"40",16798,15196,31994
"9366",1930,"41",16714,15065,31779
"9367",1930,"42",16875,15217,32092
"9368",1930,"43",15992,14426,30418
"9369",1930,"44",16079,13982,30061
"9370",1930,"45",15224,13447,28671
"9371",1930,"46",15122,12918,28040
"9372",1930,"47",14447,12606,27053
"9373",1930,"48",14039,12206,26245
"9374",1930,"49",13845,12141,25986
"9375",1930,"50",14545,12837,27382
"9376",1930,"51",13822,12269,26091
"9377",1930,"52",13819,12548,26367
"9378",1930,"53",13702,12044,25746
"9379",1930,"54",12866,11658,24524
"9380",1930,"55",12336,11037,23373
"9381",1930,"56",11930,10439,22369
"9382",1930,"57",11429,10030,21459
"9383",1930,"58",11043,9637,20680
"9384",1930,"59",10627,9163,19790
"9385",1930,"60",10325,8719,19044
"9386",1930,"61",10330,8801,19131
"9387",1930,"62",9872,8346,18218
"9388",1930,"63",10327,8615,18942
"9389",1930,"64",10220,8298,18518
"9390",1930,"65",9888,7983,17871
"9391",1930,"66",9699,7868,17567
"9392",1930,"67",8827,7135,15962
"9393",1930,"68",8112,6442,14554
"9394",1930,"69",8166,6456,14622
"9395",1930,"70",8197,6560,14757
"9396",1930,"71",7456,5966,13422
"9397",1930,"72",7117,5714,12831
"9398",1930,"73",6612,5316,11928
"9399",1930,"74",6614,5239,11853
"9400",1930,"75",6359,4947,11306
"9401",1930,"76",5545,4336,9881
"9402",1930,"77",4952,3769,8721
"9403",1930,"78",4671,3637,8308
"9404",1930,"79",4038,3069,7107
"9405",1930,"80",3648,2777,6425
"9406",1930,"81",3330,2414,5744
"9407",1930,"82",2914,2103,5017
"9408",1930,"83",2375,1850,4225
"9409",1930,"84",2132,1420,3552
"9410",1930,"85",1935,1391,3326
"9411",1930,"86",1459,953,2412
"9412",1930,"87",1266,815,2081
"9413",1930,"88",919,642,1561
"9414",1930,"89",763,527,1290
"9415",1930,"90",558,339,897
"9416",1930,"91",391,264,655
"9417",1930,"92",306,171,477
"9418",1930,"93",243,126,369
"9419",1930,"94",184,114,298
"9420",1930,"95",106,65,171
"9421",1930,"96",78,39,117
"9422",1930,"97",56,24,80
"9423",1930,"98",31,15,46
"9424",1930,"99",20,10,30
"9425",1930,"100",10,5,15
"9426",1930,"101",8,0,8
"9427",1930,"102",3,3,6
"9428",1930,"103",1,1,2
"9429",1930,"104",0,0,0
"9430",1930,"105",0,0,0
"9431",1930,"106",0,0,0
"9432",1930,"107",0,0,0
"9433",1930,"108",0,0,0
"9434",1930,"109",0,0,0
"9435",1930,"110+",0,0,0
"9436",1931,"0",22479,23676,46155
"9437",1931,"1",22251,23469,45720
"9438",1931,"2",23214,23871,47085
"9439",1931,"3",23373,24245,47618
"9440",1931,"4",25128,26154,51282
"9441",1931,"5",24861,25762,50623
"9442",1931,"6",26325,27740,54065
"9443",1931,"7",27744,28938,56682
"9444",1931,"8",28366,29102,57468
"9445",1931,"9",28916,29786,58702
"9446",1931,"10",30979,32072,63051
"9447",1931,"11",26073,27707,53780
"9448",1931,"12",28084,29017,57101
"9449",1931,"13",28192,29146,57338
"9450",1931,"14",27179,28007,55186
"9451",1931,"15",26155,26640,52795
"9452",1931,"16",27189,28536,55725
"9453",1931,"17",26741,27727,54468
"9454",1931,"18",26576,27430,54006
"9455",1931,"19",26001,26560,52561
"9456",1931,"20",25590,25509,51099
"9457",1931,"21",25607,25603,51210
"9458",1931,"22",24595,24439,49034
"9459",1931,"23",24305,23452,47757
"9460",1931,"24",24081,23154,47235
"9461",1931,"25",23745,22369,46114
"9462",1931,"26",23757,22335,46092
"9463",1931,"27",23672,21978,45650
"9464",1931,"28",23441,21881,45322
"9465",1931,"29",23339,21936,45275
"9466",1931,"30",22783,21275,44058
"9467",1931,"31",22551,21166,43717
"9468",1931,"32",22265,20731,42996
"9469",1931,"33",21823,20415,42238
"9470",1931,"34",20966,19962,40928
"9471",1931,"35",20630,19848,40478
"9472",1931,"36",19536,18602,38138
"9473",1931,"37",19496,18477,37973
"9474",1931,"38",18227,17404,35631
"9475",1931,"39",18470,17184,35654
"9476",1931,"40",17535,16098,33633
"9477",1931,"41",16706,15145,31851
"9478",1931,"42",16634,15000,31634
"9479",1931,"43",16791,15146,31937
"9480",1931,"44",15893,14364,30257
"9481",1931,"45",15996,13913,29909
"9482",1931,"46",15089,13367,28456
"9483",1931,"47",15037,12831,27868
"9484",1931,"48",14246,12536,26782
"9485",1931,"49",13962,12114,26076
"9486",1931,"50",13739,12061,25800
"9487",1931,"51",14438,12748,27186
"9488",1931,"52",13700,12178,25878
"9489",1931,"53",13695,12438,26133
"9490",1931,"54",13589,11934,25523
"9491",1931,"55",12736,11537,24273
"9492",1931,"56",12223,10916,23139
"9493",1931,"57",11810,10329,22139
"9494",1931,"58",11293,9866,21159
"9495",1931,"59",10898,9506,20404
"9496",1931,"60",10487,9004,19491
"9497",1931,"61",10162,8554,18716
"9498",1931,"62",10179,8630,18809
"9499",1931,"63",9716,8153,17869
"9500",1931,"64",10128,8430,18558
"9501",1931,"65",9998,8076,18074
"9502",1931,"66",9652,7793,17445
"9503",1931,"67",9473,7636,17109
"9504",1931,"68",8587,6914,15501
"9505",1931,"69",7848,6201,14049
"9506",1931,"70",7912,6241,14153
"9507",1931,"71",7892,6279,14171
"9508",1931,"72",7150,5693,12843
"9509",1931,"73",6798,5456,12254
"9510",1931,"74",6304,5055,11359
"9511",1931,"75",6259,4919,11178
"9512",1931,"76",5987,4638,10625
"9513",1931,"77",5164,4019,9183
"9514",1931,"78",4595,3492,8087
"9515",1931,"79",4314,3346,7660
"9516",1931,"80",3971,2988,6959
"9517",1931,"81",3303,2458,5761
"9518",1931,"82",2981,2147,5128
"9519",1931,"83",2595,1845,4440
"9520",1931,"84",2091,1605,3696
"9521",1931,"85",1832,1187,3019
"9522",1931,"86",1679,1159,2838
"9523",1931,"87",1234,784,2018
"9524",1931,"88",1057,658,1715
"9525",1931,"89",750,525,1275
"9526",1931,"90",591,407,998
"9527",1931,"91",439,262,701
"9528",1931,"92",292,203,495
"9529",1931,"93",225,135,360
"9530",1931,"94",185,84,269
"9531",1931,"95",122,72,194
"9532",1931,"96",79,45,124
"9533",1931,"97",54,21,75
"9534",1931,"98",39,13,52
"9535",1931,"99",21,11,32
"9536",1931,"100",9,5,14
"9537",1931,"101",4,3,7
"9538",1931,"102",4,0,4
"9539",1931,"103",1,2,3
"9540",1931,"104",1,0,1
"9541",1931,"105",0,0,0
"9542",1931,"106",0,0,0
"9543",1931,"107",0,0,0
"9544",1931,"108",0,0,0
"9545",1931,"109",0,0,0
"9546",1931,"110+",0,0,0
"9547",1932,"0",21763,22628,44391
"9548",1932,"1",22176,23270,45446
"9549",1932,"2",22169,23364,45533
"9550",1932,"3",23143,23795,46938
"9551",1932,"4",23326,24187,47513
"9552",1932,"5",25092,26116,51208
"9553",1932,"6",24838,25728,50566
"9554",1932,"7",26293,27706,53999
"9555",1932,"8",27714,28906,56620
"9556",1932,"9",28328,29072,57400
"9557",1932,"10",28894,29742,58636
"9558",1932,"11",30946,32036,62982
"9559",1932,"12",26059,27669,53728
"9560",1932,"13",28055,28982,57037
"9561",1932,"14",28162,29115,57277
"9562",1932,"15",27120,27954,55074
"9563",1932,"16",26102,26578,52680
"9564",1932,"17",27119,28456,55575
"9565",1932,"18",26647,27625,54272
"9566",1932,"19",26507,27340,53847
"9567",1932,"20",25913,26455,52368
"9568",1932,"21",25496,25434,50930
"9569",1932,"22",25526,25513,51039
"9570",1932,"23",24513,24341,48854
"9571",1932,"24",24248,23394,47642
"9572",1932,"25",23986,23097,47083
"9573",1932,"26",23662,22291,45953
"9574",1932,"27",23675,22271,45946
"9575",1932,"28",23589,21901,45490
"9576",1932,"29",23357,21807,45164
"9577",1932,"30",23245,21841,45086
"9578",1932,"31",22707,21225,43932
"9579",1932,"32",22459,21131,43590
"9580",1932,"33",22194,20692,42886
"9581",1932,"34",21770,20346,42116
"9582",1932,"35",20888,19855,40743
"9583",1932,"36",20567,19760,40327
"9584",1932,"37",19462,18550,38012
"9585",1932,"38",19454,18448,37902
"9586",1932,"39",18139,17343,35482
"9587",1932,"40",18405,17133,35538
"9588",1932,"41",17488,16079,33567
"9589",1932,"42",16633,15118,31751
"9590",1932,"43",16529,14941,31470
"9591",1932,"44",16697,15051,31748
"9592",1932,"45",15818,14260,30078
"9593",1932,"46",15909,13837,29746
"9594",1932,"47",14995,13289,28284
"9595",1932,"48",14950,12750,27700
"9596",1932,"49",14189,12475,26664
"9597",1932,"50",13897,12049,25946
"9598",1932,"51",13646,11967,25613
"9599",1932,"52",14330,12632,26962
"9600",1932,"53",13600,12070,25670
"9601",1932,"54",13579,12337,25916
"9602",1932,"55",13431,11787,25218
"9603",1932,"56",12581,11397,23978
"9604",1932,"57",12092,10781,22873
"9605",1932,"58",11661,10191,21852
"9606",1932,"59",11154,9716,20870
"9607",1932,"60",10748,9353,20101
"9608",1932,"61",10354,8868,19222
"9609",1932,"62",9999,8402,18401
"9610",1932,"63",9998,8478,18476
"9611",1932,"64",9549,7977,17526
"9612",1932,"65",9966,8242,18208
"9613",1932,"66",9744,7866,17610
"9614",1932,"67",9406,7574,16980
"9615",1932,"68",9194,7382,16576
"9616",1932,"69",8330,6636,14966
"9617",1932,"70",7584,5923,13507
"9618",1932,"71",7650,5980,13630
"9619",1932,"72",7564,5963,13527
"9620",1932,"73",6822,5413,12235
"9621",1932,"74",6440,5132,11572
"9622",1932,"75",5935,4698,10633
"9623",1932,"76",5853,4545,10398
"9624",1932,"77",5598,4272,9870
"9625",1932,"78",4781,3684,8465
"9626",1932,"79",4221,3184,7405
"9627",1932,"80",3753,2892,6645
"9628",1932,"81",3540,2664,6204
"9629",1932,"82",2963,2171,5134
"9630",1932,"83",2642,1843,4485
"9631",1932,"84",2253,1582,3835
"9632",1932,"85",1778,1369,3147
"9633",1932,"86",1532,964,2496
"9634",1932,"87",1417,938,2355
"9635",1932,"88",983,624,1607
"9636",1932,"89",818,535,1353
"9637",1932,"90",571,389,960
"9638",1932,"91",453,283,736
"9639",1932,"92",309,202,511
"9640",1932,"93",212,139,351
"9641",1932,"94",151,88,239
"9642",1932,"95",119,51,170
"9643",1932,"96",82,48,130
"9644",1932,"97",43,32,75
"9645",1932,"98",32,10,42
"9646",1932,"99",20,8,28
"9647",1932,"100",15,6,21
"9648",1932,"101",4,4,8
"9649",1932,"102",1,2,3
"9650",1932,"103",2,0,2
"9651",1932,"104",0,0,0
"9652",1932,"105",0,0,0
"9653",1932,"106",0,0,0
"9654",1932,"107",0,0,0
"9655",1932,"108",0,0,0
"9656",1932,"109",0,0,0
"9657",1932,"110+",0,0,0
"9658",1933,"0",21345,22458,43803
"9659",1933,"1",21487,22237,43724
"9660",1933,"2",22074,23183,45257
"9661",1933,"3",22122,23295,45417
"9662",1933,"4",23112,23765,46877
"9663",1933,"5",23288,24152,47440
"9664",1933,"6",25058,26077,51135
"9665",1933,"7",24817,25703,50520
"9666",1933,"8",26284,27678,53962
"9667",1933,"9",27701,28878,56579
"9668",1933,"10",28309,29039,57348
"9669",1933,"11",28866,29698,58564
"9670",1933,"12",30915,32006,62921
"9671",1933,"13",26043,27636,53679
"9672",1933,"14",28024,28952,56976
"9673",1933,"15",28114,29077,57191
"9674",1933,"16",27069,27889,54958
"9675",1933,"17",26040,26505,52545
"9676",1933,"18",27044,28375,55419
"9677",1933,"19",26579,27533,54112
"9678",1933,"20",26440,27260,53700
"9679",1933,"21",25839,26380,52219
"9680",1933,"22",25430,25342,50772
"9681",1933,"23",25458,25438,50896
"9682",1933,"24",24435,24265,48700
"9683",1933,"25",24168,23334,47502
"9684",1933,"26",23911,23036,46947
"9685",1933,"27",23614,22254,45868
"9686",1933,"28",23594,22218,45812
"9687",1933,"29",23515,21835,45350
"9688",1933,"30",23277,21735,45012
"9689",1933,"31",23180,21758,44938
"9690",1933,"32",22638,21197,43835
"9691",1933,"33",22402,21091,43493
"9692",1933,"34",22128,20666,42794
"9693",1933,"35",21707,20282,41989
"9694",1933,"36",20811,19789,40600
"9695",1933,"37",20521,19689,40210
"9696",1933,"38",19389,18484,37873
"9697",1933,"39",19412,18410,37822
"9698",1933,"40",18069,17284,35353
"9699",1933,"41",18347,17101,35448
"9700",1933,"42",17452,16041,33493
"9701",1933,"43",16593,15095,31688
"9702",1933,"44",16458,14872,31330
"9703",1933,"45",16628,14949,31577
"9704",1933,"46",15721,14173,29894
"9705",1933,"47",15835,13766,29601
"9706",1933,"48",14887,13199,28086
"9707",1933,"49",14849,12668,27517
"9708",1933,"50",14104,12424,26528
"9709",1933,"51",13798,11981,25779
"9710",1933,"52",13568,11878,25446
"9711",1933,"53",14223,12508,26731
"9712",1933,"54",13502,11947,25449
"9713",1933,"55",13459,12192,25651
"9714",1933,"56",13289,11646,24935
"9715",1933,"57",12462,11266,23728
"9716",1933,"58",11974,10642,22616
"9717",1933,"59",11500,10065,21565
"9718",1933,"60",11028,9585,20613
"9719",1933,"61",10587,9176,19763
"9720",1933,"62",10199,8735,18934
"9721",1933,"63",9816,8242,18058
"9722",1933,"64",9838,8271,18109
"9723",1933,"65",9349,7769,17118
"9724",1933,"66",9782,8028,17810
"9725",1933,"67",9518,7630,17148
"9726",1933,"68",9190,7353,16543
"9727",1933,"69",8910,7120,16030
"9728",1933,"70",8059,6377,14436
"9729",1933,"71",7326,5686,13012
"9730",1933,"72",7346,5700,13046
"9731",1933,"73",7212,5629,12841
"9732",1933,"74",6477,5108,11585
"9733",1933,"75",6050,4819,10869
"9734",1933,"76",5564,4378,9942
"9735",1933,"77",5418,4210,9628
"9736",1933,"78",5164,3891,9055
"9737",1933,"79",4370,3354,7724
"9738",1933,"80",3934,2976,6910
"9739",1933,"81",3391,2581,5972
"9740",1933,"82",3162,2366,5528
"9741",1933,"83",2606,1904,4510
"9742",1933,"84",2313,1589,3902
"9743",1933,"85",1928,1327,3255
"9744",1933,"86",1482,1121,2603
"9745",1933,"87",1253,788,2041
"9746",1933,"88",1143,743,1886
"9747",1933,"89",778,477,1255
"9748",1933,"90",622,402,1024
"9749",1933,"91",425,295,720
"9750",1933,"92",350,201,551
"9751",1933,"93",216,134,350
"9752",1933,"94",173,95,268
"9753",1933,"95",104,64,168
"9754",1933,"96",83,33,116
"9755",1933,"97",50,26,76
"9756",1933,"98",29,19,48
"9757",1933,"99",17,9,26
"9758",1933,"100",9,5,14
"9759",1933,"101",3,3,6
"9760",1933,"102",2,2,4
"9761",1933,"103",1,0,1
"9762",1933,"104",2,0,2
"9763",1933,"105",0,0,0
"9764",1933,"106",0,0,0
"9765",1933,"107",0,0,0
"9766",1933,"108",0,0,0
"9767",1933,"109",0,0,0
"9768",1933,"110+",0,0,0
"9769",1934,"0",19664,20936,40600
"9770",1934,"1",21061,22102,43163
"9771",1934,"2",21385,22129,43514
"9772",1934,"3",22022,23123,45145
"9773",1934,"4",22083,23261,45344
"9774",1934,"5",23089,23736,46825
"9775",1934,"6",23272,24122,47394
"9776",1934,"7",25041,26050,51091
"9777",1934,"8",24791,25675,50466
"9778",1934,"9",26261,27642,53903
"9779",1934,"10",27692,28856,56548
"9780",1934,"11",28279,29018,57297
"9781",1934,"12",28840,29677,58517
"9782",1934,"13",30892,31980,62872
"9783",1934,"14",26026,27606,53632
"9784",1934,"15",27993,28918,56911
"9785",1934,"16",28079,29036,57115
"9786",1934,"17",26999,27806,54805
"9787",1934,"18",25967,26450,52417
"9788",1934,"19",26976,28298,55274
"9789",1934,"20",26528,27423,53951
"9790",1934,"21",26373,27175,53548
"9791",1934,"22",25782,26296,52078
"9792",1934,"23",25371,25277,50648
"9793",1934,"24",25400,25354,50754
"9794",1934,"25",24368,24193,48561
"9795",1934,"26",24105,23301,47406
"9796",1934,"27",23843,22997,46840
"9797",1934,"28",23557,22228,45785
"9798",1934,"29",23537,22176,45713
"9799",1934,"30",23437,21767,45204
"9800",1934,"31",23217,21679,44896
"9801",1934,"32",23116,21691,44807
"9802",1934,"33",22560,21143,43703
"9803",1934,"34",22341,21038,43379
"9804",1934,"35",22082,20651,42733
"9805",1934,"36",21635,20233,41868
"9806",1934,"37",20754,19728,40482
"9807",1934,"38",20478,19625,40103
"9808",1934,"39",19349,18437,37786
"9809",1934,"40",19353,18367,37720
"9810",1934,"41",18018,17226,35244
"9811",1934,"42",18295,17056,35351
"9812",1934,"43",17416,16027,33443
"9813",1934,"44",16552,15070,31622
"9814",1934,"45",16375,14810,31185
"9815",1934,"46",16535,14865,31400
"9816",1934,"47",15641,14096,29737
"9817",1934,"48",15760,13696,29456
"9818",1934,"49",14793,13145,27938
"9819",1934,"50",14756,12557,27313
"9820",1934,"51",14035,12351,26386
"9821",1934,"52",13719,11921,25640
"9822",1934,"53",13488,11809,25297
"9823",1934,"54",14117,12407,26524
"9824",1934,"55",13392,11813,25205
"9825",1934,"56",13335,12058,25393
"9826",1934,"57",13164,11490,24654
"9827",1934,"58",12322,11137,23459
"9828",1934,"59",11828,10500,22328
"9829",1934,"60",11344,9942,21286
"9830",1934,"61",10881,9440,20321
"9831",1934,"62",10432,9011,19443
"9832",1934,"63",10062,8578,18640
"9833",1934,"64",9647,8060,17707
"9834",1934,"65",9655,8076,17731
"9835",1934,"66",9169,7570,16739
"9836",1934,"67",9552,7799,17351
"9837",1934,"68",9264,7414,16678
"9838",1934,"69",8924,7111,16035
"9839",1934,"70",8622,6845,15467
"9840",1934,"71",7807,6149,13956
"9841",1934,"72",7063,5420,12483
"9842",1934,"73",7031,5433,12464
"9843",1934,"74",6829,5318,12147
"9844",1934,"75",6123,4771,10894
"9845",1934,"76",5687,4436,10123
"9846",1934,"77",5216,4070,9286
"9847",1934,"78",5043,3849,8892
"9848",1934,"79",4785,3561,8346
"9849",1934,"80",4053,2957,7010
"9850",1934,"81",3578,2683,6261
"9851",1934,"82",3026,2270,5296
"9852",1934,"83",2785,2063,4848
"9853",1934,"84",2280,1655,3935
"9854",1934,"85",2025,1329,3354
"9855",1934,"86",1641,1111,2752
"9856",1934,"87",1229,921,2150
"9857",1934,"88",1027,620,1647
"9858",1934,"89",914,605,1519
"9859",1934,"90",612,363,975
"9860",1934,"91",486,297,783
"9861",1934,"92",317,211,528
"9862",1934,"93",248,149,397
"9863",1934,"94",152,90,242
"9864",1934,"95",119,61,180
"9865",1934,"96",71,37,108
"9866",1934,"97",60,19,79
"9867",1934,"98",30,18,48
"9868",1934,"99",20,12,32
"9869",1934,"100",11,6,17
"9870",1934,"101",4,3,7
"9871",1934,"102",1,2,3
"9872",1934,"103",2,1,3
"9873",1934,"104",0,0,0
"9874",1934,"105",0,0,0
"9875",1934,"106",0,0,0
"9876",1934,"107",0,0,0
"9877",1934,"108",0,0,0
"9878",1934,"109",0,0,0
"9879",1934,"110+",0,0,0
"9880",1935,"0",19681,20855,40536
"9881",1935,"1",19439,20680,40119
"9882",1935,"2",20987,22020,43007
"9883",1935,"3",21346,22046,43392
"9884",1935,"4",21978,23050,45028
"9885",1935,"5",22048,23221,45269
"9886",1935,"6",23068,23701,46769
"9887",1935,"7",23257,24100,47357
"9888",1935,"8",25030,26017,51047
"9889",1935,"9",24777,25649,50426
"9890",1935,"10",26241,27625,53866
"9891",1935,"11",27664,28823,56487
"9892",1935,"12",28264,28993,57257
"9893",1935,"13",28819,29654,58473
"9894",1935,"14",30869,31936,62805
"9895",1935,"15",25992,27582,53574
"9896",1935,"16",27963,28862,56825
"9897",1935,"17",28032,28972,57004
"9898",1935,"18",26942,27719,54661
"9899",1935,"19",25910,26386,52296
"9900",1935,"20",26910,28214,55124
"9901",1935,"21",26478,27335,53813
"9902",1935,"22",26326,27081,53407
"9903",1935,"23",25716,26222,51938
"9904",1935,"24",25297,25206,50503
"9905",1935,"25",25337,25286,50623
"9906",1935,"26",24313,24121,48434
"9907",1935,"27",24060,23275,47335
"9908",1935,"28",23787,22969,46756
"9909",1935,"29",23530,22184,45714
"9910",1935,"30",23462,22134,45596
"9911",1935,"31",23377,21705,45082
"9912",1935,"32",23140,21614,44754
"9913",1935,"33",23044,21607,44651
"9914",1935,"34",22511,21110,43621
"9915",1935,"35",22281,20986,43267
"9916",1935,"36",22036,20632,42668
"9917",1935,"37",21572,20175,41747
"9918",1935,"38",20705,19665,40370
"9919",1935,"39",20447,19562,40009
"9920",1935,"40",19284,18369,37653
"9921",1935,"41",19319,18327,37646
"9922",1935,"42",17941,17160,35101
"9923",1935,"43",18261,17025,35286
"9924",1935,"44",17353,15992,33345
"9925",1935,"45",16494,15038,31532
"9926",1935,"46",16302,14745,31047
"9927",1935,"47",16452,14775,31227
"9928",1935,"48",15549,14001,29550
"9929",1935,"49",15685,13619,29304
"9930",1935,"50",14700,13057,27757
"9931",1935,"51",14670,12450,27120
"9932",1935,"52",13952,12270,26222
"9933",1935,"53",13635,11838,25473
"9934",1935,"54",13376,11732,25108
"9935",1935,"55",14000,12291,26291
"9936",1935,"56",13277,11683,24960
"9937",1935,"57",13206,11922,25128
"9938",1935,"58",13003,11322,24325
"9939",1935,"59",12154,10975,23129
"9940",1935,"60",11678,10362,22040
"9941",1935,"61",11175,9794,20969
"9942",1935,"62",10741,9309,20050
"9943",1935,"63",10246,8850,19096
"9944",1935,"64",9896,8405,18301
"9945",1935,"65",9451,7846,17297
"9946",1935,"66",9463,7894,17357
"9947",1935,"67",8944,7346,16290
"9948",1935,"68",9325,7586,16911
"9949",1935,"69",9011,7149,16160
"9950",1935,"70",8632,6826,15458
"9951",1935,"71",8321,6565,14886
"9952",1935,"72",7499,5900,13399
"9953",1935,"73",6777,5155,11932
"9954",1935,"74",6703,5123,11826
"9955",1935,"75",6490,5012,11502
"9956",1935,"76",5766,4486,10252
"9957",1935,"77",5281,4129,9410
"9958",1935,"78",4837,3789,8626
"9959",1935,"79",4624,3495,8119
"9960",1935,"80",4474,3407,7881
"9961",1935,"81",3686,2649,6335
"9962",1935,"82",3259,2397,5656
"9963",1935,"83",2692,2020,4712
"9964",1935,"84",2462,1783,4245
"9965",1935,"85",2003,1397,3400
"9966",1935,"86",1712,1076,2788
"9967",1935,"87",1386,912,2298
"9968",1935,"88",1023,742,1765
"9969",1935,"89",831,487,1318
"9970",1935,"90",708,456,1164
"9971",1935,"91",496,275,771
"9972",1935,"92",369,224,593
"9973",1935,"93",251,166,417
"9974",1935,"94",190,101,291
"9975",1935,"95",102,61,163
"9976",1935,"96",79,45,124
"9977",1935,"97",51,23,74
"9978",1935,"98",38,11,49
"9979",1935,"99",19,13,32
"9980",1935,"100",11,7,18
"9981",1935,"101",7,2,9
"9982",1935,"102",2,2,4
"9983",1935,"103",1,1,2
"9984",1935,"104",1,0,1
"9985",1935,"105",0,0,0
"9986",1935,"106",0,0,0
"9987",1935,"107",0,0,0
"9988",1935,"108",0,0,0
"9989",1935,"109",0,0,0
"9990",1935,"110+",0,0,0
"9991",1936,"0",19604,20372,39976
"9992",1936,"1",19424,20512,39936
"9993",1936,"2",19363,20588,39951
"9994",1936,"3",20941,21950,42891
"9995",1936,"4",21317,21986,43303
"9996",1936,"5",21948,23020,44968
"9997",1936,"6",22033,23188,45221
"9998",1936,"7",23053,23671,46724
"9999",1936,"8",23241,24077,47318
"10000",1936,"9",25016,25997,51013
"10001",1936,"10",24760,25622,50382
"10002",1936,"11",26226,27603,53829
"10003",1936,"12",27637,28800,56437
"10004",1936,"13",28240,28961,57201
"10005",1936,"14",28783,29627,58410
"10006",1936,"15",30837,31909,62746
"10007",1936,"16",25955,27547,53502
"10008",1936,"17",27909,28808,56717
"10009",1936,"18",27976,28921,56897
"10010",1936,"19",26882,27644,54526
"10011",1936,"20",25849,26303,52152
"10012",1936,"21",26833,28126,54959
"10013",1936,"22",26419,27248,53667
"10014",1936,"23",26284,26997,53281
"10015",1936,"24",25662,26158,51820
"10016",1936,"25",25244,25145,50389
"10017",1936,"26",25277,25221,50498
"10018",1936,"27",24249,24076,48325
"10019",1936,"28",24021,23231,47252
"10020",1936,"29",23744,22954,46698
"10021",1936,"30",23503,22160,45663
"10022",1936,"31",23399,22095,45494
"10023",1936,"32",23324,21655,44979
"10024",1936,"33",23080,21557,44637
"10025",1936,"34",22978,21540,44518
"10026",1936,"35",22456,21073,43529
"10027",1936,"36",22222,20930,43152
"10028",1936,"37",21976,20616,42592
"10029",1936,"38",21523,20118,41641
"10030",1936,"39",20644,19601,40245
"10031",1936,"40",20401,19497,39898
"10032",1936,"41",19212,18314,37526
"10033",1936,"42",19273,18284,37557
"10034",1936,"43",17873,17093,34966
"10035",1936,"44",18218,16974,35192
"10036",1936,"45",17295,15957,33252
"10037",1936,"46",16436,15007,31443
"10038",1936,"47",16210,14672,30882
"10039",1936,"48",16347,14665,31012
"10040",1936,"49",15437,13900,29337
"10041",1936,"50",15573,13539,29112
"10042",1936,"51",14622,12971,27593
"10043",1936,"52",14568,12346,26914
"10044",1936,"53",13874,12188,26062
"10045",1936,"54",13542,11760,25302
"10046",1936,"55",13270,11624,24894
"10047",1936,"56",13886,12142,26028
"10048",1936,"57",13179,11553,24732
"10049",1936,"58",13042,11795,24837
"10050",1936,"59",12844,11156,24000
"10051",1936,"60",11983,10799,22782
"10052",1936,"61",11525,10205,21730
"10053",1936,"62",11004,9626,20630
"10054",1936,"63",10566,9132,19698
"10055",1936,"64",10062,8667,18729
"10056",1936,"65",9695,8192,17887
"10057",1936,"66",9228,7645,16873
"10058",1936,"67",9251,7643,16894
"10059",1936,"68",8688,7101,15789
"10060",1936,"69",9061,7330,16391
"10061",1936,"70",8725,6860,15585
"10062",1936,"71",8301,6588,14889
"10063",1936,"72",7997,6224,14221
"10064",1936,"73",7204,5591,12795
"10065",1936,"74",6444,4892,11336
"10066",1936,"75",6328,4801,11129
"10067",1936,"76",6044,4677,10721
"10068",1936,"77",5379,4139,9518
"10069",1936,"78",4861,3793,8654
"10070",1936,"79",4440,3467,7907
"10071",1936,"80",4326,3079,7405
"10072",1936,"81",4015,3036,7051
"10073",1936,"82",3278,2326,5604
"10074",1936,"83",2876,2097,4973
"10075",1936,"84",2343,1743,4086
"10076",1936,"85",2115,1508,3623
"10077",1936,"86",1669,1164,2833
"10078",1936,"87",1425,869,2294
"10079",1936,"88",1119,731,1850
"10080",1936,"89",810,586,1396
"10081",1936,"90",639,361,1000
"10082",1936,"91",550,334,884
"10083",1936,"92",355,203,558
"10084",1936,"93",285,154,439
"10085",1936,"94",174,109,283
"10086",1936,"95",142,64,206
"10087",1936,"96",72,33,105
"10088",1936,"97",56,26,82
"10089",1936,"98",30,17,47
"10090",1936,"99",15,6,21
"10091",1936,"100",9,9,18
"10092",1936,"101",7,5,12
"10093",1936,"102",4,2,6
"10094",1936,"103",2,1,3
"10095",1936,"104",0,0,0
"10096",1936,"105",0,0,0
"10097",1936,"106",0,0,0
"10098",1936,"107",0,0,0
"10099",1936,"108",0,0,0
"10100",1936,"109",0,0,0
"10101",1936,"110+",0,0,0
"10102",1937,"0",19913,20901,40814
"10103",1937,"1",19389,20081,39470
"10104",1937,"2",19361,20420,39781
"10105",1937,"3",19320,20530,39850
"10106",1937,"4",20897,21899,42796
"10107",1937,"5",21292,21949,43241
"10108",1937,"6",21921,22992,44913
"10109",1937,"7",22013,23149,45162
"10110",1937,"8",23026,23654,46680
"10111",1937,"9",23233,24051,47284
"10112",1937,"10",24993,25964,50957
"10113",1937,"11",24728,25604,50332
"10114",1937,"12",26200,27581,53781
"10115",1937,"13",27614,28771,56385
"10116",1937,"14",28206,28925,57131
"10117",1937,"15",28743,29579,58322
"10118",1937,"16",30790,31851,62641
"10119",1937,"17",25907,27494,53401
"10120",1937,"18",27862,28736,56598
"10121",1937,"19",27910,28853,56763
"10122",1937,"20",26823,27542,54365
"10123",1937,"21",25761,26208,51969
"10124",1937,"22",26760,28009,54769
"10125",1937,"23",26353,27153,53506
"10126",1937,"24",26219,26917,53136
"10127",1937,"25",25602,26098,51700
"10128",1937,"26",25188,25068,50256
"10129",1937,"27",25218,25154,50372
"10130",1937,"28",24176,24014,48190
"10131",1937,"29",23977,23204,47181
"10132",1937,"30",23695,22912,46607
"10133",1937,"31",23457,22147,45604
"10134",1937,"32",23351,22047,45398
"10135",1937,"33",23287,21606,44893
"10136",1937,"34",23009,21511,44520
"10137",1937,"35",22919,21483,44402
"10138",1937,"36",22401,21048,43449
"10139",1937,"37",22150,20900,43050
"10140",1937,"38",21910,20588,42498
"10141",1937,"39",21466,20054,41520
"10142",1937,"40",20587,19539,40126
"10143",1937,"41",20352,19440,39792
"10144",1937,"42",19158,18246,37404
"10145",1937,"43",19229,18240,37469
"10146",1937,"44",17797,17038,34835
"10147",1937,"45",18178,16903,35081
"10148",1937,"46",17239,15917,33156
"10149",1937,"47",16370,14973,31343
"10150",1937,"48",16134,14576,30710
"10151",1937,"49",16228,14562,30790
"10152",1937,"50",15340,13807,29147
"10153",1937,"51",15478,13448,28926
"10154",1937,"52",14516,12888,27404
"10155",1937,"53",14458,12211,26669
"10156",1937,"54",13790,12095,25885
"10157",1937,"55",13454,11667,25121
"10158",1937,"56",13166,11515,24681
"10159",1937,"57",13768,12006,25774
"10160",1937,"58",13041,11379,24420
"10161",1937,"59",12898,11613,24511
"10162",1937,"60",12674,10954,23628
"10163",1937,"61",11810,10633,22443
"10164",1937,"62",11357,10033,21390
"10165",1937,"63",10818,9432,20250
"10166",1937,"64",10399,8956,19355
"10167",1937,"65",9879,8445,18324
"10168",1937,"66",9491,7981,17472
"10169",1937,"67",8999,7417,16416
"10170",1937,"68",9016,7437,16453
"10171",1937,"69",8450,6854,15304
"10172",1937,"70",8782,7006,15788
"10173",1937,"71",8415,6587,15002
"10174",1937,"72",7963,6317,14280
"10175",1937,"73",7641,5863,13504
"10176",1937,"74",6875,5307,12182
"10177",1937,"75",6072,4630,10702
"10178",1937,"76",5955,4533,10488
"10179",1937,"77",5609,4317,9926
"10180",1937,"78",4951,3767,8718
"10181",1937,"79",4452,3413,7865
"10182",1937,"80",4194,3312,7506
"10183",1937,"81",3906,2734,6640
"10184",1937,"82",3575,2701,6276
"10185",1937,"83",2881,2011,4892
"10186",1937,"84",2503,1772,4275
"10187",1937,"85",2026,1471,3497
"10188",1937,"86",1776,1247,3023
"10189",1937,"87",1359,949,2308
"10190",1937,"88",1136,682,1818
"10191",1937,"89",903,571,1474
"10192",1937,"90",619,441,1060
"10193",1937,"91",480,271,751
"10194",1937,"92",426,248,674
"10195",1937,"93",260,147,407
"10196",1937,"94",192,102,294
"10197",1937,"95",121,79,200
"10198",1937,"96",95,38,133
"10199",1937,"97",43,20,63
"10200",1937,"98",39,11,50
"10201",1937,"99",18,15,33
"10202",1937,"100",11,3,14
"10203",1937,"101",5,5,10
"10204",1937,"102",5,4,9
"10205",1937,"103",2,1,3
"10206",1937,"104",1,0,1
"10207",1937,"105",0,0,0
"10208",1937,"106",0,0,0
"10209",1937,"107",0,0,0
"10210",1937,"108",0,0,0
"10211",1937,"109",0,0,0
"10212",1937,"110+",0,0,0
"10213",1938,"0",20615,21730,42345
"10214",1938,"1",19692,20619,40311
"10215",1938,"2",19329,19984,39313
"10216",1938,"3",19312,20360,39672
"10217",1938,"4",19282,20484,39766
"10218",1938,"5",20862,21849,42711
"10219",1938,"6",21263,21909,43172
"10220",1938,"7",21896,22943,44839
"10221",1938,"8",21995,23119,45114
"10222",1938,"9",23018,23637,46655
"10223",1938,"10",23218,24020,47238
"10224",1938,"11",24978,25937,50915
"10225",1938,"12",24716,25584,50300
"10226",1938,"13",26174,27555,53729
"10227",1938,"14",27589,28753,56342
"10228",1938,"15",28171,28874,57045
"10229",1938,"16",28699,29509,58208
"10230",1938,"17",30755,31787,62542
"10231",1938,"18",25845,27422,53267
"10232",1938,"19",27810,28645,56455
"10233",1938,"20",27853,28766,56619
"10234",1938,"21",26760,27444,54204
"10235",1938,"22",25694,26107,51801
"10236",1938,"23",26681,27910,54591
"10237",1938,"24",26285,27053,53338
"10238",1938,"25",26160,26848,53008
"10239",1938,"26",25533,26040,51573
"10240",1938,"27",25114,24985,50099
"10241",1938,"28",25161,25099,50260
"10242",1938,"29",24122,23956,48078
"10243",1938,"30",23936,23197,47133
"10244",1938,"31",23647,22883,46530
"10245",1938,"32",23415,22114,45529
"10246",1938,"33",23294,22018,45312
"10247",1938,"34",23221,21557,44778
"10248",1938,"35",22945,21451,44396
"10249",1938,"36",22866,21412,44278
"10250",1938,"37",22347,20996,43343
"10251",1938,"38",22102,20870,42972
"10252",1938,"39",21847,20558,42405
"10253",1938,"40",21413,19992,41405
"10254",1938,"41",20540,19477,40017
"10255",1938,"42",20296,19391,39687
"10256",1938,"43",19104,18162,37266
"10257",1938,"44",19188,18198,37386
"10258",1938,"45",17727,16953,34680
"10259",1938,"46",18129,16850,34979
"10260",1938,"47",17177,15889,33066
"10261",1938,"48",16318,14917,31235
"10262",1938,"49",16041,14492,30533
"10263",1938,"50",16124,14431,30555
"10264",1938,"51",15228,13691,28919
"10265",1938,"52",15380,13361,28741
"10266",1938,"53",14398,12792,27190
"10267",1938,"54",14321,12115,26436
"10268",1938,"55",13678,11984,25662
"10269",1938,"56",13349,11561,24910
"10270",1938,"57",13056,11408,24464
"10271",1938,"58",13629,11838,25467
"10272",1938,"59",12891,11227,24118
"10273",1938,"60",12725,11425,24150
"10274",1938,"61",12490,10759,23249
"10275",1938,"62",11609,10422,22031
"10276",1938,"63",11180,9855,21035
"10277",1938,"64",10605,9224,19829
"10278",1938,"65",10208,8753,18961
"10279",1938,"66",9679,8245,17924
"10280",1938,"67",9281,7763,17044
"10281",1938,"68",8776,7219,15995
"10282",1938,"69",8769,7160,15929
"10283",1938,"70",8191,6594,14785
"10284",1938,"71",8481,6717,15198
"10285",1938,"72",8055,6278,14333
"10286",1938,"73",7573,6020,13593
"10287",1938,"74",7244,5543,12787
"10288",1938,"75",6518,4969,11487
"10289",1938,"76",5700,4332,10032
"10290",1938,"77",5557,4207,9764
"10291",1938,"78",5171,3945,9116
"10292",1938,"79",4538,3419,7957
"10293",1938,"80",4054,3044,7098
"10294",1938,"81",3770,2923,6693
"10295",1938,"82",3495,2411,5906
"10296",1938,"83",3163,2351,5514
"10297",1938,"84",2484,1748,4232
"10298",1938,"85",2142,1482,3624
"10299",1938,"86",1732,1209,2941
"10300",1938,"87",1473,1009,2482
"10301",1938,"88",1102,750,1852
"10302",1938,"89",918,550,1468
"10303",1938,"90",698,431,1129
"10304",1938,"91",479,328,807
"10305",1938,"92",362,200,562
"10306",1938,"93",324,171,495
"10307",1938,"94",176,105,281
"10308",1938,"95",131,64,195
"10309",1938,"96",85,50,135
"10310",1938,"97",63,24,87
"10311",1938,"98",29,8,37
"10312",1938,"99",29,7,36
"10313",1938,"100",11,11,22
"10314",1938,"101",4,2,6
"10315",1938,"102",4,3,7
"10316",1938,"103",3,2,5
"10317",1938,"104",1,0,1
"10318",1938,"105",1,0,1
"10319",1938,"106",0,0,0
"10320",1938,"107",0,0,0
"10321",1938,"108",0,0,0
"10322",1938,"109",0,0,0
"10323",1938,"110+",0,0,0
"10324",1939,"0",21466,22507,43973
"10325",1939,"1",20419,21444,41863
"10326",1939,"2",19623,20534,40157
"10327",1939,"3",19286,19932,39218
"10328",1939,"4",19286,20309,39595
"10329",1939,"5",19263,20439,39702
"10330",1939,"6",20834,21813,42647
"10331",1939,"7",21233,21877,43110
"10332",1939,"8",21877,22918,44795
"10333",1939,"9",21978,23099,45077
"10334",1939,"10",23012,23623,46635
"10335",1939,"11",23199,24001,47200
"10336",1939,"12",24968,25923,50891
"10337",1939,"13",24702,25558,50260
"10338",1939,"14",26163,27537,53700
"10339",1939,"15",27566,28722,56288
"10340",1939,"16",28146,28837,56983
"10341",1939,"17",28653,29444,58097
"10342",1939,"18",30699,31723,62422
"10343",1939,"19",25785,27339,53124
"10344",1939,"20",27755,28565,56320
"10345",1939,"21",27797,28663,56460
"10346",1939,"22",26685,27358,54043
"10347",1939,"23",25624,26035,51659
"10348",1939,"24",26608,27804,54412
"10349",1939,"25",26226,26964,53190
"10350",1939,"26",26104,26784,52888
"10351",1939,"27",25469,25964,51433
"10352",1939,"28",25057,24931,49988
"10353",1939,"29",25113,25031,50144
"10354",1939,"30",24066,23912,47978
"10355",1939,"31",23897,23160,47057
"10356",1939,"32",23578,22866,46444
"10357",1939,"33",23379,22085,45464
"10358",1939,"34",23255,21966,45221
"10359",1939,"35",23168,21515,44683
"10360",1939,"36",22895,21396,44291
"10361",1939,"37",22797,21350,44147
"10362",1939,"38",22292,20941,43233
"10363",1939,"39",22034,20808,42842
"10364",1939,"40",21794,20518,42312
"10365",1939,"41",21349,19917,41266
"10366",1939,"42",20483,19388,39871
"10367",1939,"43",20254,19327,39581
"10368",1939,"44",19041,18116,37157
"10369",1939,"45",19142,18138,37280
"10370",1939,"46",17673,16893,34566
"10371",1939,"47",18062,16808,34870
"10372",1939,"48",17137,15848,32985
"10373",1939,"49",16238,14886,31124
"10374",1939,"50",15955,14406,30361
"10375",1939,"51",16019,14284,30303
"10376",1939,"52",15111,13563,28674
"10377",1939,"53",15275,13256,28531
"10378",1939,"54",14293,12692,26985
"10379",1939,"55",14198,11997,26195
"10380",1939,"56",13572,11884,25456
"10381",1939,"57",13279,11448,24727
"10382",1939,"58",12953,11292,24245
"10383",1939,"59",13467,11672,25139
"10384",1939,"60",12722,11064,23786
"10385",1939,"61",12558,11225,23783
"10386",1939,"62",12300,10569,22869
"10387",1939,"63",11400,10220,21620
"10388",1939,"64",10995,9667,20662
"10389",1939,"65",10394,9000,19394
"10390",1939,"66",9991,8517,18508
"10391",1939,"67",9456,7988,17444
"10392",1939,"68",9064,7542,16606
"10393",1939,"69",8557,6979,15536
"10394",1939,"70",8480,6926,15406
"10395",1939,"71",7946,6342,14288
"10396",1939,"72",8156,6422,14578
"10397",1939,"73",7714,5967,13681
"10398",1939,"74",7214,5671,12885
"10399",1939,"75",6878,5214,12092
"10400",1939,"76",6171,4643,10814
"10401",1939,"77",5347,4019,9366
"10402",1939,"78",5155,3883,9038
"10403",1939,"79",4722,3589,8311
"10404",1939,"80",4302,3144,7446
"10405",1939,"81",3651,2729,6380
"10406",1939,"82",3365,2593,5958
"10407",1939,"83",3113,2119,5232
"10408",1939,"84",2734,2008,4742
"10409",1939,"85",2140,1480,3620
"10410",1939,"86",1838,1213,3051
"10411",1939,"87",1442,976,2418
"10412",1939,"88",1209,810,2019
"10413",1939,"89",869,600,1469
"10414",1939,"90",729,424,1153
"10415",1939,"91",529,322,851
"10416",1939,"92",351,254,605
"10417",1939,"93",268,145,413
"10418",1939,"94",237,120,357
"10419",1939,"95",119,70,189
"10420",1939,"96",84,46,130
"10421",1939,"97",60,32,92
"10422",1939,"98",40,14,54
"10423",1939,"99",19,7,26
"10424",1939,"100",17,5,22
"10425",1939,"101",4,7,11
"10426",1939,"102",2,1,3
"10427",1939,"103",1,2,3
"10428",1939,"104",3,0,3
"10429",1939,"105",0,0,0
"10430",1939,"106",0,0,0
"10431",1939,"107",0,0,0
"10432",1939,"108",0,0,0
"10433",1939,"109",0,0,0
"10434",1939,"110+",0,0,0
"10435",1940,"0",22204,23035,45239
"10436",1940,"1",21259,22233,43492
"10437",1940,"2",20351,21360,41711
"10438",1940,"3",19576,20485,40061
"10439",1940,"4",19251,19886,39137
"10440",1940,"5",19258,20265,39523
"10441",1940,"6",19238,20407,39645
"10442",1940,"7",20817,21787,42604
"10443",1940,"8",21216,21855,43071
"10444",1940,"9",21867,22895,44762
"10445",1940,"10",21963,23082,45045
"10446",1940,"11",23006,23603,46609
"10447",1940,"12",23191,23982,47173
"10448",1940,"13",24957,25896,50853
"10449",1940,"14",24692,25537,50229
"10450",1940,"15",26139,27518,53657
"10451",1940,"16",27537,28673,56210
"10452",1940,"17",28120,28803,56923
"10453",1940,"18",28610,29379,57989
"10454",1940,"19",30645,31636,62281
"10455",1940,"20",25747,27269,53016
"10456",1940,"21",27694,28472,56166
"10457",1940,"22",27726,28585,56311
"10458",1940,"23",26615,27254,53869
"10459",1940,"24",25566,25964,51530
"10460",1940,"25",26557,27721,54278
"10461",1940,"26",26174,26883,53057
"10462",1940,"27",26051,26714,52765
"10463",1940,"28",25421,25918,51339
"10464",1940,"29",25001,24887,49888
"10465",1940,"30",25048,24980,50028
"10466",1940,"31",24010,23855,47865
"10467",1940,"32",23860,23157,47017
"10468",1940,"33",23550,22858,46408
"10469",1940,"34",23359,22061,45420
"10470",1940,"35",23206,21929,45135
"10471",1940,"36",23116,21460,44576
"10472",1940,"37",22842,21357,44199
"10473",1940,"38",22737,21306,44043
"10474",1940,"39",22241,20920,43161
"10475",1940,"40",21964,20774,42738
"10476",1940,"41",21778,20489,42267
"10477",1940,"42",21293,19844,41137
"10478",1940,"43",20436,19307,39743
"10479",1940,"44",20211,19257,39468
"10480",1940,"45",18968,18020,36988
"10481",1940,"46",19094,18097,37191
"10482",1940,"47",17597,16819,34416
"10483",1940,"48",18016,16762,34778
"10484",1940,"49",17092,15804,32896
"10485",1940,"50",16158,14825,30983
"10486",1940,"51",15864,14309,30173
"10487",1940,"52",15888,14176,30064
"10488",1940,"53",15023,13451,28474
"10489",1940,"54",15165,13155,28320
"10490",1940,"55",14174,12585,26759
"10491",1940,"56",14073,11872,25945
"10492",1940,"57",13461,11761,25222
"10493",1940,"58",13167,11328,24495
"10494",1940,"59",12834,11146,23980
"10495",1940,"60",13311,11494,24805
"10496",1940,"61",12558,10878,23436
"10497",1940,"62",12412,11026,23438
"10498",1940,"63",12077,10352,22429
"10499",1940,"64",11196,9985,21181
"10500",1940,"65",10779,9441,20220
"10501",1940,"66",10180,8785,18965
"10502",1940,"67",9768,8288,18056
"10503",1940,"68",9229,7766,16995
"10504",1940,"69",8818,7321,16139
"10505",1940,"70",8250,6720,14970
"10506",1940,"71",8148,6672,14820
"10507",1940,"72",7634,6080,13714
"10508",1940,"73",7798,6098,13896
"10509",1940,"74",7351,5611,12962
"10510",1940,"75",6824,5299,12123
"10511",1940,"76",6454,4876,11330
"10512",1940,"77",5789,4322,10111
"10513",1940,"78",4926,3652,8578
"10514",1940,"79",4734,3513,8247
"10515",1940,"80",4330,3239,7569
"10516",1940,"81",3853,2795,6648
"10517",1940,"82",3275,2393,5668
"10518",1940,"83",2975,2254,5229
"10519",1940,"84",2704,1803,4507
"10520",1940,"85",2337,1701,4038
"10521",1940,"86",1806,1181,2987
"10522",1940,"87",1522,969,2491
"10523",1940,"88",1168,760,1928
"10524",1940,"89",934,624,1558
"10525",1940,"90",693,427,1120
"10526",1940,"91",545,297,842
"10527",1940,"92",382,232,614
"10528",1940,"93",251,181,432
"10529",1940,"94",184,99,283
"10530",1940,"95",154,77,231
"10531",1940,"96",75,40,115
"10532",1940,"97",51,27,78
"10533",1940,"98",39,24,63
"10534",1940,"99",28,9,37
"10535",1940,"100",11,4,15
"10536",1940,"101",9,4,13
"10537",1940,"102",2,5,7
"10538",1940,"103",0,0,0
"10539",1940,"104",1,0,1
"10540",1940,"105",1,0,1
"10541",1940,"106",0,0,0
"10542",1940,"107",0,0,0
"10543",1940,"108",0,0,0
"10544",1940,"109",0,0,0
"10545",1940,"110+",0,0,0
"10546",1941,"0",22593,23948,46541
"10547",1941,"1",21961,22722,44683
"10548",1941,"2",21182,22143,43325
"10549",1941,"3",20311,21311,41622
"10550",1941,"4",19554,20429,39983
"10551",1941,"5",19227,19846,39073
"10552",1941,"6",19238,20236,39474
"10553",1941,"7",19226,20367,39593
"10554",1941,"8",20796,21760,42556
"10555",1941,"9",21199,21828,43027
"10556",1941,"10",21842,22871,44713
"10557",1941,"11",21956,23061,45017
"10558",1941,"12",22993,23580,46573
"10559",1941,"13",23176,23970,47146
"10560",1941,"14",24929,25872,50801
"10561",1941,"15",24671,25498,50169
"10562",1941,"16",26120,27479,53599
"10563",1941,"17",27507,28609,56116
"10564",1941,"18",28066,28733,56799
"10565",1941,"19",28557,29281,57838
"10566",1941,"20",30596,31516,62112
"10567",1941,"21",25705,27110,52815
"10568",1941,"22",27635,28276,55911
"10569",1941,"23",27664,28429,56093
"10570",1941,"24",26563,27060,53623
"10571",1941,"25",25513,25782,51295
"10572",1941,"26",26496,27539,54035
"10573",1941,"27",26136,26741,52877
"10574",1941,"28",26010,26579,52589
"10575",1941,"29",25377,25801,51178
"10576",1941,"30",24956,24766,49722
"10577",1941,"31",25014,24866,49880
"10578",1941,"32",23971,23756,47727
"10579",1941,"33",23831,23082,46913
"10580",1941,"34",23519,22806,46325
"10581",1941,"35",23332,21999,45331
"10582",1941,"36",23155,21867,45022
"10583",1941,"37",23068,21376,44444
"10584",1941,"38",22786,21270,44056
"10585",1941,"39",22699,21216,43915
"10586",1941,"40",22193,20855,43048
"10587",1941,"41",21914,20695,42609
"10588",1941,"42",21744,20433,42177
"10589",1941,"43",21227,19760,40987
"10590",1941,"44",20390,19196,39586
"10591",1941,"45",20174,19151,39325
"10592",1941,"46",18906,17909,36815
"10593",1941,"47",19035,18021,37056
"10594",1941,"48",17505,16716,34221
"10595",1941,"49",17958,16673,34631
"10596",1941,"50",17027,15748,32775
"10597",1941,"51",16074,14726,30800
"10598",1941,"52",15767,14202,29969
"10599",1941,"53",15742,14025,29767
"10600",1941,"54",14903,13316,28219
"10601",1941,"55",15037,13024,28061
"10602",1941,"56",14051,12432,26483
"10603",1941,"57",13963,11733,25696
"10604",1941,"58",13334,11624,24958
"10605",1941,"59",13049,11167,24216
"10606",1941,"60",12698,10971,23669
"10607",1941,"61",13161,11299,24460
"10608",1941,"62",12382,10653,23035
"10609",1941,"63",12227,10807,23034
"10610",1941,"64",11859,10136,21995
"10611",1941,"65",10972,9749,20721
"10612",1941,"66",10551,9223,19774
"10613",1941,"67",9938,8506,18444
"10614",1941,"68",9490,8028,17518
"10615",1941,"69",8950,7511,16461
"10616",1941,"70",8538,7058,15596
"10617",1941,"71",7941,6459,14400
"10618",1941,"72",7799,6382,14181
"10619",1941,"73",7296,5801,13097
"10620",1941,"74",7439,5807,13246
"10621",1941,"75",6943,5281,12224
"10622",1941,"76",6403,4938,11341
"10623",1941,"77",5981,4518,10499
"10624",1941,"78",5323,3974,9297
"10625",1941,"79",4530,3309,7839
"10626",1941,"80",4427,3207,7634
"10627",1941,"81",3903,2864,6767
"10628",1941,"82",3410,2440,5850
"10629",1941,"83",2852,2068,4920
"10630",1941,"84",2608,1940,4548
"10631",1941,"85",2322,1514,3836
"10632",1941,"86",1949,1423,3372
"10633",1941,"87",1501,980,2481
"10634",1941,"88",1262,758,2020
"10635",1941,"89",913,600,1513
"10636",1941,"90",731,479,1210
"10637",1941,"91",529,322,851
"10638",1941,"92",384,216,600
"10639",1941,"93",276,165,441
"10640",1941,"94",186,118,304
"10641",1941,"95",117,65,182
"10642",1941,"96",103,51,154
"10643",1941,"97",48,27,75
"10644",1941,"98",30,18,48
"10645",1941,"99",27,14,41
"10646",1941,"100",17,6,23
"10647",1941,"101",5,1,6
"10648",1941,"102",3,2,5
"10649",1941,"103",1,2,3
"10650",1941,"104",0,0,0
"10651",1941,"105",0,0,0
"10652",1941,"106",1,0,1
"10653",1941,"107",0,0,0
"10654",1941,"108",0,0,0
"10655",1941,"109",0,0,0
"10656",1941,"110+",0,0,0
"10657",1942,"0",21631,22725,44356
"10658",1942,"1",22335,23596,45931
"10659",1942,"2",21926,22639,44565
"10660",1942,"3",21154,22085,43239
"10661",1942,"4",20322,21266,41588
"10662",1942,"5",19574,20433,40007
"10663",1942,"6",19256,19841,39097
"10664",1942,"7",19295,20232,39527
"10665",1942,"8",19274,20395,39669
"10666",1942,"9",20877,21812,42689
"10667",1942,"10",21261,21916,43177
"10668",1942,"11",21897,22921,44818
"10669",1942,"12",21975,23127,45102
"10670",1942,"13",22954,23592,46546
"10671",1942,"14",23056,23918,46974
"10672",1942,"15",24792,25821,50613
"10673",1942,"16",24526,25444,49970
"10674",1942,"17",25973,27416,53389
"10675",1942,"18",27361,28540,55901
"10676",1942,"19",27917,28671,56588
"10677",1942,"20",28451,29202,57653
"10678",1942,"21",30396,31522,61918
"10679",1942,"22",25550,27106,52656
"10680",1942,"23",27437,28297,55734
"10681",1942,"24",27495,28427,55922
"10682",1942,"25",26412,27002,53414
"10683",1942,"26",25384,25701,51085
"10684",1942,"27",26361,27436,53797
"10685",1942,"28",25894,26731,52625
"10686",1942,"29",25739,26238,51977
"10687",1942,"30",25483,25833,51316
"10688",1942,"31",24930,24985,49915
"10689",1942,"32",24578,24298,48876
"10690",1942,"33",24361,24076,48437
"10691",1942,"34",23542,23131,46673
"10692",1942,"35",23567,22678,46245
"10693",1942,"36",23371,22270,45641
"10694",1942,"37",23084,21589,44673
"10695",1942,"38",22952,21575,44527
"10696",1942,"39",22786,21203,43989
"10697",1942,"40",22513,21080,43593
"10698",1942,"41",22283,21054,43337
"10699",1942,"42",21791,20483,42274
"10700",1942,"43",21664,20371,42035
"10701",1942,"44",21189,19737,40926
"10702",1942,"45",20490,19311,39801
"10703",1942,"46",19718,18690,38408
"10704",1942,"47",19284,18317,37601
"10705",1942,"48",18402,17469,35871
"10706",1942,"49",18045,16920,34965
"10707",1942,"50",17186,16132,33318
"10708",1942,"51",17053,15701,32754
"10709",1942,"52",16139,14687,30826
"10710",1942,"53",15540,13944,29484
"10711",1942,"54",15337,13693,29030
"10712",1942,"55",15179,13428,28607
"10713",1942,"56",14433,12777,27210
"10714",1942,"57",14285,12296,26581
"10715",1942,"58",13412,11575,24987
"10716",1942,"59",13397,11209,24606
"10717",1942,"60",12738,11121,23859
"10718",1942,"61",12690,10898,23588
"10719",1942,"62",12489,10624,23113
"10720",1942,"63",12421,11003,23424
"10721",1942,"64",11954,10382,22336
"10722",1942,"65",11405,9957,21362
"10723",1942,"66",11003,9474,20477
"10724",1942,"67",10150,9001,19151
"10725",1942,"68",9746,8307,18053
"10726",1942,"69",9294,7744,17038
"10727",1942,"70",8540,7191,15731
"10728",1942,"71",8357,6762,15119
"10729",1942,"72",7736,6270,14006
"10730",1942,"73",7241,5832,13073
"10731",1942,"74",7088,5693,12781
"10732",1942,"75",6948,5238,12186
"10733",1942,"76",6514,4996,11510
"10734",1942,"77",5974,4543,10517
"10735",1942,"78",5568,4257,9825
"10736",1942,"79",4792,3498,8290
"10737",1942,"80",4094,2922,7016
"10738",1942,"81",4013,2835,6848
"10739",1942,"82",3434,2524,5958
"10740",1942,"83",3011,2139,5150
"10741",1942,"84",2457,1737,4194
"10742",1942,"85",2233,1618,3851
"10743",1942,"86",1951,1255,3206
"10744",1942,"87",1606,1164,2770
"10745",1942,"88",1247,775,2022
"10746",1942,"89",1033,587,1620
"10747",1942,"90",708,459,1167
"10748",1942,"91",553,338,891
"10749",1942,"92",392,221,613
"10750",1942,"93",265,158,423
"10751",1942,"94",187,116,303
"10752",1942,"95",124,81,205
"10753",1942,"96",79,42,121
"10754",1942,"97",59,33,92
"10755",1942,"98",32,15,47
"10756",1942,"99",17,8,25
"10757",1942,"100",15,7,22
"10758",1942,"101",10,3,13
"10759",1942,"102",1,1,2
"10760",1942,"103",2,1,3
"10761",1942,"104",1,0,1
"10762",1942,"105",0,0,0
"10763",1942,"106",0,0,0
"10764",1942,"107",0,0,0
"10765",1942,"108",0,0,0
"10766",1942,"109",0,0,0
"10767",1942,"110+",0,0,0
"10768",1943,"0",25141,26572,51713
"10769",1943,"1",21442,22516,43958
"10770",1943,"2",22229,23465,45694
"10771",1943,"3",21838,22554,44392
"10772",1943,"4",21094,22015,43109
"10773",1943,"5",20280,21217,41497
"10774",1943,"6",19550,20377,39927
"10775",1943,"7",19227,19800,39027
"10776",1943,"8",19261,20177,39438
"10777",1943,"9",19244,20365,39609
"10778",1943,"10",20845,21760,42605
"10779",1943,"11",21230,21878,43108
"10780",1943,"12",21857,22884,44741
"10781",1943,"13",21941,23095,45036
"10782",1943,"14",22919,23547,46466
"10783",1943,"15",23029,23888,46917
"10784",1943,"16",24751,25778,50529
"10785",1943,"17",24489,25386,49875
"10786",1943,"18",25914,27316,53230
"10787",1943,"19",27295,28411,55706
"10788",1943,"20",27855,28511,56366
"10789",1943,"21",28374,29038,57412
"10790",1943,"22",30334,31319,61653
"10791",1943,"23",25476,26915,52391
"10792",1943,"24",27353,28104,55457
"10793",1943,"25",27423,28253,55676
"10794",1943,"26",26342,26838,53180
"10795",1943,"27",25318,25538,50856
"10796",1943,"28",26298,27272,53570
"10797",1943,"29",25822,26564,52386
"10798",1943,"30",25692,26065,51757
"10799",1943,"31",25403,25697,51100
"10800",1943,"32",24863,24857,49720
"10801",1943,"33",24505,24158,48663
"10802",1943,"34",24305,23926,48231
"10803",1943,"35",23474,22986,46460
"10804",1943,"36",23511,22546,46057
"10805",1943,"37",23293,22140,45433
"10806",1943,"38",23004,21452,44456
"10807",1943,"39",22861,21409,44270
"10808",1943,"40",22720,21067,43787
"10809",1943,"41",22433,20950,43383
"10810",1943,"42",22206,20924,43130
"10811",1943,"43",21709,20332,42041
"10812",1943,"44",21586,20240,41826
"10813",1943,"45",21096,19583,40679
"10814",1943,"46",20415,19168,39583
"10815",1943,"47",19637,18531,38168
"10816",1943,"48",19177,18175,37352
"10817",1943,"49",18315,17291,35606
"10818",1943,"50",17940,16770,34710
"10819",1943,"51",17078,15961,33039
"10820",1943,"52",16921,15556,32477
"10821",1943,"53",16033,14549,30582
"10822",1943,"54",15402,13804,29206
"10823",1943,"55",15240,13530,28770
"10824",1943,"56",15040,13292,28332
"10825",1943,"57",14286,12612,26898
"10826",1943,"58",14158,12123,26281
"10827",1943,"59",13274,11403,24677
"10828",1943,"60",13242,11017,24259
"10829",1943,"61",12600,10946,23546
"10830",1943,"62",12505,10677,23182
"10831",1943,"63",12262,10407,22669
"10832",1943,"64",12213,10745,22958
"10833",1943,"65",11721,10096,21817
"10834",1943,"66",11153,9715,20868
"10835",1943,"67",10780,9220,20000
"10836",1943,"68",9903,8763,18666
"10837",1943,"69",9505,8049,17554
"10838",1943,"70",9006,7450,16456
"10839",1943,"71",8263,6889,15152
"10840",1943,"72",8047,6497,14544
"10841",1943,"73",7434,5949,13383
"10842",1943,"74",6916,5496,12412
"10843",1943,"75",6763,5359,12122
"10844",1943,"76",6545,4893,11438
"10845",1943,"77",6147,4643,10790
"10846",1943,"78",5544,4222,9766
"10847",1943,"79",5153,3881,9034
"10848",1943,"80",4495,3273,7768
"10849",1943,"81",3724,2642,6366
"10850",1943,"82",3587,2520,6107
"10851",1943,"83",3074,2214,5288
"10852",1943,"84",2665,1859,4524
"10853",1943,"85",2164,1493,3657
"10854",1943,"86",1890,1377,3267
"10855",1943,"87",1654,1011,2665
"10856",1943,"88",1338,945,2283
"10857",1943,"89",1028,610,1638
"10858",1943,"90",807,434,1241
"10859",1943,"91",563,347,910
"10860",1943,"92",439,251,690
"10861",1943,"93",291,157,448
"10862",1943,"94",193,121,314
"10863",1943,"95",131,83,214
"10864",1943,"96",93,51,144
"10865",1943,"97",48,27,75
"10866",1943,"98",38,22,60
"10867",1943,"99",21,9,30
"10868",1943,"100",6,4,10
"10869",1943,"101",9,2,11
"10870",1943,"102",7,1,8
"10871",1943,"103",0,0,0
"10872",1943,"104",1,0,1
"10873",1943,"105",0,0,0
"10874",1943,"106",0,0,0
"10875",1943,"107",0,0,0
"10876",1943,"108",0,0,0
"10877",1943,"109",0,0,0
"10878",1943,"110+",0,0,0
"10879",1944,"0",26963,28729,55692
"10880",1944,"1",24974,26303,51277
"10881",1944,"2",21346,22381,43727
"10882",1944,"3",22146,23339,45485
"10883",1944,"4",21781,22461,44242
"10884",1944,"5",21023,21926,42949
"10885",1944,"6",20221,21162,41383
"10886",1944,"7",19514,20328,39842
"10887",1944,"8",19200,19755,38955
"10888",1944,"9",19224,20124,39348
"10889",1944,"10",19215,20328,39543
"10890",1944,"11",20811,21723,42534
"10891",1944,"12",21211,21841,43052
"10892",1944,"13",21835,22843,44678
"10893",1944,"14",21909,23043,44952
"10894",1944,"15",22865,23512,46377
"10895",1944,"16",22987,23837,46824
"10896",1944,"17",24706,25719,50425
"10897",1944,"18",24437,25292,49729
"10898",1944,"19",25856,27216,53072
"10899",1944,"20",27225,28256,55481
"10900",1944,"21",27787,28340,56127
"10901",1944,"22",28297,28869,57166
"10902",1944,"23",30254,31121,61375
"10903",1944,"24",25412,26748,52160
"10904",1944,"25",27265,27946,55211
"10905",1944,"26",27350,28099,55449
"10906",1944,"27",26277,26673,52950
"10907",1944,"28",25246,25393,50639
"10908",1944,"29",26236,27125,53361
"10909",1944,"30",25757,26427,52184
"10910",1944,"31",25612,25919,51531
"10911",1944,"32",25340,25552,50892
"10912",1944,"33",24800,24732,49532
"10913",1944,"34",24443,24025,48468
"10914",1944,"35",24238,23791,48029
"10915",1944,"36",23409,22858,46267
"10916",1944,"37",23434,22403,45837
"10917",1944,"38",23203,22011,45214
"10918",1944,"39",22918,21325,44243
"10919",1944,"40",22802,21292,44094
"10920",1944,"41",22644,20939,43583
"10921",1944,"42",22359,20822,43181
"10922",1944,"43",22122,20794,42916
"10923",1944,"44",21622,20205,41827
"10924",1944,"45",21506,20086,41592
"10925",1944,"46",20996,19436,40432
"10926",1944,"47",20322,19004,39326
"10927",1944,"48",19561,18397,37958
"10928",1944,"49",19073,18045,37118
"10929",1944,"50",18216,17141,35357
"10930",1944,"51",17843,16622,34465
"10931",1944,"52",16960,15791,32751
"10932",1944,"53",16816,15395,32211
"10933",1944,"54",15918,14406,30324
"10934",1944,"55",15296,13651,28947
"10935",1944,"56",15111,13380,28491
"10936",1944,"57",14900,13123,28023
"10937",1944,"58",14143,12446,26589
"10938",1944,"59",14013,11937,25950
"10939",1944,"60",13117,11226,24343
"10940",1944,"61",13088,10843,23931
"10941",1944,"62",12447,10772,23219
"10942",1944,"63",12343,10473,22816
"10943",1944,"64",12098,10205,22303
"10944",1944,"65",12007,10509,22516
"10945",1944,"66",11458,9861,21319
"10946",1944,"67",10911,9459,20370
"10947",1944,"68",10507,8946,19453
"10948",1944,"69",9657,8492,18149
"10949",1944,"70",9229,7777,17006
"10950",1944,"71",8723,7165,15888
"10951",1944,"72",7992,6592,14584
"10952",1944,"73",7766,6250,14016
"10953",1944,"74",7133,5680,12813
"10954",1944,"75",6589,5178,11767
"10955",1944,"76",6406,5061,11467
"10956",1944,"77",6187,4557,10744
"10957",1944,"78",5770,4308,10078
"10958",1944,"79",5151,3843,8994
"10959",1944,"80",4845,3480,8325
"10960",1944,"81",4106,2931,7037
"10961",1944,"82",3359,2374,5733
"10962",1944,"83",3238,2203,5441
"10963",1944,"84",2744,1926,4670
"10964",1944,"85",2299,1580,3879
"10965",1944,"86",1855,1258,3113
"10966",1944,"87",1600,1082,2682
"10967",1944,"88",1394,808,2202
"10968",1944,"89",1090,752,1842
"10969",1944,"90",819,471,1290
"10970",1944,"91",635,328,963
"10971",1944,"92",426,264,690
"10972",1944,"93",326,176,502
"10973",1944,"94",201,110,311
"10974",1944,"95",148,97,245
"10975",1944,"96",99,65,164
"10976",1944,"97",63,29,92
"10977",1944,"98",30,16,46
"10978",1944,"99",22,16,38
"10979",1944,"100",12,3,15
"10980",1944,"101",3,3,6
"10981",1944,"102",8,0,8
"10982",1944,"103",3,1,4
"10983",1944,"104",0,0,0
"10984",1944,"105",1,0,1
"10985",1944,"106",0,0,0
"10986",1944,"107",0,0,0
"10987",1944,"108",0,0,0
"10988",1944,"109",0,0,0
"10989",1944,"110+",0,0,0
"10990",1945,"0",29169,31335,60504
"10991",1945,"1",26766,28369,55135
"10992",1945,"2",24859,26149,51008
"10993",1945,"3",21257,22278,43535
"10994",1945,"4",22081,23257,45338
"10995",1945,"5",21732,22406,44138
"10996",1945,"6",20969,21866,42835
"10997",1945,"7",20189,21102,41291
"10998",1945,"8",19494,20292,39786
"10999",1945,"9",19179,19720,38899
"11000",1945,"10",19206,20084,39290
"11001",1945,"11",19190,20264,39454
"11002",1945,"12",20786,21669,42455
"11003",1945,"13",21183,21806,42989
"11004",1945,"14",21802,22799,44601
"11005",1945,"15",21871,22992,44863
"11006",1945,"16",22824,23448,46272
"11007",1945,"17",22946,23744,46690
"11008",1945,"18",24647,25631,50278
"11009",1945,"19",24382,25169,49551
"11010",1945,"20",25776,27062,52838
"11011",1945,"21",27165,28098,55263
"11012",1945,"22",27696,28178,55874
"11013",1945,"23",28199,28702,56901
"11014",1945,"24",30192,30916,61108
"11015",1945,"25",25361,26584,51945
"11016",1945,"26",27189,27766,54955
"11017",1945,"27",27266,27930,55196
"11018",1945,"28",26216,26547,52763
"11019",1945,"29",25167,25242,50409
"11020",1945,"30",26166,26985,53151
"11021",1945,"31",25685,26290,51975
"11022",1945,"32",25541,25809,51350
"11023",1945,"33",25258,25406,50664
"11024",1945,"34",24720,24605,49325
"11025",1945,"35",24370,23901,48271
"11026",1945,"36",24159,23655,47814
"11027",1945,"37",23328,22733,46061
"11028",1945,"38",23362,22287,45649
"11029",1945,"39",23134,21898,45032
"11030",1945,"40",22847,21194,44041
"11031",1945,"41",22721,21162,43883
"11032",1945,"42",22566,20805,43371
"11033",1945,"43",22281,20682,42963
"11034",1945,"44",22025,20659,42684
"11035",1945,"45",21532,20069,41601
"11036",1945,"46",21409,19944,41353
"11037",1945,"47",20884,19295,40179
"11038",1945,"48",20221,18855,39076
"11039",1945,"49",19464,18228,37692
"11040",1945,"50",18986,17903,36889
"11041",1945,"51",18104,16980,35084
"11042",1945,"52",17734,16456,34190
"11043",1945,"53",16834,15621,32455
"11044",1945,"54",16709,15222,31931
"11045",1945,"55",15812,14247,30059
"11046",1945,"56",15171,13465,28636
"11047",1945,"57",14971,13206,28177
"11048",1945,"58",14760,12953,27713
"11049",1945,"59",13990,12283,26273
"11050",1945,"60",13860,11751,25611
"11051",1945,"61",12962,11057,24019
"11052",1945,"62",12902,10652,23554
"11053",1945,"63",12287,10561,22848
"11054",1945,"64",12151,10230,22381
"11055",1945,"65",11850,9964,21814
"11056",1945,"66",11779,10279,22058
"11057",1945,"67",11224,9600,20824
"11058",1945,"68",10674,9188,19862
"11059",1945,"69",10250,8692,18942
"11060",1945,"70",9362,8197,17559
"11061",1945,"71",8944,7504,16448
"11062",1945,"72",8393,6861,15254
"11063",1945,"73",7704,6301,14005
"11064",1945,"74",7383,5963,13346
"11065",1945,"75",6800,5393,12193
"11066",1945,"76",6237,4856,11093
"11067",1945,"77",6036,4717,10753
"11068",1945,"78",5805,4191,9996
"11069",1945,"79",5343,3968,9311
"11070",1945,"80",4919,3531,8450
"11071",1945,"81",4424,3132,7556
"11072",1945,"82",3702,2609,6311
"11073",1945,"83",3002,2089,5091
"11074",1945,"84",2854,1923,4777
"11075",1945,"85",2388,1655,4043
"11076",1945,"86",1971,1322,3293
"11077",1945,"87",1535,1046,2581
"11078",1945,"88",1360,886,2246
"11079",1945,"89",1098,649,1747
"11080",1945,"90",893,580,1473
"11081",1945,"91",635,381,1016
"11082",1945,"92",491,247,738
"11083",1945,"93",313,198,511
"11084",1945,"94",222,128,350
"11085",1945,"95",138,68,206
"11086",1945,"96",89,63,152
"11087",1945,"97",69,47,116
"11088",1945,"98",41,21,62
"11089",1945,"99",20,12,32
"11090",1945,"100",8,11,19
"11091",1945,"101",8,0,8
"11092",1945,"102",1,3,4
"11093",1945,"103",6,0,6
"11094",1945,"104",2,0,2
"11095",1945,"105",0,0,0
"11096",1945,"106",1,0,1
"11097",1945,"107",0,0,0
"11098",1945,"108",0,0,0
"11099",1945,"109",0,0,0
"11100",1945,"110+",0,0,0
"11101",1946,"0",29139,30934,60073
"11102",1946,"1",29087,31100,60187
"11103",1946,"2",26682,28229,54911
"11104",1946,"3",24798,26058,50856
"11105",1946,"4",21209,22212,43421
"11106",1946,"5",22044,23208,45252
"11107",1946,"6",21703,22360,44063
"11108",1946,"7",20946,21827,42773
"11109",1946,"8",20174,21049,41223
"11110",1946,"9",19480,20256,39736
"11111",1946,"10",19162,19686,38848
"11112",1946,"11",19183,20059,39242
"11113",1946,"12",19179,20229,39408
"11114",1946,"13",20765,21625,42390
"11115",1946,"14",21158,21772,42930
"11116",1946,"15",21784,22763,44547
"11117",1946,"16",21851,22948,44799
"11118",1946,"17",22786,23395,46181
"11119",1946,"18",22909,23681,46590
"11120",1946,"19",24598,25568,50166
"11121",1946,"20",24336,25076,49412
"11122",1946,"21",25734,26973,52707
"11123",1946,"22",27111,28000,55111
"11124",1946,"23",27633,28029,55662
"11125",1946,"24",28121,28544,56665
"11126",1946,"25",30129,30787,60916
"11127",1946,"26",25295,26486,51781
"11128",1946,"27",27133,27638,54771
"11129",1946,"28",27193,27786,54979
"11130",1946,"29",26153,26455,52608
"11131",1946,"30",25106,25137,50243
"11132",1946,"31",26109,26871,52980
"11133",1946,"32",25624,26181,51805
"11134",1946,"33",25488,25695,51183
"11135",1946,"34",25197,25320,50517
"11136",1946,"35",24658,24505,49163
"11137",1946,"36",24303,23801,48104
"11138",1946,"37",24107,23561,47668
"11139",1946,"38",23266,22643,45909
"11140",1946,"39",23291,22179,45470
"11141",1946,"40",23053,21799,44852
"11142",1946,"41",22776,21086,43862
"11143",1946,"42",22638,21050,43688
"11144",1946,"43",22488,20715,43203
"11145",1946,"44",22197,20573,42770
"11146",1946,"45",21937,20553,42490
"11147",1946,"46",21457,19955,41412
"11148",1946,"47",21313,19796,41109
"11149",1946,"48",20786,19185,39971
"11150",1946,"49",20125,18727,38852
"11151",1946,"50",19360,18098,37458
"11152",1946,"51",18894,17765,36659
"11153",1946,"52",17992,16832,34824
"11154",1946,"53",17636,16341,33977
"11155",1946,"54",16714,15479,32193
"11156",1946,"55",16589,15086,31675
"11157",1946,"56",15711,14114,29825
"11158",1946,"57",15029,13301,28330
"11159",1946,"58",14835,13054,27889
"11160",1946,"59",14638,12796,27434
"11161",1946,"60",13846,12113,25959
"11162",1946,"61",13685,11574,25259
"11163",1946,"62",12809,10885,23694
"11164",1946,"63",12708,10478,23186
"11165",1946,"64",12113,10362,22475
"11166",1946,"65",11951,10022,21973
"11167",1946,"66",11610,9733,21343
"11168",1946,"67",11570,10022,21592
"11169",1946,"68",10992,9349,20341
"11170",1946,"69",10391,8919,19310
"11171",1946,"70",9976,8410,18386
"11172",1946,"71",9137,7887,17024
"11173",1946,"72",8672,7213,15885
"11174",1946,"73",8103,6569,14672
"11175",1946,"74",7401,6005,13406
"11176",1946,"75",7077,5638,12715
"11177",1946,"76",6424,5091,11515
"11178",1946,"77",5857,4558,10415
"11179",1946,"78",5660,4366,10026
"11180",1946,"79",5437,3877,9314
"11181",1946,"80",4898,3514,8412
"11182",1946,"81",4522,3183,7705
"11183",1946,"82",3992,2815,6807
"11184",1946,"83",3335,2296,5631
"11185",1946,"84",2645,1803,4448
"11186",1946,"85",2480,1632,4112
"11187",1946,"86",2051,1400,3451
"11188",1946,"87",1672,1089,2761
"11189",1946,"88",1267,865,2132
"11190",1946,"89",1110,724,1834
"11191",1946,"90",882,507,1389
"11192",1946,"91",683,475,1158
"11193",1946,"92",514,279,793
"11194",1946,"93",374,186,560
"11195",1946,"94",235,133,368
"11196",1946,"95",156,83,239
"11197",1946,"96",92,40,132
"11198",1946,"97",63,40,103
"11199",1946,"98",49,33,82
"11200",1946,"99",25,16,41
"11201",1946,"100",14,9,23
"11202",1946,"101",3,9,12
"11203",1946,"102",3,0,3
"11204",1946,"103",0,1,1
"11205",1946,"104",3,0,3
"11206",1946,"105",1,0,1
"11207",1946,"106",0,0,0
"11208",1946,"107",0,0,0
"11209",1946,"108",0,0,0
"11210",1946,"109",0,0,0
"11211",1946,"110+",0,0,0
"11212",1947,"0",33640,35459,69099
"11213",1947,"1",29015,30643,59658
"11214",1947,"2",28991,30967,59958
"11215",1947,"3",26727,28200,54927
"11216",1947,"4",24924,26150,51074
"11217",1947,"5",21337,22247,43584
"11218",1947,"6",22214,23305,45519
"11219",1947,"7",21861,22462,44323
"11220",1947,"8",21057,21850,42907
"11221",1947,"9",20380,21210,41590
"11222",1947,"10",19719,20395,40114
"11223",1947,"11",19396,19845,39241
"11224",1947,"12",19481,20193,39674
"11225",1947,"13",19493,20459,39952
"11226",1947,"14",21163,21953,43116
"11227",1947,"15",21482,22193,43675
"11228",1947,"16",22066,23059,45125
"11229",1947,"17",22020,23269,45289
"11230",1947,"18",22705,23532,46237
"11231",1947,"19",22469,23580,46049
"11232",1947,"20",24170,25392,49562
"11233",1947,"21",23899,24930,48829
"11234",1947,"22",25294,26702,51996
"11235",1947,"23",26652,27686,54338
"11236",1947,"24",27169,27439,54608
"11237",1947,"25",27836,27993,55829
"11238",1947,"26",29521,29648,59169
"11239",1947,"27",24835,25522,50357
"11240",1947,"28",26535,26436,52971
"11241",1947,"29",26723,26722,53445
"11242",1947,"30",25705,25816,51521
"11243",1947,"31",24736,24700,49436
"11244",1947,"32",25753,26452,52205
"11245",1947,"33",25323,25714,51037
"11246",1947,"34",25235,25680,50915
"11247",1947,"35",24757,25099,49856
"11248",1947,"36",24496,24403,48899
"11249",1947,"37",24606,24645,49251
"11250",1947,"38",23602,23547,47149
"11251",1947,"39",23328,22721,46049
"11252",1947,"40",23136,22419,45555
"11253",1947,"41",22864,21774,44638
"11254",1947,"42",22809,21708,44517
"11255",1947,"43",22630,21426,44056
"11256",1947,"44",22348,21334,43682
"11257",1947,"45",22215,21148,43363
"11258",1947,"46",21828,20560,42388
"11259",1947,"47",21569,20310,41879
"11260",1947,"48",21231,19965,41196
"11261",1947,"49",20685,19310,39995
"11262",1947,"50",19873,18854,38727
"11263",1947,"51",19461,18524,37985
"11264",1947,"52",18225,17221,35446
"11265",1947,"53",18074,16916,34990
"11266",1947,"54",16774,15878,32652
"11267",1947,"55",17005,15493,32498
"11268",1947,"56",16129,14553,30682
"11269",1947,"57",15333,13648,28981
"11270",1947,"58",15088,13427,28515
"11271",1947,"59",15080,13414,28494
"11272",1947,"60",14163,12596,26759
"11273",1947,"61",13812,11961,25773
"11274",1947,"62",13184,11374,24558
"11275",1947,"63",12875,10752,23627
"11276",1947,"64",12107,10436,22543
"11277",1947,"65",11637,9785,21422
"11278",1947,"66",11390,9718,21108
"11279",1947,"67",11800,10050,21850
"11280",1947,"68",10030,9384,19414
"11281",1947,"69",10724,9319,20043
"11282",1947,"70",10436,8758,19194
"11283",1947,"71",9502,8083,17585
"11284",1947,"72",8885,7491,16376
"11285",1947,"73",8283,6842,15125
"11286",1947,"74",7705,6333,14038
"11287",1947,"75",7107,5730,12837
"11288",1947,"76",6582,5124,11706
"11289",1947,"77",6188,4740,10928
"11290",1947,"78",5789,4295,10084
"11291",1947,"79",5184,3906,9090
"11292",1947,"80",5014,3598,8612
"11293",1947,"81",4452,3190,7642
"11294",1947,"82",4087,2868,6955
"11295",1947,"83",3579,2480,6059
"11296",1947,"84",2948,2025,4973
"11297",1947,"85",2303,1536,3839
"11298",1947,"86",2099,1389,3488
"11299",1947,"87",1724,1162,2886
"11300",1947,"88",1380,911,2291
"11301",1947,"89",1057,696,1753
"11302",1947,"90",898,591,1489
"11303",1947,"91",684,380,1064
"11304",1947,"92",532,353,885
"11305",1947,"93",382,201,583
"11306",1947,"94",256,123,379
"11307",1947,"95",162,94,256
"11308",1947,"96",95,64,159
"11309",1947,"97",62,22,84
"11310",1947,"98",38,32,70
"11311",1947,"99",35,21,56
"11312",1947,"100",9,6,15
"11313",1947,"101",7,5,12
"11314",1947,"102",2,7,9
"11315",1947,"103",2,0,2
"11316",1947,"104",0,1,1
"11317",1947,"105",2,0,2
"11318",1947,"106",0,0,0
"11319",1947,"107",0,0,0
"11320",1947,"108",0,0,0
"11321",1947,"109",0,0,0
"11322",1947,"110+",0,0,0
"11323",1948,"0",32419,33873,66292
"11324",1948,"1",33372,35248,68620
"11325",1948,"2",28974,30584,59558
"11326",1948,"3",28961,30941,59902
"11327",1948,"4",26721,28194,54915
"11328",1948,"5",24911,26114,51025
"11329",1948,"6",21319,22238,43557
"11330",1948,"7",22162,23275,45437
"11331",1948,"8",21858,22441,44299
"11332",1948,"9",21012,21820,42832
"11333",1948,"10",20368,21191,41559
"11334",1948,"11",19679,20381,40060
"11335",1948,"12",19353,19825,39178
"11336",1948,"13",19441,20172,39613
"11337",1948,"14",19450,20414,39864
"11338",1948,"15",21126,21929,43055
"11339",1948,"16",21450,22165,43615
"11340",1948,"17",21994,23022,45016
"11341",1948,"18",21941,23212,45153
"11342",1948,"19",22646,23462,46108
"11343",1948,"20",22405,23519,45924
"11344",1948,"21",24086,25305,49391
"11345",1948,"22",23825,24851,48676
"11346",1948,"23",25216,26637,51853
"11347",1948,"24",26580,27587,54167
"11348",1948,"25",27098,27344,54442
"11349",1948,"26",27746,27914,55660
"11350",1948,"27",29438,29552,58990
"11351",1948,"28",24772,25430,50202
"11352",1948,"29",26466,26344,52810
"11353",1948,"30",26653,26627,53280
"11354",1948,"31",25647,25735,51382
"11355",1948,"32",24662,24623,49285
"11356",1948,"33",25687,26372,52059
"11357",1948,"34",25271,25622,50893
"11358",1948,"35",25161,25596,50757
"11359",1948,"36",24661,25017,49678
"11360",1948,"37",24410,24322,48732
"11361",1948,"38",24519,24555,49074
"11362",1948,"39",23500,23471,46971
"11363",1948,"40",23215,22632,45847
"11364",1948,"41",23033,22334,45367
"11365",1948,"42",22768,21674,44442
"11366",1948,"43",22709,21623,44332
"11367",1948,"44",22525,21333,43858
"11368",1948,"45",22234,21220,43454
"11369",1948,"46",22089,21036,43125
"11370",1948,"47",21700,20443,42143
"11371",1948,"48",21457,20200,41657
"11372",1948,"49",21103,19841,40944
"11373",1948,"50",20567,19196,39763
"11374",1948,"51",19735,18690,38425
"11375",1948,"52",19345,18391,37736
"11376",1948,"53",18100,17084,35184
"11377",1948,"54",17932,16780,34712
"11378",1948,"55",16635,15731,32366
"11379",1948,"56",16880,15331,32211
"11380",1948,"57",15999,14406,30405
"11381",1948,"58",15179,13501,28680
"11382",1948,"59",14963,13270,28233
"11383",1948,"60",14910,13213,28123
"11384",1948,"61",13989,12410,26399
"11385",1948,"62",13648,11765,25413
"11386",1948,"63",12981,11163,24144
"11387",1948,"64",12675,10528,23203
"11388",1948,"65",11879,10201,22080
"11389",1948,"66",11400,9568,20968
"11390",1948,"67",11149,9453,20602
"11391",1948,"68",11516,9768,21284
"11392",1948,"69",10726,9106,19832
"11393",1948,"70",10382,9001,19383
"11394",1948,"71",10100,8416,18516
"11395",1948,"72",9172,7771,16943
"11396",1948,"73",8491,7169,15660
"11397",1948,"74",7909,6522,14431
"11398",1948,"75",7312,5978,13290
"11399",1948,"76",6712,5383,12095
"11400",1948,"77",6215,4754,10969
"11401",1948,"78",5757,4399,10156
"11402",1948,"79",5369,3977,9346
"11403",1948,"80",4825,3539,8364
"11404",1948,"81",4542,3218,7760
"11405",1948,"82",4007,2836,6843
"11406",1948,"83",3635,2490,6125
"11407",1948,"84",3124,2154,5278
"11408",1948,"85",2509,1738,4247
"11409",1948,"86",1957,1299,3256
"11410",1948,"87",1738,1147,2885
"11411",1948,"88",1414,950,2364
"11412",1948,"89",1097,729,1826
"11413",1948,"90",840,534,1374
"11414",1948,"91",690,441,1131
"11415",1948,"92",513,281,794
"11416",1948,"93",411,248,659
"11417",1948,"94",293,129,422
"11418",1948,"95",172,75,247
"11419",1948,"96",107,65,172
"11420",1948,"97",46,38,84
"11421",1948,"98",37,15,52
"11422",1948,"99",26,18,44
"11423",1948,"100",20,12,32
"11424",1948,"101",4,2,6
"11425",1948,"102",4,4,8
"11426",1948,"103",2,4,6
"11427",1948,"104",1,0,1
"11428",1948,"105",0,0,0
"11429",1948,"106",0,0,0
"11430",1948,"107",0,0,0
"11431",1948,"108",0,0,0
"11432",1948,"109",0,0,0
"11433",1948,"110+",0,0,0
"11434",1949,"0",30891,33287,64178
"11435",1949,"1",32209,33689,65898
"11436",1949,"2",33338,35242,68580
"11437",1949,"3",28958,30549,59507
"11438",1949,"4",28956,30900,59856
"11439",1949,"5",26700,28180,54880
"11440",1949,"6",24902,26084,50986
"11441",1949,"7",21300,22230,43530
"11442",1949,"8",22142,23244,45386
"11443",1949,"9",21837,22406,44243
"11444",1949,"10",20999,21792,42791
"11445",1949,"11",20348,21162,41510
"11446",1949,"12",19664,20351,40015
"11447",1949,"13",19329,19794,39123
"11448",1949,"14",19414,20151,39565
"11449",1949,"15",19425,20395,39820
"11450",1949,"16",21088,21886,42974
"11451",1949,"17",21406,22105,43511
"11452",1949,"18",21935,22943,44878
"11453",1949,"19",21889,23141,45030
"11454",1949,"20",22593,23388,45981
"11455",1949,"21",22353,23440,45793
"11456",1949,"22",24027,25200,49227
"11457",1949,"23",23763,24744,48507
"11458",1949,"24",25143,26526,51669
"11459",1949,"25",26505,27481,53986
"11460",1949,"26",27013,27230,54243
"11461",1949,"27",27695,27787,55482
"11462",1949,"28",29369,29423,58792
"11463",1949,"29",24707,25312,50019
"11464",1949,"30",26393,26233,52626
"11465",1949,"31",26582,26535,53117
"11466",1949,"32",25581,25621,51202
"11467",1949,"33",24603,24521,49124
"11468",1949,"34",25618,26275,51893
"11469",1949,"35",25177,25534,50711
"11470",1949,"36",25084,25501,50585
"11471",1949,"37",24597,24927,49524
"11472",1949,"38",24331,24232,48563
"11473",1949,"39",24440,24457,48897
"11474",1949,"40",23402,23376,46778
"11475",1949,"41",23137,22529,45666
"11476",1949,"42",22957,22235,45192
"11477",1949,"43",22667,21568,44235
"11478",1949,"44",22641,21506,44147
"11479",1949,"45",22426,21223,43649
"11480",1949,"46",22144,21105,43249
"11481",1949,"47",21993,20899,42892
"11482",1949,"48",21600,20313,41913
"11483",1949,"49",21344,20050,41394
"11484",1949,"50",20983,19722,40705
"11485",1949,"51",20459,19065,39524
"11486",1949,"52",19626,18544,38170
"11487",1949,"53",19206,18244,37450
"11488",1949,"54",17974,16940,34914
"11489",1949,"55",17812,16623,34435
"11490",1949,"56",16510,15546,32056
"11491",1949,"57",16731,15170,31901
"11492",1949,"58",15850,14238,30088
"11493",1949,"59",15040,13348,28388
"11494",1949,"60",14816,13105,27921
"11495",1949,"61",14741,13010,27751
"11496",1949,"62",13818,12215,26033
"11497",1949,"63",13476,11577,25053
"11498",1949,"64",12787,10972,23759
"11499",1949,"65",12460,10331,22791
"11500",1949,"66",11662,9991,21653
"11501",1949,"67",11198,9358,20556
"11502",1949,"68",10908,9228,20136
"11503",1949,"69",11246,9495,20741
"11504",1949,"70",10426,8802,19228
"11505",1949,"71",10045,8688,18733
"11506",1949,"72",9743,8061,17804
"11507",1949,"73",8818,7407,16225
"11508",1949,"74",8166,6809,14975
"11509",1949,"75",7516,6170,13686
"11510",1949,"76",6937,5624,12561
"11511",1949,"77",6340,5036,11376
"11512",1949,"78",5806,4380,10186
"11513",1949,"79",5332,4036,9368
"11514",1949,"80",4848,3556,8404
"11515",1949,"81",4413,3198,7611
"11516",1949,"82",4113,2901,7014
"11517",1949,"83",3569,2504,6073
"11518",1949,"84",3201,2169,5370
"11519",1949,"85",2740,1869,4609
"11520",1949,"86",2161,1478,3639
"11521",1949,"87",1658,1093,2751
"11522",1949,"88",1447,949,2396
"11523",1949,"89",1146,760,1906
"11524",1949,"90",873,560,1433
"11525",1949,"91",664,393,1057
"11526",1949,"92",538,328,866
"11527",1949,"93",386,208,594
"11528",1949,"94",292,188,480
"11529",1949,"95",207,78,285
"11530",1949,"96",117,53,170
"11531",1949,"97",73,35,108
"11532",1949,"98",29,22,51
"11533",1949,"99",28,10,38
"11534",1949,"100",15,10,25
"11535",1949,"101",15,8,23
"11536",1949,"102",2,1,3
"11537",1949,"103",3,2,5
"11538",1949,"104",1,4,5
"11539",1949,"105",0,0,0
"11540",1949,"106",0,0,0
"11541",1949,"107",0,0,0
"11542",1949,"108",0,0,0
"11543",1949,"109",0,0,0
"11544",1949,"110+",0,0,0
"11545",1950,"0",29931,31736,61667
"11546",1950,"1",30656,32966,63622
"11547",1950,"2",32145,33680,65825
"11548",1950,"3",33317,35232,68549
"11549",1950,"4",28950,30518,59468
"11550",1950,"5",28951,30873,59824
"11551",1950,"6",26685,28177,54862
"11552",1950,"7",24899,26062,50961
"11553",1950,"8",21291,22225,43516
"11554",1950,"9",22112,23221,45333
"11555",1950,"10",21816,22376,44192
"11556",1950,"11",20970,21763,42733
"11557",1950,"12",20326,21135,41461
"11558",1950,"13",19649,20325,39974
"11559",1950,"14",19313,19766,39079
"11560",1950,"15",19384,20131,39515
"11561",1950,"16",19402,20356,39758
"11562",1950,"17",21064,21831,42895
"11563",1950,"18",21372,22038,43410
"11564",1950,"19",21881,22875,44756
"11565",1950,"20",21838,23081,44919
"11566",1950,"21",22524,23332,45856
"11567",1950,"22",22293,23362,45655
"11568",1950,"23",23958,25131,49089
"11569",1950,"24",23703,24680,48383
"11570",1950,"25",25086,26440,51526
"11571",1950,"26",26447,27400,53847
"11572",1950,"27",26939,27147,54086
"11573",1950,"28",27615,27700,55315
"11574",1950,"29",29296,29332,58628
"11575",1950,"30",24635,25238,49873
"11576",1950,"31",26316,26146,52462
"11577",1950,"32",26500,26447,52947
"11578",1950,"33",25506,25539,51045
"11579",1950,"34",24525,24423,48948
"11580",1950,"35",25548,26201,51749
"11581",1950,"36",25116,25433,50549
"11582",1950,"37",25012,25432,50444
"11583",1950,"38",24529,24853,49382
"11584",1950,"39",24256,24157,48413
"11585",1950,"40",24356,24375,48731
"11586",1950,"41",23332,23294,46626
"11587",1950,"42",23069,22433,45502
"11588",1950,"43",22874,22148,45022
"11589",1950,"44",22586,21478,44064
"11590",1950,"45",22537,21416,43953
"11591",1950,"46",22338,21106,43444
"11592",1950,"47",22055,20990,43045
"11593",1950,"48",21904,20789,42693
"11594",1950,"49",21494,20194,41688
"11595",1950,"50",21233,19914,41147
"11596",1950,"51",20847,19561,40408
"11597",1950,"52",20349,18921,39270
"11598",1950,"53",19519,18405,37924
"11599",1950,"54",19081,18067,37148
"11600",1950,"55",17865,16763,34628
"11601",1950,"56",17668,16461,34129
"11602",1950,"57",16390,15354,31744
"11603",1950,"58",16567,15021,31588
"11604",1950,"59",15697,14058,29755
"11605",1950,"60",14887,13132,28019
"11606",1950,"61",14639,12905,27544
"11607",1950,"62",14567,12826,27393
"11608",1950,"63",13629,12001,25630
"11609",1950,"64",13285,11350,24635
"11610",1950,"65",12564,10743,23307
"11611",1950,"66",12223,10105,22328
"11612",1950,"67",11445,9755,21200
"11613",1950,"68",10934,9084,20018
"11614",1950,"69",10617,8933,19550
"11615",1950,"70",10931,9172,20103
"11616",1950,"71",10094,8486,18580
"11617",1950,"72",9720,8282,18002
"11618",1950,"73",9303,7680,16983
"11619",1950,"74",8418,7056,15474
"11620",1950,"75",7712,6424,14136
"11621",1950,"76",7150,5757,12907
"11622",1950,"77",6500,5221,11721
"11623",1950,"78",5933,4678,10611
"11624",1950,"79",5355,4016,9371
"11625",1950,"80",5008,3622,8630
"11626",1950,"81",4373,3194,7567
"11627",1950,"82",3981,2836,6817
"11628",1950,"83",3635,2560,6195
"11629",1950,"84",3143,2186,5329
"11630",1950,"85",2758,1866,4624
"11631",1950,"86",2330,1565,3895
"11632",1950,"87",1773,1217,2990
"11633",1950,"88",1355,895,2250
"11634",1950,"89",1163,764,1927
"11635",1950,"90",918,589,1507
"11636",1950,"91",671,427,1098
"11637",1950,"92",494,292,786
"11638",1950,"93",378,223,601
"11639",1950,"94",283,153,436
"11640",1950,"95",216,145,361
"11641",1950,"96",143,51,194
"11642",1950,"97",64,34,98
"11643",1950,"98",56,20,76
"11644",1950,"99",20,14,34
"11645",1950,"100",15,5,20
"11646",1950,"101",6,4,10
"11647",1950,"102",9,5,14
"11648",1950,"103",1,0,1
"11649",1950,"104",0,0,0
"11650",1950,"105",0,4,4
"11651",1950,"106",0,0,0
"11652",1950,"107",0,0,0
"11653",1950,"108",0,0,0
"11654",1950,"109",0,0,0
"11655",1950,"110+",0,0,0
"11656",1951,"0",29651,31407,61058
"11657",1951,"1",29707,31452,61159
"11658",1951,"2",30885,33020,63905
"11659",1951,"3",31778,33887,65665
"11660",1951,"4",33433,35189,68622
"11661",1951,"5",30452,32063,62515
"11662",1951,"6",28759,30677,59436
"11663",1951,"7",26084,27390,53474
"11664",1951,"8",24328,25372,49700
"11665",1951,"9",21068,21970,43038
"11666",1951,"10",22336,23318,45654
"11667",1951,"11",21537,22223,43760
"11668",1951,"12",21108,21812,42920
"11669",1951,"13",20155,20940,41095
"11670",1951,"14",19646,20414,40060
"11671",1951,"15",19376,19760,39136
"11672",1951,"16",19268,20050,39318
"11673",1951,"17",19429,20364,39793
"11674",1951,"18",21088,21859,42947
"11675",1951,"19",21205,21914,43119
"11676",1951,"20",22063,23120,45183
"11677",1951,"21",21734,22750,44484
"11678",1951,"22",22327,23292,45619
"11679",1951,"23",22529,23512,46041
"11680",1951,"24",23554,24743,48297
"11681",1951,"25",23887,24954,48841
"11682",1951,"26",25027,26237,51264
"11683",1951,"27",26280,27340,53620
"11684",1951,"28",26758,27063,53821
"11685",1951,"29",27423,27328,54751
"11686",1951,"30",29633,29818,59451
"11687",1951,"31",24323,24736,49059
"11688",1951,"32",26255,26192,52447
"11689",1951,"33",26281,26225,52506
"11690",1951,"34",25294,25324,50618
"11691",1951,"35",24901,24822,49723
"11692",1951,"36",25127,25717,50844
"11693",1951,"37",24923,25321,50244
"11694",1951,"38",25058,25308,50366
"11695",1951,"39",24310,24749,49059
"11696",1951,"40",24353,24266,48619
"11697",1951,"41",24080,24044,48124
"11698",1951,"42",23350,23307,46657
"11699",1951,"43",22967,22380,45347
"11700",1951,"44",22746,21954,44700
"11701",1951,"45",22687,21512,44199
"11702",1951,"46",22305,21191,43496
"11703",1951,"47",22441,21102,43543
"11704",1951,"48",21770,20793,42563
"11705",1951,"49",21717,20604,42321
"11706",1951,"50",21645,20230,41875
"11707",1951,"51",20745,19390,40135
"11708",1951,"52",20993,19650,40643
"11709",1951,"53",19912,18640,38552
"11710",1951,"54",19595,18385,37980
"11711",1951,"55",18954,17940,36894
"11712",1951,"56",17750,16604,34354
"11713",1951,"57",17545,16221,33766
"11714",1951,"58",16560,15281,31841
"11715",1951,"59",16111,14750,30861
"11716",1951,"60",15630,13894,29524
"11717",1951,"61",14576,12839,27415
"11718",1951,"62",14736,12725,27461
"11719",1951,"63",13994,12634,26628
"11720",1951,"64",13562,11790,25352
"11721",1951,"65",13145,11154,24299
"11722",1951,"66",12560,10413,22973
"11723",1951,"67",11815,9920,21735
"11724",1951,"68",11531,9579,21110
"11725",1951,"69",10341,8636,18977
"11726",1951,"70",10552,8713,19265
"11727",1951,"71",10301,8710,19011
"11728",1951,"72",10105,8417,18522
"11729",1951,"73",9082,7757,16839
"11730",1951,"74",8876,7220,16096
"11731",1951,"75",8156,6794,14950
"11732",1951,"76",7193,5996,13189
"11733",1951,"77",6562,5324,11886
"11734",1951,"78",6446,4991,11437
"11735",1951,"79",5088,3981,9069
"11736",1951,"80",5004,3705,8709
"11737",1951,"81",4538,3226,7764
"11738",1951,"82",3914,2822,6736
"11739",1951,"83",3540,2473,6013
"11740",1951,"84",3187,2185,5372
"11741",1951,"85",2693,1826,4519
"11742",1951,"86",2301,1530,3831
"11743",1951,"87",1959,1280,3239
"11744",1951,"88",1428,1001,2429
"11745",1951,"89",1090,714,1804
"11746",1951,"90",921,591,1512
"11747",1951,"91",704,448,1152
"11748",1951,"92",502,322,824
"11749",1951,"93",364,201,565
"11750",1951,"94",270,163,433
"11751",1951,"95",210,97,307
"11752",1951,"96",146,95,241
"11753",1951,"97",96,28,124
"11754",1951,"98",36,19,55
"11755",1951,"99",35,10,45
"11756",1951,"100",11,3,14
"11757",1951,"101",9,1,10
"11758",1951,"102",1,3,4
"11759",1951,"103",4,1,5
"11760",1951,"104",0,0,0
"11761",1951,"105",0,0,0
"11762",1951,"106",0,4,4
"11763",1951,"107",0,0,0
"11764",1951,"108",0,0,0
"11765",1951,"109",0,0,0
"11766",1951,"110+",0,0,0
"11767",1952,"0",28642,30649,59291
"11768",1952,"1",29473,31167,60640
"11769",1952,"2",29647,31368,61015
"11770",1952,"3",30788,32930,63718
"11771",1952,"4",31763,33727,65490
"11772",1952,"5",33315,35077,68392
"11773",1952,"6",30341,32000,62341
"11774",1952,"7",28715,30634,59349
"11775",1952,"8",26035,27376,53411
"11776",1952,"9",24282,25319,49601
"11777",1952,"10",21080,21961,43041
"11778",1952,"11",22290,23292,45582
"11779",1952,"12",21529,22237,43766
"11780",1952,"13",21103,21809,42912
"11781",1952,"14",20166,20946,41112
"11782",1952,"15",19637,20448,40085
"11783",1952,"16",19337,19763,39100
"11784",1952,"17",19239,20063,39302
"11785",1952,"18",19353,20348,39701
"11786",1952,"19",21020,21825,42845
"11787",1952,"20",21150,21882,43032
"11788",1952,"21",21970,23050,45020
"11789",1952,"22",21662,22689,44351
"11790",1952,"23",22276,23226,45502
"11791",1952,"24",22461,23417,45878
"11792",1952,"25",23514,24681,48195
"11793",1952,"26",23820,24858,48678
"11794",1952,"27",24947,26139,51086
"11795",1952,"28",26218,27233,53451
"11796",1952,"29",26651,26959,53610
"11797",1952,"30",27325,27263,54588
"11798",1952,"31",29511,29702,59213
"11799",1952,"32",24282,24709,48991
"11800",1952,"33",26171,26132,52303
"11801",1952,"34",26187,26165,52352
"11802",1952,"35",25208,25242,50450
"11803",1952,"36",24853,24777,49630
"11804",1952,"37",25054,25632,50686
"11805",1952,"38",24853,25236,50089
"11806",1952,"39",25021,25277,50298
"11807",1952,"40",24238,24661,48899
"11808",1952,"41",24284,24199,48483
"11809",1952,"42",24037,24014,48051
"11810",1952,"43",23276,23257,46533
"11811",1952,"44",22909,22318,45227
"11812",1952,"45",22668,21903,44571
"11813",1952,"46",22626,21421,44047
"11814",1952,"47",22209,21097,43306
"11815",1952,"48",22336,21018,43354
"11816",1952,"49",21714,20708,42422
"11817",1952,"50",21593,20495,42088
"11818",1952,"51",21532,20106,41638
"11819",1952,"52",20636,19279,39915
"11820",1952,"53",20908,19530,40438
"11821",1952,"54",19804,18505,38309
"11822",1952,"55",19478,18232,37710
"11823",1952,"56",18825,17775,36600
"11824",1952,"57",17618,16452,34070
"11825",1952,"58",17412,16091,33503
"11826",1952,"59",16438,15129,31567
"11827",1952,"60",15963,14594,30557
"11828",1952,"61",15486,13739,29225
"11829",1952,"62",14444,12658,27102
"11830",1952,"63",14554,12554,27108
"11831",1952,"64",13824,12442,26266
"11832",1952,"65",13348,11595,24943
"11833",1952,"66",12961,10917,23878
"11834",1952,"67",12375,10203,22578
"11835",1952,"68",11592,9675,21267
"11836",1952,"69",11296,9308,20604
"11837",1952,"70",10106,8383,18489
"11838",1952,"71",10237,8420,18657
"11839",1952,"72",9949,8373,18322
"11840",1952,"73",9751,8071,17822
"11841",1952,"74",8710,7388,16098
"11842",1952,"75",8449,6838,15287
"11843",1952,"76",7774,6391,14165
"11844",1952,"77",6806,5630,12436
"11845",1952,"78",6164,4962,11126
"11846",1952,"79",6022,4602,10624
"11847",1952,"80",4794,3705,8499
"11848",1952,"81",4566,3379,7945
"11849",1952,"82",4103,2900,7003
"11850",1952,"83",3487,2473,5960
"11851",1952,"84",3099,2146,5245
"11852",1952,"85",2796,1870,4666
"11853",1952,"86",2287,1577,3864
"11854",1952,"87",1965,1260,3225
"11855",1952,"88",1626,1058,2684
"11856",1952,"89",1156,810,1966
"11857",1952,"90",880,547,1427
"11858",1952,"91",736,457,1193
"11859",1952,"92",554,338,892
"11860",1952,"93",381,234,615
"11861",1952,"94",262,145,407
"11862",1952,"95",185,108,293
"11863",1952,"96",156,62,218
"11864",1952,"97",91,84,175
"11865",1952,"98",73,16,89
"11866",1952,"99",21,11,32
"11867",1952,"100",22,8,30
"11868",1952,"101",7,1,8
"11869",1952,"102",4,0,4
"11870",1952,"103",1,2,3
"11871",1952,"104",3,0,3
"11872",1952,"105",0,0,0
"11873",1952,"106",0,0,0
"11874",1952,"107",0,4,4
"11875",1952,"108",0,0,0
"11876",1952,"109",0,0,0
"11877",1952,"110+",0,0,0
"11878",1953,"0",29666,31583,61249
"11879",1953,"1",28482,30471,58953
"11880",1953,"2",29427,31115,60542
"11881",1953,"3",29612,31316,60928
"11882",1953,"4",30691,32867,63558
"11883",1953,"5",31748,33600,65348
"11884",1953,"6",33211,34969,68180
"11885",1953,"7",30234,31938,62172
"11886",1953,"8",28678,30595,59273
"11887",1953,"9",25986,27363,53349
"11888",1953,"10",24240,25266,49506
"11889",1953,"11",21097,21952,43049
"11890",1953,"12",22245,23259,45504
"11891",1953,"13",21531,22256,43787
"11892",1953,"14",21100,21798,42898
"11893",1953,"15",20178,20969,41147
"11894",1953,"16",19634,20484,40118
"11895",1953,"17",19294,19773,39067
"11896",1953,"18",19204,20073,39277
"11897",1953,"19",19272,20328,39600
"11898",1953,"20",20931,21796,42727
"11899",1953,"21",21058,21836,42894
"11900",1953,"22",21877,22998,44875
"11901",1953,"23",21571,22645,44216
"11902",1953,"24",22234,23152,45386
"11903",1953,"25",22369,23341,45710
"11904",1953,"26",23447,24616,48063
"11905",1953,"27",23714,24748,48462
"11906",1953,"28",24852,26067,50919
"11907",1953,"29",26141,27133,53274
"11908",1953,"30",26555,26866,53421
"11909",1953,"31",27223,27196,54419
"11910",1953,"32",29389,29623,59012
"11911",1953,"33",24228,24695,48923
"11912",1953,"34",26108,26096,52204
"11913",1953,"35",26087,26124,52211
"11914",1953,"36",25126,25168,50294
"11915",1953,"37",24818,24736,49554
"11916",1953,"38",25004,25562,50566
"11917",1953,"39",24802,25167,49969
"11918",1953,"40",24983,25238,50221
"11919",1953,"41",24190,24607,48797
"11920",1953,"42",24200,24140,48340
"11921",1953,"43",23993,23963,47956
"11922",1953,"44",23223,23195,46418
"11923",1953,"45",22856,22219,45075
"11924",1953,"46",22602,21839,44441
"11925",1953,"47",22544,21330,43874
"11926",1953,"48",22136,21011,43147
"11927",1953,"49",22228,20932,43160
"11928",1953,"50",21646,20632,42278
"11929",1953,"51",21488,20396,41884
"11930",1953,"52",21415,19971,41386
"11931",1953,"53",20536,19154,39690
"11932",1953,"54",20815,19390,40205
"11933",1953,"55",19685,18367,38052
"11934",1953,"56",19335,18078,37413
"11935",1953,"57",18669,17609,36278
"11936",1953,"58",17497,16289,33786
"11937",1953,"59",17266,15956,33222
"11938",1953,"60",16286,14941,31227
"11939",1953,"61",15793,14412,30205
"11940",1953,"62",15339,13572,28911
"11941",1953,"63",14263,12463,26726
"11942",1953,"64",14361,12347,26708
"11943",1953,"65",13661,12197,25858
"11944",1953,"66",13120,11343,24463
"11945",1953,"67",12756,10678,23434
"11946",1953,"68",12174,9957,22131
"11947",1953,"69",11352,9412,20764
"11948",1953,"70",11026,9030,20056
"11949",1953,"71",9834,8083,17917
"11950",1953,"72",9896,8061,17957
"11951",1953,"73",9567,8031,17598
"11952",1953,"74",9320,7684,17004
"11953",1953,"75",8292,7009,15301
"11954",1953,"76",8023,6426,14449
"11955",1953,"77",7310,5996,13306
"11956",1953,"78",6397,5225,11622
"11957",1953,"79",5723,4577,10300
"11958",1953,"80",5625,4261,9886
"11959",1953,"81",4377,3345,7722
"11960",1953,"82",4080,2996,7076
"11961",1953,"83",3687,2550,6237
"11962",1953,"84",3090,2149,5239
"11963",1953,"85",2721,1851,4572
"11964",1953,"86",2400,1582,3982
"11965",1953,"87",1944,1295,3239
"11966",1953,"88",1631,1006,2637
"11967",1953,"89",1331,854,2185
"11968",1953,"90",911,658,1569
"11969",1953,"91",689,428,1117
"11970",1953,"92",572,347,919
"11971",1953,"93",412,246,658
"11972",1953,"94",277,167,444
"11973",1953,"95",197,101,298
"11974",1953,"96",110,64,174
"11975",1953,"97",107,42,149
"11976",1953,"98",64,66,130
"11977",1953,"99",41,11,52
"11978",1953,"100",16,8,24
"11979",1953,"101",13,4,17
"11980",1953,"102",5,1,6
"11981",1953,"103",4,0,4
"11982",1953,"104",1,1,2
"11983",1953,"105",1,0,1
"11984",1953,"106",0,0,0
"11985",1953,"107",0,0,0
"11986",1953,"108",0,2,2
"11987",1953,"109",0,0,0
"11988",1953,"110+",0,0,0
"11989",1954,"0",30188,31580,61768
"11990",1954,"1",29541,31450,60991
"11991",1954,"2",28427,30395,58822
"11992",1954,"3",29406,31073,60479
"11993",1954,"4",29600,31272,60872
"11994",1954,"5",30616,32805,63421
"11995",1954,"6",31744,33479,65223
"11996",1954,"7",33116,34875,67991
"11997",1954,"8",30142,31882,62024
"11998",1954,"9",28650,30566,59216
"11999",1954,"10",25952,27354,53306
"12000",1954,"11",24211,25218,49429
"12001",1954,"12",21122,21948,43070
"12002",1954,"13",22204,23237,45441
"12003",1954,"14",21533,22278,43811
"12004",1954,"15",21094,21793,42887
"12005",1954,"16",20187,20986,41173
"12006",1954,"17",19630,20515,40145
"12007",1954,"18",19250,19768,39018
"12008",1954,"19",19168,20076,39244
"12009",1954,"20",19198,20312,39510
"12010",1954,"21",20854,21769,42623
"12011",1954,"22",20997,21802,42799
"12012",1954,"23",21809,22952,44761
"12013",1954,"24",21504,22608,44112
"12014",1954,"25",22195,23096,45291
"12015",1954,"26",22300,23269,45569
"12016",1954,"27",23417,24568,47985
"12017",1954,"28",23637,24685,48322
"12018",1954,"29",24787,25992,50779
"12019",1954,"30",26084,27049,53133
"12020",1954,"31",26477,26781,53258
"12021",1954,"32",27136,27140,54276
"12022",1954,"33",29264,29555,58819
"12023",1954,"34",24174,24687,48861
"12024",1954,"35",26041,26064,52105
"12025",1954,"36",26000,26090,52090
"12026",1954,"37",25063,25110,50173
"12027",1954,"38",24776,24690,49466
"12028",1954,"39",24958,25502,50460
"12029",1954,"40",24754,25116,49870
"12030",1954,"41",24966,25199,50165
"12031",1954,"42",24148,24545,48693
"12032",1954,"43",24141,24071,48212
"12033",1954,"44",23957,23901,47858
"12034",1954,"45",23177,23135,46312
"12035",1954,"46",22805,22126,44931
"12036",1954,"47",22527,21766,44293
"12037",1954,"48",22465,21241,43706
"12038",1954,"49",22060,20929,42989
"12039",1954,"50",22125,20847,42972
"12040",1954,"51",21587,20550,42137
"12041",1954,"52",21384,20277,41661
"12042",1954,"53",21299,19838,41137
"12043",1954,"54",20430,19031,39461
"12044",1954,"55",20704,19249,39953
"12045",1954,"56",19554,18214,37768
"12046",1954,"57",19207,17932,37139
"12047",1954,"58",18514,17411,35925
"12048",1954,"59",17374,16134,33508
"12049",1954,"60",17115,15784,32899
"12050",1954,"61",16133,14757,30890
"12051",1954,"62",15654,14215,29869
"12052",1954,"63",15186,13370,28556
"12053",1954,"64",14104,12244,26348
"12054",1954,"65",14138,12096,26234
"12055",1954,"66",13467,11934,25401
"12056",1954,"67",12873,11043,23916
"12057",1954,"68",12537,10411,22948
"12058",1954,"69",11940,9711,21651
"12059",1954,"70",11099,9127,20226
"12060",1954,"71",10720,8723,19443
"12061",1954,"72",9557,7760,17317
"12062",1954,"73",9554,7700,17254
"12063",1954,"74",9179,7634,16813
"12064",1954,"75",8909,7280,16189
"12065",1954,"76",7910,6617,14527
"12066",1954,"77",7561,6019,13580
"12067",1954,"78",6845,5576,12421
"12068",1954,"79",5978,4827,10805
"12069",1954,"80",5312,4098,9410
"12070",1954,"81",5095,3858,8953
"12071",1954,"82",3986,3000,6986
"12072",1954,"83",3679,2650,6329
"12073",1954,"84",3217,2208,5425
"12074",1954,"85",2715,1839,4554
"12075",1954,"86",2307,1577,3884
"12076",1954,"87",2030,1329,3359
"12077",1954,"88",1607,1046,2653
"12078",1954,"89",1328,779,2107
"12079",1954,"90",1065,667,1732
"12080",1954,"91",726,492,1218
"12081",1954,"92",535,329,864
"12082",1954,"93",422,264,686
"12083",1954,"94",303,177,480
"12084",1954,"95",180,95,275
"12085",1954,"96",141,60,201
"12086",1954,"97",67,34,101
"12087",1954,"98",74,28,102
"12088",1954,"99",41,50,91
"12089",1954,"100",24,8,32
"12090",1954,"101",7,6,13
"12091",1954,"102",9,1,10
"12092",1954,"103",4,1,5
"12093",1954,"104",1,0,1
"12094",1954,"105",1,1,2
"12095",1954,"106",0,0,0
"12096",1954,"107",0,0,0
"12097",1954,"108",0,0,0
"12098",1954,"109",0,0,0
"12099",1954,"110+",0,0,0
"12100",1955,"0",30153,31351,61504
"12101",1955,"1",30075,31496,61571
"12102",1955,"2",29485,31397,60882
"12103",1955,"3",28390,30346,58736
"12104",1955,"4",29390,31055,60445
"12105",1955,"5",29595,31233,60828
"12106",1955,"6",30537,32759,63296
"12107",1955,"7",31739,33376,65115
"12108",1955,"8",33029,34782,67811
"12109",1955,"9",30057,31834,61891
"12110",1955,"10",28630,30539,59169
"12111",1955,"11",25917,27341,53258
"12112",1955,"12",24173,25176,49349
"12113",1955,"13",21149,21949,43098
"12114",1955,"14",22162,23211,45373
"12115",1955,"15",21534,22304,43838
"12116",1955,"16",21087,21782,42869
"12117",1955,"17",20200,20993,41193
"12118",1955,"18",19617,20555,40172
"12119",1955,"19",19190,19770,38960
"12120",1955,"20",19128,20085,39213
"12121",1955,"21",19107,20293,39400
"12122",1955,"22",20788,21734,42522
"12123",1955,"23",20936,21766,42702
"12124",1955,"24",21735,22904,44639
"12125",1955,"25",21429,22561,43990
"12126",1955,"26",22169,23051,45220
"12127",1955,"27",22234,23216,45450
"12128",1955,"28",23383,24517,47900
"12129",1955,"29",23577,24604,48181
"12130",1955,"30",24725,25930,50655
"12131",1955,"31",26035,26966,53001
"12132",1955,"32",26397,26700,53097
"12133",1955,"33",27059,27100,54159
"12134",1955,"34",29160,29500,58660
"12135",1955,"35",24131,24681,48812
"12136",1955,"36",25978,26028,52006
"12137",1955,"37",25922,26061,51983
"12138",1955,"38",24997,25060,50057
"12139",1955,"39",24742,24655,49397
"12140",1955,"40",24905,25447,50352
"12141",1955,"41",24712,25064,49776
"12142",1955,"42",24950,25143,50093
"12143",1955,"43",24108,24490,48598
"12144",1955,"44",24062,23989,48051
"12145",1955,"45",23917,23874,47791
"12146",1955,"46",23115,23087,46202
"12147",1955,"47",22766,22049,44815
"12148",1955,"48",22456,21709,44165
"12149",1955,"49",22370,21134,43504
"12150",1955,"50",21960,20821,42781
"12151",1955,"51",22042,20756,42798
"12152",1955,"52",21514,20475,41989
"12153",1955,"53",21262,20133,41395
"12154",1955,"54",21156,19690,40846
"12155",1955,"55",20301,18889,39190
"12156",1955,"56",20591,19104,39695
"12157",1955,"57",19435,18065,37500
"12158",1955,"58",19058,17769,36827
"12159",1955,"59",18373,17211,35584
"12160",1955,"60",17220,15942,33162
"12161",1955,"61",16967,15587,32554
"12162",1955,"62",15965,14562,30527
"12163",1955,"63",15485,14006,29491
"12164",1955,"64",15023,13106,28129
"12165",1955,"65",13906,12000,25906
"12166",1955,"66",13907,11811,25718
"12167",1955,"67",13280,11644,24924
"12168",1955,"68",12631,10751,23382
"12169",1955,"69",12306,10089,22395
"12170",1955,"70",11654,9380,21034
"12171",1955,"71",10798,8826,19624
"12172",1955,"72",10377,8402,18779
"12173",1955,"73",9249,7429,16678
"12174",1955,"74",9174,7294,16468
"12175",1955,"75",8772,7245,16017
"12176",1955,"76",8444,6831,15275
"12177",1955,"77",7450,6179,13629
"12178",1955,"78",7084,5556,12640
"12179",1955,"79",6367,5127,11494
"12180",1955,"80",5655,4449,10104
"12181",1955,"81",4847,3716,8563
"12182",1955,"82",4590,3426,8016
"12183",1955,"83",3562,2637,6199
"12184",1955,"84",3229,2340,5569
"12185",1955,"85",2754,1895,4649
"12186",1955,"86",2326,1528,3854
"12187",1955,"87",1927,1323,3250
"12188",1955,"88",1682,1089,2771
"12189",1955,"89",1320,838,2158
"12190",1955,"90",1053,629,1682
"12191",1955,"91",830,508,1338
"12192",1955,"92",531,376,907
"12193",1955,"93",421,241,662
"12194",1955,"94",298,187,485
"12195",1955,"95",225,119,344
"12196",1955,"96",120,67,187
"12197",1955,"97",95,34,129
"12198",1955,"98",39,21,60
"12199",1955,"99",39,17,56
"12200",1955,"100",29,39,68
"12201",1955,"101",13,5,18
"12202",1955,"102",5,4,9
"12203",1955,"103",2,1,3
"12204",1955,"104",2,0,2
"12205",1955,"105",1,0,1
"12206",1955,"106",0,1,1
"12207",1955,"107",0,0,0
"12208",1955,"108",0,0,0
"12209",1955,"109",0,0,0
"12210",1955,"110+",0,0,0
"12211",1956,"0",30335,32045,62380
"12212",1956,"1",30019,31301,61320
"12213",1956,"2",30016,31399,61415
"12214",1956,"3",29428,31311,60739
"12215",1956,"4",28385,30328,58713
"12216",1956,"5",29295,30938,60233
"12217",1956,"6",29695,31277,60972
"12218",1956,"7",30455,32853,63308
"12219",1956,"8",31772,33326,65098
"12220",1956,"9",32731,34430,67161
"12221",1956,"10",29752,31691,61443
"12222",1956,"11",28271,30311,58582
"12223",1956,"12",25844,27227,53071
"12224",1956,"13",24038,25057,49095
"12225",1956,"14",21173,21991,43164
"12226",1956,"15",22092,23174,45266
"12227",1956,"16",21530,22373,43903
"12228",1956,"17",21129,21832,42961
"12229",1956,"18",20272,20997,41269
"12230",1956,"19",19686,20608,40294
"12231",1956,"20",19215,19829,39044
"12232",1956,"21",19089,20121,39210
"12233",1956,"22",19221,20425,39646
"12234",1956,"23",20848,21901,42749
"12235",1956,"24",20946,21916,42862
"12236",1956,"25",21853,23049,44902
"12237",1956,"26",21524,22640,44164
"12238",1956,"27",22138,23187,45325
"12239",1956,"28",22338,23440,45778
"12240",1956,"29",23351,24664,48015
"12241",1956,"30",23647,24691,48338
"12242",1956,"31",24803,25974,50777
"12243",1956,"32",26050,27062,53112
"12244",1956,"33",26512,26788,53300
"12245",1956,"34",27165,27058,54223
"12246",1956,"35",29181,29569,58750
"12247",1956,"36",23949,24512,48461
"12248",1956,"37",25878,26004,51882
"12249",1956,"38",25857,26001,51858
"12250",1956,"39",24904,25095,49999
"12251",1956,"40",24752,24608,49360
"12252",1956,"41",24955,25475,50430
"12253",1956,"42",24737,25065,49802
"12254",1956,"43",24872,25052,49924
"12255",1956,"44",24095,24423,48518
"12256",1956,"45",24097,23972,48069
"12257",1956,"46",23801,23753,47554
"12258",1956,"47",23054,23007,46061
"12259",1956,"48",22682,21977,44659
"12260",1956,"49",22436,21581,44017
"12261",1956,"50",22280,21026,43306
"12262",1956,"51",21881,20659,42540
"12263",1956,"52",22024,20607,42631
"12264",1956,"53",21322,20243,41565
"12265",1956,"54",21187,19936,41123
"12266",1956,"55",21143,19614,40757
"12267",1956,"56",20247,18723,38970
"12268",1956,"57",20409,18909,39318
"12269",1956,"58",19313,17888,37201
"12270",1956,"59",18958,17432,36390
"12271",1956,"60",18255,16921,35176
"12272",1956,"61",17032,15652,32684
"12273",1956,"62",16765,15218,31983
"12274",1956,"63",15780,14234,30014
"12275",1956,"64",15303,13616,28919
"12276",1956,"65",14814,12762,27576
"12277",1956,"66",13708,11665,25373
"12278",1956,"67",13732,11486,25218
"12279",1956,"68",12896,11217,24113
"12280",1956,"69",12421,10396,22817
"12281",1956,"70",12067,9711,21778
"12282",1956,"71",11394,8950,20344
"12283",1956,"72",10539,8409,18948
"12284",1956,"73",10087,7991,18078
"12285",1956,"74",8895,7031,15926
"12286",1956,"75",8799,6972,15771
"12287",1956,"76",8247,6825,15072
"12288",1956,"77",7970,6389,14359
"12289",1956,"78",6989,5696,12685
"12290",1956,"79",6605,5127,11732
"12291",1956,"80",5881,4674,10555
"12292",1956,"81",5201,4018,9219
"12293",1956,"82",4380,3397,7777
"12294",1956,"83",4097,3058,7155
"12295",1956,"84",3128,2316,5444
"12296",1956,"85",2803,1993,4796
"12297",1956,"86",2369,1599,3968
"12298",1956,"87",1910,1265,3175
"12299",1956,"88",1611,1078,2689
"12300",1956,"89",1373,887,2260
"12301",1956,"90",1037,650,1687
"12302",1956,"91",810,450,1260
"12303",1956,"92",637,376,1013
"12304",1956,"93",383,274,657
"12305",1956,"94",300,170,470
"12306",1956,"95",210,128,338
"12307",1956,"96",156,76,232
"12308",1956,"97",80,48,128
"12309",1956,"98",59,26,85
"12310",1956,"99",25,13,38
"12311",1956,"100",24,7,31
"12312",1956,"101",14,31,45
"12313",1956,"102",6,3,9
"12314",1956,"103",3,3,6
"12315",1956,"104",2,0,2
"12316",1956,"105",2,0,2
"12317",1956,"106",0,0,0
"12318",1956,"107",0,1,1
"12319",1956,"108",0,0,0
"12320",1956,"109",0,0,0
"12321",1956,"110+",0,0,0
"12322",1957,"0",30802,32033,62835
"12323",1957,"1",30180,31862,62042
"12324",1957,"2",29965,31221,61186
"12325",1957,"3",30011,31356,61367
"12326",1957,"4",29433,31334,60767
"12327",1957,"5",28334,30252,58586
"12328",1957,"6",29365,31032,60397
"12329",1957,"7",29556,31160,60716
"12330",1957,"8",30460,32662,63122
"12331",1957,"9",31725,33229,64954
"12332",1957,"10",32975,34701,67676
"12333",1957,"11",30008,31783,61791
"12334",1957,"12",28656,30533,59189
"12335",1957,"13",25885,27337,53222
"12336",1957,"14",24145,25125,49270
"12337",1957,"15",21158,21909,43067
"12338",1957,"16",22105,23159,45264
"12339",1957,"17",21510,22275,43785
"12340",1957,"18",21041,21714,42755
"12341",1957,"19",20162,20943,41105
"12342",1957,"20",19527,20485,40012
"12343",1957,"21",19056,19685,38741
"12344",1957,"22",19037,20006,39043
"12345",1957,"23",18942,20156,39098
"12346",1957,"24",20649,21538,42187
"12347",1957,"25",20812,21614,42426
"12348",1957,"26",21580,22732,44312
"12349",1957,"27",21289,22401,43690
"12350",1957,"28",22072,22893,44965
"12351",1957,"29",22088,23047,45135
"12352",1957,"30",23312,24366,47678
"12353",1957,"31",23431,24410,47841
"12354",1957,"32",24595,25775,50370
"12355",1957,"33",25926,26772,52698
"12356",1957,"34",26239,26498,52737
"12357",1957,"35",26891,26947,53838
"12358",1957,"36",28979,29339,58318
"12359",1957,"37",24080,24641,48721
"12360",1957,"38",25878,25919,51797
"12361",1957,"39",25806,25932,51738
"12362",1957,"40",24887,24901,49788
"12363",1957,"41",24637,24556,49193
"12364",1957,"42",24767,25287,50054
"12365",1957,"43",24603,24904,49507
"12366",1957,"44",24876,25016,49892
"12367",1957,"45",24000,24324,48324
"12368",1957,"46",23916,23825,47741
"12369",1957,"47",23834,23768,47602
"12370",1957,"48",22982,22927,45909
"12371",1957,"49",22612,21843,44455
"12372",1957,"50",22269,21497,43766
"12373",1957,"51",22181,20885,43066
"12374",1957,"52",21760,20560,42320
"12375",1957,"53",21830,20525,42355
"12376",1957,"54",21370,20227,41597
"12377",1957,"55",21030,19813,40843
"12378",1957,"56",20879,19335,40214
"12379",1957,"57",20073,18530,38603
"12380",1957,"58",20303,18731,39034
"12381",1957,"59",19188,17642,36830
"12382",1957,"60",18721,17313,36034
"12383",1957,"61",18048,16741,34789
"12384",1957,"62",16922,15529,32451
"12385",1957,"63",16622,15102,31724
"12386",1957,"64",15602,14050,29652
"12387",1957,"65",15083,13504,28587
"12388",1957,"66",14620,12591,27211
"12389",1957,"67",13446,11460,24906
"12390",1957,"68",13362,11222,24584
"12391",1957,"69",12828,11051,23879
"12392",1957,"70",12013,10139,22152
"12393",1957,"71",11614,9430,21044
"12394",1957,"72",11010,8698,19708
"12395",1957,"73",10126,8092,18218
"12396",1957,"74",9629,7713,17342
"12397",1957,"75",8546,6718,15264
"12398",1957,"76",8275,6519,14794
"12399",1957,"77",7868,6392,14260
"12400",1957,"78",7475,5918,13393
"12401",1957,"79",6543,5252,11795
"12402",1957,"80",6116,4688,10804
"12403",1957,"81",5368,4231,9599
"12404",1957,"82",4697,3578,8275
"12405",1957,"83",3925,2986,6911
"12406",1957,"84",3592,2686,6278
"12407",1957,"85",2759,1973,4732
"12408",1957,"86",2397,1693,4090
"12409",1957,"87",2018,1316,3334
"12410",1957,"88",1600,1032,2632
"12411",1957,"89",1317,861,2178
"12412",1957,"90",1101,703,1804
"12413",1957,"91",816,473,1289
"12414",1957,"92",597,336,933
"12415",1957,"93",460,266,726
"12416",1957,"94",276,194,470
"12417",1957,"95",209,124,333
"12418",1957,"96",145,81,226
"12419",1957,"97",100,48,148
"12420",1957,"98",61,29,90
"12421",1957,"99",33,14,47
"12422",1957,"100",17,6,23
"12423",1957,"101",17,4,21
"12424",1957,"102",7,28,35
"12425",1957,"103",4,2,6
"12426",1957,"104",1,2,3
"12427",1957,"105",2,0,2
"12428",1957,"106",2,0,2
"12429",1957,"107",0,0,0
"12430",1957,"108",0,1,1
"12431",1957,"109",0,0,0
"12432",1957,"110+",0,0,0
"12433",1958,"0",30239,31500,61739
"12434",1958,"1",30700,32086,62786
"12435",1958,"2",30117,31817,61934
"12436",1958,"3",29942,31179,61121
"12437",1958,"4",30006,31336,61342
"12438",1958,"5",29427,31310,60737
"12439",1958,"6",28319,30218,58537
"12440",1958,"7",29371,31036,60407
"12441",1958,"8",29525,31126,60651
"12442",1958,"9",30457,32615,63072
"12443",1958,"10",31710,33198,64908
"12444",1958,"11",33016,34740,67756
"12445",1958,"12",30049,31787,61836
"12446",1958,"13",28717,30557,59274
"12447",1958,"14",25882,27331,53213
"12448",1958,"15",24154,25125,49279
"12449",1958,"16",21144,21873,43017
"12450",1958,"17",22100,23143,45243
"12451",1958,"18",21503,22234,43737
"12452",1958,"19",21019,21671,42690
"12453",1958,"20",20141,20926,41067
"12454",1958,"21",19503,20447,39950
"12455",1958,"22",19019,19640,38659
"12456",1958,"23",19017,19972,38989
"12457",1958,"24",18893,20095,38988
"12458",1958,"25",20612,21469,42081
"12459",1958,"26",20784,21539,42323
"12460",1958,"27",21529,22658,44187
"12461",1958,"28",21237,22335,43572
"12462",1958,"29",22055,22825,44880
"12463",1958,"30",22038,22964,45002
"12464",1958,"31",23292,24299,47591
"12465",1958,"32",23387,24350,47737
"12466",1958,"33",24534,25723,50257
"12467",1958,"34",25883,26689,52572
"12468",1958,"35",26167,26420,52587
"12469",1958,"36",26815,26896,53711
"12470",1958,"37",28924,29268,58192
"12471",1958,"38",24078,24626,48704
"12472",1958,"39",25859,25858,51717
"12473",1958,"40",25765,25887,51652
"12474",1958,"41",24857,24828,49685
"12475",1958,"42",24586,24498,49084
"12476",1958,"43",24700,25189,49889
"12477",1958,"44",24540,24810,49350
"12478",1958,"45",24836,24939,49775
"12479",1958,"46",23941,24231,48172
"12480",1958,"47",23840,23724,47564
"12481",1958,"48",23776,23675,47451
"12482",1958,"49",22899,22836,45735
"12483",1958,"50",22535,21711,44246
"12484",1958,"51",22195,21371,43566
"12485",1958,"52",22102,20756,42858
"12486",1958,"53",21671,20421,42092
"12487",1958,"54",21726,20373,42099
"12488",1958,"55",21293,20099,41392
"12489",1958,"56",20895,19641,40536
"12490",1958,"57",20734,19111,39845
"12491",1958,"58",19953,18320,38273
"12492",1958,"59",20153,18506,38659
"12493",1958,"60",19024,17402,36426
"12494",1958,"61",18517,17052,35569
"12495",1958,"62",17867,16489,34356
"12496",1958,"63",16748,15279,32027
"12497",1958,"64",16441,14829,31270
"12498",1958,"65",15399,13760,29159
"12499",1958,"66",14860,13203,28063
"12500",1958,"67",14370,12314,26684
"12501",1958,"68",13212,11165,24377
"12502",1958,"69",13043,10879,23922
"12503",1958,"70",12526,10678,23204
"12504",1958,"71",11656,9767,21423
"12505",1958,"72",11227,9088,20315
"12506",1958,"73",10607,8352,18959
"12507",1958,"74",9728,7716,17444
"12508",1958,"75",9168,7325,16493
"12509",1958,"76",8143,6326,14469
"12510",1958,"77",7797,6071,13868
"12511",1958,"78",7341,5952,13293
"12512",1958,"79",6961,5465,12426
"12513",1958,"80",6087,4807,10894
"12514",1958,"81",5572,4245,9817
"12515",1958,"82",4857,3811,8668
"12516",1958,"83",4169,3158,7327
"12517",1958,"84",3455,2605,6060
"12518",1958,"85",3103,2302,5405
"12519",1958,"86",2352,1662,4014
"12520",1958,"87",2010,1393,3403
"12521",1958,"88",1670,1076,2746
"12522",1958,"89",1314,809,2123
"12523",1958,"90",1053,679,1732
"12524",1958,"91",850,539,1389
"12525",1958,"92",634,348,982
"12526",1958,"93",447,251,698
"12527",1958,"94",336,178,514
"12528",1958,"95",187,128,315
"12529",1958,"96",144,87,231
"12530",1958,"97",92,51,143
"12531",1958,"98",64,27,91
"12532",1958,"99",39,18,57
"12533",1958,"100",20,5,25
"12534",1958,"101",9,4,13
"12535",1958,"102",8,2,10
"12536",1958,"103",3,21,24
"12537",1958,"104",2,1,3
"12538",1958,"105",1,0,1
"12539",1958,"106",2,0,2
"12540",1958,"107",2,0,2
"12541",1958,"108",0,0,0
"12542",1958,"109",0,0,0
"12543",1958,"110+",0,0,0
"12544",1959,"0",30189,31510,61699
"12545",1959,"1",30080,31597,61677
"12546",1959,"2",30669,32026,62695
"12547",1959,"3",30055,31775,61830
"12548",1959,"4",29912,31145,61057
"12549",1959,"5",29991,31320,61311
"12550",1959,"6",29413,31283,60696
"12551",1959,"7",28283,30192,58475
"12552",1959,"8",29362,31032,60394
"12553",1959,"9",29487,31092,60579
"12554",1959,"10",30448,32563,63011
"12555",1959,"11",31696,33158,64854
"12556",1959,"12",33053,34794,67847
"12557",1959,"13",30101,31787,61888
"12558",1959,"14",28773,30574,59347
"12559",1959,"15",25889,27341,53230
"12560",1959,"16",24154,25133,49287
"12561",1959,"17",21190,21849,43039
"12562",1959,"18",22097,23138,45235
"12563",1959,"19",21501,22220,43721
"12564",1959,"20",20962,21638,42600
"12565",1959,"21",20031,20937,40968
"12566",1959,"22",19388,20419,39807
"12567",1959,"23",18945,19558,38503
"12568",1959,"24",18958,19861,38819
"12569",1959,"25",18810,19962,38772
"12570",1959,"26",20569,21316,41885
"12571",1959,"27",20709,21378,42087
"12572",1959,"28",21446,22549,43995
"12573",1959,"29",21171,22200,43371
"12574",1959,"30",22004,22703,44707
"12575",1959,"31",21988,22866,44854
"12576",1959,"32",23247,24203,47450
"12577",1959,"33",23359,24268,47627
"12578",1959,"34",24476,25641,50117
"12579",1959,"35",25822,26613,52435
"12580",1959,"36",26107,26331,52438
"12581",1959,"37",26730,26839,53569
"12582",1959,"38",28874,29173,58047
"12583",1959,"39",24079,24638,48717
"12584",1959,"40",25799,25803,51602
"12585",1959,"41",25706,25853,51559
"12586",1959,"42",24806,24726,49532
"12587",1959,"43",24553,24427,48980
"12588",1959,"44",24621,25081,49702
"12589",1959,"45",24449,24724,49173
"12590",1959,"46",24784,24849,49633
"12591",1959,"47",23877,24130,48007
"12592",1959,"48",23744,23626,47370
"12593",1959,"49",23712,23571,47283
"12594",1959,"50",22815,22726,45541
"12595",1959,"51",22457,21587,44044
"12596",1959,"52",22094,21244,43338
"12597",1959,"53",22003,20593,42596
"12598",1959,"54",21576,20263,41839
"12599",1959,"55",21603,20193,41796
"12600",1959,"56",21206,19932,41138
"12601",1959,"57",20756,19448,40204
"12602",1959,"58",20580,18907,39487
"12603",1959,"59",19801,18057,37858
"12604",1959,"60",19990,18236,38226
"12605",1959,"61",18841,17143,35984
"12606",1959,"62",18340,16795,35135
"12607",1959,"63",17685,16184,33869
"12608",1959,"64",16572,14985,31557
"12609",1959,"65",16219,14554,30773
"12610",1959,"66",15158,13443,28601
"12611",1959,"67",14617,12909,27526
"12612",1959,"68",14112,11979,26091
"12613",1959,"69",12908,10833,23741
"12614",1959,"70",12703,10556,23259
"12615",1959,"71",12208,10263,22471
"12616",1959,"72",11289,9390,20679
"12617",1959,"73",10801,8693,19494
"12618",1959,"74",10183,7929,18112
"12619",1959,"75",9275,7288,16563
"12620",1959,"76",8704,6875,15579
"12621",1959,"77",7695,5928,13623
"12622",1959,"78",7284,5603,12887
"12623",1959,"79",6818,5452,12270
"12624",1959,"80",6448,4946,11394
"12625",1959,"81",5548,4305,9853
"12626",1959,"82",5010,3791,8801
"12627",1959,"83",4309,3364,7673
"12628",1959,"84",3671,2745,6416
"12629",1959,"85",3014,2235,5249
"12630",1959,"86",2621,1961,4582
"12631",1959,"87",1987,1348,3335
"12632",1959,"88",1658,1139,2797
"12633",1959,"89",1360,862,2222
"12634",1959,"90",1042,640,1682
"12635",1959,"91",824,512,1336
"12636",1959,"92",633,387,1020
"12637",1959,"93",453,242,695
"12638",1959,"94",312,178,490
"12639",1959,"95",224,118,342
"12640",1959,"96",129,82,211
"12641",1959,"97",106,62,168
"12642",1959,"98",69,35,104
"12643",1959,"99",37,14,51
"12644",1959,"100",24,10,34
"12645",1959,"101",17,3,20
"12646",1959,"102",5,3,8
"12647",1959,"103",5,1,6
"12648",1959,"104",3,15,18
"12649",1959,"105",2,0,2
"12650",1959,"106",1,0,1
"12651",1959,"107",1,0,1
"12652",1959,"108",1,0,1
"12653",1959,"109",0,0,0
"12654",1959,"110+",0,0,0
"12655",1960,"0",30057,31612,61669
"12656",1960,"1",30180,31676,61856
"12657",1960,"2",29993,31534,61527
"12658",1960,"3",30647,32016,62663
"12659",1960,"4",30005,31728,61733
"12660",1960,"5",29895,31106,61001
"12661",1960,"6",29979,31301,61280
"12662",1960,"7",29413,31263,60676
"12663",1960,"8",28256,30166,58422
"12664",1960,"9",29377,31038,60415
"12665",1960,"10",29443,31059,60502
"12666",1960,"11",30433,32521,62954
"12667",1960,"12",31682,33128,64810
"12668",1960,"13",33069,34821,67890
"12669",1960,"14",30130,31779,61909
"12670",1960,"15",28827,30580,59407
"12671",1960,"16",25903,27332,53235
"12672",1960,"17",24245,25137,49382
"12673",1960,"18",21175,21816,42991
"12674",1960,"19",22031,23128,45159
"12675",1960,"20",21397,22189,43586
"12676",1960,"21",20838,21629,42467
"12677",1960,"22",19942,20893,40835
"12678",1960,"23",19283,20269,39552
"12679",1960,"24",18871,19435,38306
"12680",1960,"25",18909,19710,38619
"12681",1960,"26",18720,19812,38532
"12682",1960,"27",20501,21194,41695
"12683",1960,"28",20652,21249,41901
"12684",1960,"29",21373,22413,43786
"12685",1960,"30",21116,22100,43216
"12686",1960,"31",21981,22588,44569
"12687",1960,"32",21933,22738,44671
"12688",1960,"33",23230,24112,47342
"12689",1960,"34",23320,24208,47528
"12690",1960,"35",24433,25562,49995
"12691",1960,"36",25771,26549,52320
"12692",1960,"37",26017,26233,52250
"12693",1960,"38",26666,26792,53458
"12694",1960,"39",28794,29091,57885
"12695",1960,"40",24066,24566,48632
"12696",1960,"41",25746,25721,51467
"12697",1960,"42",25657,25761,51418
"12698",1960,"43",24771,24644,49415
"12699",1960,"44",24484,24363,48847
"12700",1960,"45",24542,24984,49526
"12701",1960,"46",24368,24615,48983
"12702",1960,"47",24724,24771,49495
"12703",1960,"48",23797,24026,47823
"12704",1960,"49",23644,23512,47156
"12705",1960,"50",23651,23475,47126
"12706",1960,"51",22746,22614,45360
"12707",1960,"52",22380,21459,43839
"12708",1960,"53",22006,21101,43107
"12709",1960,"54",21901,20410,42311
"12710",1960,"55",21474,20094,41568
"12711",1960,"56",21467,19990,41457
"12712",1960,"57",21101,19733,40834
"12713",1960,"58",20621,19250,39871
"12714",1960,"59",20412,18677,39089
"12715",1960,"60",19652,17798,37450
"12716",1960,"61",19817,17960,37777
"12717",1960,"62",18667,16838,35505
"12718",1960,"63",18123,16535,34658
"12719",1960,"64",17461,15869,33330
"12720",1960,"65",16334,14666,31000
"12721",1960,"66",15937,14252,30189
"12722",1960,"67",14886,13126,28012
"12723",1960,"68",14325,12588,26913
"12724",1960,"69",13799,11645,25444
"12725",1960,"70",12580,10479,23059
"12726",1960,"71",12365,10165,22530
"12727",1960,"72",11853,9869,21722
"12728",1960,"73",10887,8949,19836
"12729",1960,"74",10370,8307,18677
"12730",1960,"75",9770,7529,17299
"12731",1960,"76",8822,6893,15715
"12732",1960,"77",8191,6469,14660
"12733",1960,"78",7216,5465,12681
"12734",1960,"79",6796,5132,11928
"12735",1960,"80",6447,4963,11410
"12736",1960,"81",5924,4472,10396
"12737",1960,"82",4973,3833,8806
"12738",1960,"83",4469,3353,7822
"12739",1960,"84",3823,2926,6749
"12740",1960,"85",3213,2386,5599
"12741",1960,"86",2585,1881,4466
"12742",1960,"87",2209,1619,3828
"12743",1960,"88",1628,1102,2730
"12744",1960,"89",1358,898,2256
"12745",1960,"90",1064,676,1740
"12746",1960,"91",811,495,1306
"12747",1960,"92",627,387,1014
"12748",1960,"93",466,272,738
"12749",1960,"94",317,171,488
"12750",1960,"95",210,116,326
"12751",1960,"96",152,76,228
"12752",1960,"97",85,51,136
"12753",1960,"98",71,33,104
"12754",1960,"99",43,17,60
"12755",1960,"100",20,6,26
"12756",1960,"101",14,5,19
"12757",1960,"102",11,1,12
"12758",1960,"103",2,1,3
"12759",1960,"104",2,0,2
"12760",1960,"105",2,11,13
"12761",1960,"106",2,0,2
"12762",1960,"107",1,0,1
"12763",1960,"108",0,0,0
"12764",1960,"109",0,0,0
"12765",1960,"110+",0,0,0
"12766",1961,"0",29603,30998,60601
"12767",1961,"1",29864,31644,61508
"12768",1961,"2",30225,31612,61837
"12769",1961,"3",29928,31457,61385
"12770",1961,"4",30669,31967,62636
"12771",1961,"5",29944,31694,61638
"12772",1961,"6",29857,31076,60933
"12773",1961,"7",29972,31279,61251
"12774",1961,"8",29532,31258,60790
"12775",1961,"9",28239,30121,58360
"12776",1961,"10",29392,31051,60443
"12777",1961,"11",29411,31063,60474
"12778",1961,"12",30407,32510,62917
"12779",1961,"13",31662,33102,64764
"12780",1961,"14",33119,34882,68001
"12781",1961,"15",30188,31813,62001
"12782",1961,"16",28905,30646,59551
"12783",1961,"17",25912,27342,53254
"12784",1961,"18",24228,25137,49365
"12785",1961,"19",21102,21777,42879
"12786",1961,"20",21979,23121,45100
"12787",1961,"21",21256,22149,43405
"12788",1961,"22",20696,21566,42262
"12789",1961,"23",19815,20734,40549
"12790",1961,"24",19169,20150,39319
"12791",1961,"25",18792,19231,38023
"12792",1961,"26",18797,19548,38345
"12793",1961,"27",18663,19650,38313
"12794",1961,"28",20376,21008,41384
"12795",1961,"29",20560,21037,41597
"12796",1961,"30",21293,22263,43556
"12797",1961,"31",21058,21932,42990
"12798",1961,"32",21918,22455,44373
"12799",1961,"33",21868,22620,44488
"12800",1961,"34",23221,24001,47222
"12801",1961,"35",23287,24109,47396
"12802",1961,"36",24393,25488,49881
"12803",1961,"37",25745,26461,52206
"12804",1961,"38",25963,26146,52109
"12805",1961,"39",26600,26692,53292
"12806",1961,"40",28743,28980,57723
"12807",1961,"41",24093,24521,48614
"12808",1961,"42",25738,25597,51335
"12809",1961,"43",25609,25677,51286
"12810",1961,"44",24729,24528,49257
"12811",1961,"45",24449,24293,48742
"12812",1961,"46",24481,24868,49349
"12813",1961,"47",24286,24515,48801
"12814",1961,"48",24654,24680,49334
"12815",1961,"49",23705,23903,47608
"12816",1961,"50",23547,23394,46941
"12817",1961,"51",23586,23384,46970
"12818",1961,"52",22652,22483,45135
"12819",1961,"53",22295,21292,43587
"12820",1961,"54",21896,20959,42855
"12821",1961,"55",21783,20222,42005
"12822",1961,"56",21360,19897,41257
"12823",1961,"57",21297,19831,41128
"12824",1961,"58",20999,19526,40525
"12825",1961,"59",20462,19027,39489
"12826",1961,"60",20218,18394,38612
"12827",1961,"61",19475,17521,36996
"12828",1961,"62",19633,17624,37257
"12829",1961,"63",18447,16507,34954
"12830",1961,"64",17922,16232,34154
"12831",1961,"65",17242,15538,32780
"12832",1961,"66",16089,14359,30448
"12833",1961,"67",15681,13920,29601
"12834",1961,"68",14596,12747,27343
"12835",1961,"69",13986,12222,26208
"12836",1961,"70",13459,11282,24741
"12837",1961,"71",12261,10096,22357
"12838",1961,"72",11951,9761,21712
"12839",1961,"73",11466,9443,20909
"12840",1961,"74",10482,8505,18987
"12841",1961,"75",9920,7892,17812
"12842",1961,"76",9244,7100,16344
"12843",1961,"77",8326,6451,14777
"12844",1961,"78",7652,5997,13649
"12845",1961,"79",6680,5032,11712
"12846",1961,"80",6246,4615,10861
"12847",1961,"81",5902,4460,10362
"12848",1961,"82",5362,3991,9353
"12849",1961,"83",4461,3373,7834
"12850",1961,"84",3954,2855,6809
"12851",1961,"85",3308,2505,5813
"12852",1961,"86",2760,2000,4760
"12853",1961,"87",2174,1521,3695
"12854",1961,"88",1837,1304,3141
"12855",1961,"89",1318,877,2195
"12856",1961,"90",1088,731,1819
"12857",1961,"91",800,505,1305
"12858",1961,"92",614,378,992
"12859",1961,"93",467,274,741
"12860",1961,"94",343,194,537
"12861",1961,"95",230,110,340
"12862",1961,"96",136,78,214
"12863",1961,"97",92,42,134
"12864",1961,"98",54,32,86
"12865",1961,"99",45,21,66
"12866",1961,"100",25,9,34
"12867",1961,"101",12,3,15
"12868",1961,"102",11,2,13
"12869",1961,"103",8,0,8
"12870",1961,"104",2,1,3
"12871",1961,"105",1,0,1
"12872",1961,"106",1,7,8
"12873",1961,"107",0,0,0
"12874",1961,"108",1,0,1
"12875",1961,"109",0,0,0
"12876",1961,"110+",0,0,0
"12877",1962,"0",29848,31756,61604
"12878",1962,"1",29524,30897,60421
"12879",1962,"2",29854,31623,61477
"12880",1962,"3",30218,31592,61810
"12881",1962,"4",29914,31434,61348
"12882",1962,"5",30672,31950,62622
"12883",1962,"6",29927,31658,61585
"12884",1962,"7",29868,31066,60934
"12885",1962,"8",29974,31265,61239
"12886",1962,"9",29522,31249,60771
"12887",1962,"10",28240,30119,58359
"12888",1962,"11",29389,31021,60410
"12889",1962,"12",29410,31042,60452
"12890",1962,"13",30419,32502,62921
"12891",1962,"14",31654,33099,64753
"12892",1962,"15",33116,34863,67979
"12893",1962,"16",30191,31785,61976
"12894",1962,"17",28963,30636,59599
"12895",1962,"18",25931,27320,53251
"12896",1962,"19",24155,25131,49286
"12897",1962,"20",21025,21803,42828
"12898",1962,"21",21967,23118,45085
"12899",1962,"22",21271,22163,43434
"12900",1962,"23",20643,21522,42165
"12901",1962,"24",19824,20684,40508
"12902",1962,"25",19135,20077,39212
"12903",1962,"26",18771,19215,37986
"12904",1962,"27",18821,19525,38346
"12905",1962,"28",18674,19622,38296
"12906",1962,"29",20364,21002,41366
"12907",1962,"30",20552,21011,41563
"12908",1962,"31",21306,22263,43569
"12909",1962,"32",21056,21924,42980
"12910",1962,"33",21915,22412,44327
"12911",1962,"34",21847,22587,44434
"12912",1962,"35",23189,23952,47141
"12913",1962,"36",23253,24096,47349
"12914",1962,"37",24393,25452,49845
"12915",1962,"38",25715,26408,52123
"12916",1962,"39",25928,26104,52032
"12917",1962,"40",26573,26631,53204
"12918",1962,"41",28710,28930,57640
"12919",1962,"42",24044,24448,48492
"12920",1962,"43",25703,25512,51215
"12921",1962,"44",25575,25600,51175
"12922",1962,"45",24672,24449,49121
"12923",1962,"46",24398,24202,48600
"12924",1962,"47",24419,24776,49195
"12925",1962,"48",24229,24442,48671
"12926",1962,"49",24598,24568,49166
"12927",1962,"50",23625,23809,47434
"12928",1962,"51",23483,23262,46745
"12929",1962,"52",23500,23244,46744
"12930",1962,"53",22568,22311,44879
"12931",1962,"54",22209,21108,43317
"12932",1962,"55",21804,20780,42584
"12933",1962,"56",21665,20027,41692
"12934",1962,"57",21239,19660,40899
"12935",1962,"58",21177,19609,40786
"12936",1962,"59",20833,19290,40123
"12937",1962,"60",20295,18766,39061
"12938",1962,"61",20053,18102,38155
"12939",1962,"62",19294,17195,36489
"12940",1962,"63",19421,17277,36698
"12941",1962,"64",18214,16148,34362
"12942",1962,"65",17685,15865,33550
"12943",1962,"66",16995,15168,32163
"12944",1962,"67",15821,13999,29820
"12945",1962,"68",15420,13539,28959
"12946",1962,"69",14295,12347,26642
"12947",1962,"70",13626,11751,25377
"12948",1962,"71",13099,10796,23895
"12949",1962,"72",11908,9665,21573
"12950",1962,"73",11534,9290,20824
"12951",1962,"74",11015,8989,20004
"12952",1962,"75",10023,8056,18079
"12953",1962,"76",9441,7418,16859
"12954",1962,"77",8770,6627,15397
"12955",1962,"78",7819,5914,13733
"12956",1962,"79",7136,5538,12674
"12957",1962,"80",6232,4530,10762
"12958",1962,"81",5704,4151,9855
"12959",1962,"82",5292,3956,9248
"12960",1962,"83",4761,3527,8288
"12961",1962,"84",3942,2916,6858
"12962",1962,"85",3408,2432,5840
"12963",1962,"86",2840,2121,4961
"12964",1962,"87",2308,1650,3958
"12965",1962,"88",1798,1205,3003
"12966",1962,"89",1482,1029,2511
"12967",1962,"90",1049,651,1700
"12968",1962,"91",851,543,1394
"12969",1962,"92",617,379,996
"12970",1962,"93",438,272,710
"12971",1962,"94",349,186,535
"12972",1962,"95",234,139,373
"12973",1962,"96",157,66,223
"12974",1962,"97",94,42,136
"12975",1962,"98",56,35,91
"12976",1962,"99",29,17,46
"12977",1962,"100",25,11,36
"12978",1962,"101",16,7,23
"12979",1962,"102",6,1,7
"12980",1962,"103",4,1,5
"12981",1962,"104",4,0,4
"12982",1962,"105",1,1,2
"12983",1962,"106",1,0,1
"12984",1962,"107",0,2,2
"12985",1962,"108",0,0,0
"12986",1962,"109",0,0,0
"12987",1962,"110+",0,0,0
"12988",1963,"0",29858,31443,61301
"12989",1963,"1",29763,31646,61409
"12990",1963,"2",29523,30905,60428
"12991",1963,"3",29851,31598,61449
"12992",1963,"4",30213,31581,61794
"12993",1963,"5",29905,31427,61332
"12994",1963,"6",30651,31933,62584
"12995",1963,"7",29921,31667,61588
"12996",1963,"8",29868,31053,60921
"12997",1963,"9",29982,31276,61258
"12998",1963,"10",29526,31234,60760
"12999",1963,"11",28234,30111,58345
"13000",1963,"12",29384,31014,60398
"13001",1963,"13",29395,31031,60426
"13002",1963,"14",30415,32493,62908
"13003",1963,"15",31641,33096,64737
"13004",1963,"16",33093,34842,67935
"13005",1963,"17",30199,31757,61956
"13006",1963,"18",28895,30580,59475
"13007",1963,"19",25808,27303,53111
"13008",1963,"20",24090,25152,49242
"13009",1963,"21",20932,21784,42716
"13010",1963,"22",21896,23059,44955
"13011",1963,"23",21203,22034,43237
"13012",1963,"24",20613,21462,42075
"13013",1963,"25",19818,20596,40414
"13014",1963,"26",19126,20005,39131
"13015",1963,"27",18779,19131,37910
"13016",1963,"28",18814,19481,38295
"13017",1963,"29",18686,19592,38278
"13018",1963,"30",20363,20974,41337
"13019",1963,"31",20556,20969,41525
"13020",1963,"32",21312,22252,43564
"13021",1963,"33",21058,21879,42937
"13022",1963,"34",21904,22392,44296
"13023",1963,"35",21835,22563,44398
"13024",1963,"36",23168,23902,47070
"13025",1963,"37",23249,24050,47299
"13026",1963,"38",24369,25399,49768
"13027",1963,"39",25702,26353,52055
"13028",1963,"40",25904,26037,51941
"13029",1963,"41",26528,26578,53106
"13030",1963,"42",28681,28866,57547
"13031",1963,"43",24005,24373,48378
"13032",1963,"44",25644,25463,51107
"13033",1963,"45",25536,25539,51075
"13034",1963,"46",24617,24368,48985
"13035",1963,"47",24332,24113,48445
"13036",1963,"48",24374,24692,49066
"13037",1963,"49",24175,24317,48492
"13038",1963,"50",24524,24448,48972
"13039",1963,"51",23551,23676,47227
"13040",1963,"52",23414,23109,46523
"13041",1963,"53",23416,23046,46462
"13042",1963,"54",22465,22135,44600
"13043",1963,"55",22092,20966,43058
"13044",1963,"56",21702,20592,42294
"13045",1963,"57",21545,19812,41357
"13046",1963,"58",21127,19391,40518
"13047",1963,"59",21015,19345,40360
"13048",1963,"60",20659,19012,39671
"13049",1963,"61",20127,18493,38620
"13050",1963,"62",19865,17782,37647
"13051",1963,"63",19075,16865,35940
"13052",1963,"64",19196,16916,36112
"13053",1963,"65",17953,15781,33734
"13054",1963,"66",17459,15513,32972
"13055",1963,"67",16696,14718,31414
"13056",1963,"68",15564,13558,29122
"13057",1963,"69",15087,13070,28157
"13058",1963,"70",13917,11927,25844
"13059",1963,"71",13222,11274,24496
"13060",1963,"72",12705,10285,22990
"13061",1963,"73",11520,9231,20751
"13062",1963,"74",11029,8781,19810
"13063",1963,"75",10541,8472,19013
"13064",1963,"76",9534,7560,17094
"13065",1963,"77",8940,6898,15838
"13066",1963,"78",8226,6119,14345
"13067",1963,"79",7301,5417,12718
"13068",1963,"80",6637,4925,11562
"13069",1963,"81",5714,4046,9760
"13070",1963,"82",5154,3692,8846
"13071",1963,"83",4689,3480,8169
"13072",1963,"84",4197,3074,7271
"13073",1963,"85",3424,2452,5876
"13074",1963,"86",2906,2052,4958
"13075",1963,"87",2404,1752,4156
"13076",1963,"88",1904,1331,3235
"13077",1963,"89",1428,943,2371
"13078",1963,"90",1160,801,1961
"13079",1963,"91",836,477,1313
"13080",1963,"92",630,397,1027
"13081",1963,"93",451,266,717
"13082",1963,"94",299,195,494
"13083",1963,"95",246,119,365
"13084",1963,"96",149,88,237
"13085",1963,"97",106,42,148
"13086",1963,"98",61,30,91
"13087",1963,"99",30,20,50
"13088",1963,"100",14,10,24
"13089",1963,"101",15,5,20
"13090",1963,"102",7,3,10
"13091",1963,"103",5,1,6
"13092",1963,"104",2,1,3
"13093",1963,"105",2,0,2
"13094",1963,"106",0,0,0
"13095",1963,"107",1,0,1
"13096",1963,"108",0,2,2
"13097",1963,"109",0,0,0
"13098",1963,"110+",0,0,0
"13099",1964,"0",30547,31856,62403
"13100",1964,"1",29785,31353,61138
"13101",1964,"2",29749,31610,61359
"13102",1964,"3",29524,30900,60424
"13103",1964,"4",29840,31585,61425
"13104",1964,"5",30212,31558,61770
"13105",1964,"6",29914,31419,61333
"13106",1964,"7",30640,31913,62553
"13107",1964,"8",29919,31643,61562
"13108",1964,"9",29878,31043,60921
"13109",1964,"10",29979,31270,61249
"13110",1964,"11",29517,31224,60741
"13111",1964,"12",28233,30100,58333
"13112",1964,"13",29383,30995,60378
"13113",1964,"14",29387,31026,60413
"13114",1964,"15",30402,32473,62875
"13115",1964,"16",31623,33065,64688
"13116",1964,"17",33145,34807,67952
"13117",1964,"18",30199,31725,61924
"13118",1964,"19",28808,30607,59415
"13119",1964,"20",25746,27305,53051
"13120",1964,"21",23996,25148,49144
"13121",1964,"22",20897,21782,42679
"13122",1964,"23",21877,23012,44889
"13123",1964,"24",21192,22008,43200
"13124",1964,"25",20585,21390,41975
"13125",1964,"26",19780,20579,40359
"13126",1964,"27",19119,19964,39083
"13127",1964,"28",18755,19091,37846
"13128",1964,"29",18805,19442,38247
"13129",1964,"30",18680,19543,38223
"13130",1964,"31",20361,20961,41322
"13131",1964,"32",20537,20955,41492
"13132",1964,"33",21328,22205,43533
"13133",1964,"34",21027,21865,42892
"13134",1964,"35",21891,22349,44240
"13135",1964,"36",21839,22533,44372
"13136",1964,"37",23156,23865,47021
"13137",1964,"38",23239,23996,47235
"13138",1964,"39",24345,25359,49704
"13139",1964,"40",25656,26305,51961
"13140",1964,"41",25885,25991,51876
"13141",1964,"42",26507,26512,53019
"13142",1964,"43",28649,28759,57408
"13143",1964,"44",23950,24310,48260
"13144",1964,"45",25589,25376,50965
"13145",1964,"46",25461,25453,50914
"13146",1964,"47",24556,24273,48829
"13147",1964,"48",24268,24013,48281
"13148",1964,"49",24305,24581,48886
"13149",1964,"50",24115,24194,48309
"13150",1964,"51",24436,24299,48735
"13151",1964,"52",23468,23530,46998
"13152",1964,"53",23313,22929,46242
"13153",1964,"54",23307,22869,46176
"13154",1964,"55",22358,21918,44276
"13155",1964,"56",21977,20730,42707
"13156",1964,"57",21595,20333,41928
"13157",1964,"58",21407,19550,40957
"13158",1964,"59",20979,19115,40094
"13159",1964,"60",20859,19075,39934
"13160",1964,"61",20458,18711,39169
"13161",1964,"62",19959,18200,38159
"13162",1964,"63",19667,17466,37133
"13163",1964,"64",18846,16488,35334
"13164",1964,"65",18937,16501,35438
"13165",1964,"66",17709,15342,33051
"13166",1964,"67",17146,15077,32223
"13167",1964,"68",16372,14264,30636
"13168",1964,"69",15217,13093,28310
"13169",1964,"70",14720,12543,27263
"13170",1964,"71",13489,11432,24921
"13171",1964,"72",12785,10751,23536
"13172",1964,"73",12215,9771,21986
"13173",1964,"74",11002,8707,19709
"13174",1964,"75",10443,8253,18696
"13175",1964,"76",9989,7883,17872
"13176",1964,"77",8946,6997,15943
"13177",1964,"78",8299,6347,14646
"13178",1964,"79",7568,5595,13163
"13179",1964,"80",6829,4875,11704
"13180",1964,"81",6000,4354,10354
"13181",1964,"82",5126,3542,8668
"13182",1964,"83",4495,3198,7693
"13183",1964,"84",4044,3025,7069
"13184",1964,"85",3593,2621,6214
"13185",1964,"86",2874,2031,4905
"13186",1964,"87",2429,1639,4068
"13187",1964,"88",1943,1399,3342
"13188",1964,"89",1510,1038,2548
"13189",1964,"90",1123,711,1834
"13190",1964,"91",871,580,1451
"13191",1964,"92",596,348,944
"13192",1964,"93",456,291,747
"13193",1964,"94",326,187,513
"13194",1964,"95",193,131,324
"13195",1964,"96",163,78,241
"13196",1964,"97",91,53,144
"13197",1964,"98",57,26,83
"13198",1964,"99",34,20,54
"13199",1964,"100",23,14,37
"13200",1964,"101",10,4,14
"13201",1964,"102",10,2,12
"13202",1964,"103",3,1,4
"13203",1964,"104",2,0,2
"13204",1964,"105",1,1,2
"13205",1964,"106",1,0,1
"13206",1964,"107",0,0,0
"13207",1964,"108",1,0,1
"13208",1964,"109",0,0,0
"13209",1964,"110+",0,0,0
"13210",1965,"0",31189,33422,64611
"13211",1965,"1",30471,31761,62232
"13212",1965,"2",29744,31297,61041
"13213",1965,"3",29713,31555,61268
"13214",1965,"4",29517,30857,60374
"13215",1965,"5",29830,31539,61369
"13216",1965,"6",30206,31513,61719
"13217",1965,"7",29919,31406,61325
"13218",1965,"8",30638,31887,62525
"13219",1965,"9",29903,31630,61533
"13220",1965,"10",29846,31030,60876
"13221",1965,"11",29972,31230,61202
"13222",1965,"12",29531,31209,60740
"13223",1965,"13",28222,30091,58313
"13224",1965,"14",29374,30979,60353
"13225",1965,"15",29376,31001,60377
"13226",1965,"16",30390,32437,62827
"13227",1965,"17",31630,33031,64661
"13228",1965,"18",33035,34766,67801
"13229",1965,"19",30056,31651,61707
"13230",1965,"20",28608,30542,59150
"13231",1965,"21",25573,27250,52823
"13232",1965,"22",23876,25055,48931
"13233",1965,"23",20787,21663,42450
"13234",1965,"24",21775,22935,44710
"13235",1965,"25",21106,21908,43014
"13236",1965,"26",20523,21243,41766
"13237",1965,"27",19764,20464,40228
"13238",1965,"28",19109,19893,39002
"13239",1965,"29",18733,19012,37745
"13240",1965,"30",18808,19383,38191
"13241",1965,"31",18659,19507,38166
"13242",1965,"32",20314,20919,41233
"13243",1965,"33",20516,20905,41421
"13244",1965,"34",21301,22161,43462
"13245",1965,"35",21016,21820,42836
"13246",1965,"36",21887,22301,44188
"13247",1965,"37",21797,22514,44311
"13248",1965,"38",23134,23796,46930
"13249",1965,"39",23198,23947,47145
"13250",1965,"40",24309,25311,49620
"13251",1965,"41",25620,26233,51853
"13252",1965,"42",25847,25930,51777
"13253",1965,"43",26490,26421,52911
"13254",1965,"44",28596,28651,57247
"13255",1965,"45",23915,24216,48131
"13256",1965,"46",25541,25259,50800
"13257",1965,"47",25411,25348,50759
"13258",1965,"48",24491,24151,48642
"13259",1965,"49",24200,23899,48099
"13260",1965,"50",24233,24418,48651
"13261",1965,"51",24053,24013,48066
"13262",1965,"52",24365,24127,48492
"13263",1965,"53",23369,23377,46746
"13264",1965,"54",23203,22767,45970
"13265",1965,"55",23190,22662,45852
"13266",1965,"56",22246,21676,43922
"13267",1965,"57",21863,20496,42359
"13268",1965,"58",21467,20119,41586
"13269",1965,"59",21281,19303,40584
"13270",1965,"60",20818,18833,39651
"13271",1965,"61",20677,18794,39471
"13272",1965,"62",20282,18381,38663
"13273",1965,"63",19747,17826,37573
"13274",1965,"64",19448,17081,36529
"13275",1965,"65",18565,16068,34633
"13276",1965,"66",18660,16099,34759
"13277",1965,"67",17391,14887,32278
"13278",1965,"68",16824,14618,31442
"13279",1965,"69",16023,13799,29822
"13280",1965,"70",14838,12597,27435
"13281",1965,"71",14317,12063,26380
"13282",1965,"72",13075,10930,24005
"13283",1965,"73",12319,10240,22559
"13284",1965,"74",11755,9280,21035
"13285",1965,"75",10514,8233,18747
"13286",1965,"76",9925,7677,17602
"13287",1965,"77",9395,7355,16750
"13288",1965,"78",8338,6483,14821
"13289",1965,"79",7701,5823,13524
"13290",1965,"80",7062,5029,12091
"13291",1965,"81",6219,4368,10587
"13292",1965,"82",5399,3880,9279
"13293",1965,"83",4578,3106,7684
"13294",1965,"84",3935,2746,6681
"13295",1965,"85",3470,2576,6046
"13296",1965,"86",3062,2180,5242
"13297",1965,"87",2446,1690,4136
"13298",1965,"88",2034,1318,3352
"13299",1965,"89",1567,1107,2674
"13300",1965,"90",1198,830,2028
"13301",1965,"91",855,550,1405
"13302",1965,"92",691,438,1129
"13303",1965,"93",456,246,702
"13304",1965,"94",340,196,536
"13305",1965,"95",243,135,378
"13306",1965,"96",126,81,207
"13307",1965,"97",106,50,156
"13308",1965,"98",66,33,99
"13309",1965,"99",30,19,49
"13310",1965,"100",21,9,30
"13311",1965,"101",11,12,23
"13312",1965,"102",4,3,7
"13313",1965,"103",3,2,5
"13314",1965,"104",3,1,4
"13315",1965,"105",2,0,2
"13316",1965,"106",1,0,1
"13317",1965,"107",0,0,0
"13318",1965,"108",0,0,0
"13319",1965,"109",0,0,0
"13320",1965,"110+",0,0,0
"13321",1966,"0",31584,33726,65310
"13322",1966,"1",31096,33324,64420
"13323",1966,"2",30442,31748,62190
"13324",1966,"3",29714,31270,60984
"13325",1966,"4",29682,31534,61216
"13326",1966,"5",29490,30810,60300
"13327",1966,"6",29820,31516,61336
"13328",1966,"7",30174,31468,61642
"13329",1966,"8",29900,31380,61280
"13330",1966,"9",30640,31866,62506
"13331",1966,"10",29876,31616,61492
"13332",1966,"11",29830,31000,60830
"13333",1966,"12",29982,31224,61206
"13334",1966,"13",29518,31184,60702
"13335",1966,"14",28222,30076,58298
"13336",1966,"15",29354,30940,60294
"13337",1966,"16",29354,30964,60318
"13338",1966,"17",30364,32418,62782
"13339",1966,"18",31468,32944,64412
"13340",1966,"19",32858,34678,67536
"13341",1966,"20",29880,31596,61476
"13342",1966,"21",28444,30464,58908
"13343",1966,"22",25410,27136,52546
"13344",1966,"23",23738,24874,48612
"13345",1966,"24",20726,21546,42272
"13346",1966,"25",21676,22802,44478
"13347",1966,"26",21046,21858,42904
"13348",1966,"27",20532,21134,41666
"13349",1966,"28",19716,20370,40086
"13350",1966,"29",19088,19818,38906
"13351",1966,"30",18718,18962,37680
"13352",1966,"31",18798,19364,38162
"13353",1966,"32",18640,19474,38114
"13354",1966,"33",20302,20860,41162
"13355",1966,"34",20504,20892,41396
"13356",1966,"35",21280,22114,43394
"13357",1966,"36",21000,21764,42764
"13358",1966,"37",21868,22228,44096
"13359",1966,"38",21758,22474,44232
"13360",1966,"39",23112,23736,46848
"13361",1966,"40",23172,23904,47076
"13362",1966,"41",24284,25232,49516
"13363",1966,"42",25568,26176,51744
"13364",1966,"43",25810,25828,51638
"13365",1966,"44",26436,26340,52776
"13366",1966,"45",28560,28558,57118
"13367",1966,"46",23880,24126,48006
"13368",1966,"47",25492,25150,50642
"13369",1966,"48",25336,25264,50600
"13370",1966,"49",24432,24036,48468
"13371",1966,"50",24128,23760,47888
"13372",1966,"51",24154,24236,48390
"13373",1966,"52",23986,23848,47834
"13374",1966,"53",24258,23930,48188
"13375",1966,"54",23304,23178,46482
"13376",1966,"55",23104,22562,45666
"13377",1966,"56",23090,22444,45534
"13378",1966,"57",22148,21440,43588
"13379",1966,"58",21748,20252,42000
"13380",1966,"59",21298,19826,41124
"13381",1966,"60",21110,19042,40152
"13382",1966,"61",20644,18516,39160
"13383",1966,"62",20500,18452,38952
"13384",1966,"63",20070,18024,38094
"13385",1966,"64",19510,17482,36992
"13386",1966,"65",19208,16712,35920
"13387",1966,"66",18302,15640,33942
"13388",1966,"67",18410,15588,33998
"13389",1966,"68",17096,14436,31532
"13390",1966,"69",16492,14112,30604
"13391",1966,"70",15682,13322,29004
"13392",1966,"71",14442,12098,26540
"13393",1966,"72",13892,11516,25408
"13394",1966,"73",12640,10424,23064
"13395",1966,"74",11818,9674,21492
"13396",1966,"75",11268,8704,19972
"13397",1966,"76",10044,7730,17774
"13398",1966,"77",9404,7124,16528
"13399",1966,"78",8832,6820,15652
"13400",1966,"79",7776,5940,13716
"13401",1966,"80",7178,5226,12404
"13402",1966,"81",6444,4483,10927
"13403",1966,"82",5658,3907,9565
"13404",1966,"83",4821,3381,8202
"13405",1966,"84",4021,2685,6706
"13406",1966,"85",3414,2330,5744
"13407",1966,"86",2986,2171,5157
"13408",1966,"87",2569,1822,4391
"13409",1966,"88",2069,1362,3431
"13410",1966,"89",1684,1061,2745
"13411",1966,"90",1238,879,2117
"13412",1966,"91",929,624,1553
"13413",1966,"92",673,410,1083
"13414",1966,"93",522,327,849
"13415",1966,"94",342,169,511
"13416",1966,"95",253,135,388
"13417",1966,"96",170,90,260
"13418",1966,"97",79,56,135
"13419",1966,"98",74,31,105
"13420",1966,"99",47,21,68
"13421",1966,"100",16,12,28
"13422",1966,"101",13,6,19
"13423",1966,"102",3,8,11
"13424",1966,"103",1,1,2
"13425",1966,"104",2,1,3
"13426",1966,"105",1,0,1
"13427",1966,"106",0,0,0
"13428",1966,"107",0,0,0
"13429",1966,"108",0,0,0
"13430",1966,"109",0,0,0
"13431",1966,"110+",0,0,0
"13432",1967,"0",31784,33882,65666
"13433",1967,"1",31386,33540,64926
"13434",1967,"2",31025,33189,64214
"13435",1967,"3",30426,31664,62090
"13436",1967,"4",29708,31195,60903
"13437",1967,"5",29649,31414,61063
"13438",1967,"6",29511,30935,60446
"13439",1967,"7",29902,31645,61547
"13440",1967,"8",29993,31458,61451
"13441",1967,"9",30002,31373,61375
"13442",1967,"10",30599,31849,62448
"13443",1967,"11",30012,31666,61678
"13444",1967,"12",29821,30977,60798
"13445",1967,"13",29998,31255,61253
"13446",1967,"14",29436,31049,60485
"13447",1967,"15",28387,30236,58623
"13448",1967,"16",29185,30778,59963
"13449",1967,"17",29478,31130,60608
"13450",1967,"18",30254,32269,62523
"13451",1967,"19",31417,32986,64403
"13452",1967,"20",32762,34838,67600
"13453",1967,"21",29573,31350,60923
"13454",1967,"22",28241,30417,58658
"13455",1967,"23",25281,26958,52239
"13456",1967,"24",23414,24651,48065
"13457",1967,"25",20769,21585,42354
"13458",1967,"26",21356,22550,43906
"13459",1967,"27",21059,21756,42815
"13460",1967,"28",20484,21089,41573
"13461",1967,"29",19641,20367,40008
"13462",1967,"30",19004,19725,38729
"13463",1967,"31",18636,18925,37561
"13464",1967,"32",18700,19327,38027
"13465",1967,"33",18636,19569,38205
"13466",1967,"34",20275,20841,41116
"13467",1967,"35",20562,20963,41525
"13468",1967,"36",21097,22010,43107
"13469",1967,"37",20956,21767,42723
"13470",1967,"38",21775,22142,43917
"13471",1967,"39",21774,22456,44230
"13472",1967,"40",23101,23768,46869
"13473",1967,"41",23119,23811,46930
"13474",1967,"42",24221,25169,49390
"13475",1967,"43",25527,26165,51692
"13476",1967,"44",25882,25904,51786
"13477",1967,"45",26461,26373,52834
"13478",1967,"46",28464,28381,56845
"13479",1967,"47",23693,23946,47639
"13480",1967,"48",25373,25019,50392
"13481",1967,"49",25291,25242,50533
"13482",1967,"50",24340,23857,48197
"13483",1967,"51",24101,23619,47720
"13484",1967,"52",24078,24061,48139
"13485",1967,"53",23962,23743,47705
"13486",1967,"54",24078,23693,47771
"13487",1967,"55",23313,23009,46322
"13488",1967,"56",22927,22220,45147
"13489",1967,"57",23031,22062,45093
"13490",1967,"58",22014,21118,43132
"13491",1967,"59",21641,20039,41680
"13492",1967,"60",21236,19503,40739
"13493",1967,"61",20812,18628,39440
"13494",1967,"62",20578,18226,38804
"13495",1967,"63",20345,18127,38472
"13496",1967,"64",19930,17663,37593
"13497",1967,"65",19483,16993,36476
"13498",1967,"66",19007,16232,35239
"13499",1967,"67",18179,15221,33400
"13500",1967,"68",17931,15003,32934
"13501",1967,"69",16982,14014,30996
"13502",1967,"70",16208,13493,29701
"13503",1967,"71",15379,12676,28055
"13504",1967,"72",14170,11580,25750
"13505",1967,"73",13652,10907,24559
"13506",1967,"74",12329,9808,22137
"13507",1967,"75",11581,9113,20694
"13508",1967,"76",10752,8051,18803
"13509",1967,"77",9648,7137,16785
"13510",1967,"78",8913,6466,15379
"13511",1967,"79",8261,6196,14457
"13512",1967,"80",7263,5275,12538
"13513",1967,"81",6577,4651,11228
"13514",1967,"82",5862,3968,9830
"13515",1967,"83",5084,3408,8492
"13516",1967,"84",4241,2915,7156
"13517",1967,"85",3485,2300,5785
"13518",1967,"86",2954,1943,4897
"13519",1967,"87",2495,1821,4316
"13520",1967,"88",2148,1499,3647
"13521",1967,"89",1690,1063,2753
"13522",1967,"90",1326,830,2156
"13523",1967,"91",981,666,1647
"13524",1967,"92",694,447,1141
"13525",1967,"93",500,285,785
"13526",1967,"94",382,231,613
"13527",1967,"95",234,116,350
"13528",1967,"96",179,86,265
"13529",1967,"97",105,49,154
"13530",1967,"98",50,43,93
"13531",1967,"99",42,18,60
"13532",1967,"100",31,12,43
"13533",1967,"101",11,8,19
"13534",1967,"102",10,3,13
"13535",1967,"103",2,4,6
"13536",1967,"104",0,1,1
"13537",1967,"105",1,1,2
"13538",1967,"106",1,0,1
"13539",1967,"107",0,0,0
"13540",1967,"108",0,0,0
"13541",1967,"109",0,0,0
"13542",1967,"110+",0,0,0
"13543",1968,"0",31924,33595,65519
"13544",1968,"1",31772,33862,65634
"13545",1968,"2",31400,33527,64927
"13546",1968,"3",31038,33232,64270
"13547",1968,"4",30446,31625,62071
"13548",1968,"5",29733,31206,60939
"13549",1968,"6",29653,31422,61075
"13550",1968,"7",29533,30945,60478
"13551",1968,"8",29901,31628,61529
"13552",1968,"9",30006,31471,61477
"13553",1968,"10",29999,31389,61388
"13554",1968,"11",30613,31848,62461
"13555",1968,"12",30032,31666,61698
"13556",1968,"13",29832,30976,60808
"13557",1968,"14",29991,31244,61235
"13558",1968,"15",29424,31057,60481
"13559",1968,"16",28361,30224,58585
"13560",1968,"17",29211,30780,59991
"13561",1968,"18",29414,31120,60534
"13562",1968,"19",30194,32333,62527
"13563",1968,"20",31358,33039,64397
"13564",1968,"21",32685,34862,67547
"13565",1968,"22",29468,31360,60828
"13566",1968,"23",28191,30462,58653
"13567",1968,"24",25247,26963,52210
"13568",1968,"25",23395,24638,48033
"13569",1968,"26",20765,21620,42385
"13570",1968,"27",21346,22519,43865
"13571",1968,"28",21052,21736,42788
"13572",1968,"29",20478,21146,41624
"13573",1968,"30",19652,20401,40053
"13574",1968,"31",19024,19753,38777
"13575",1968,"32",18637,18902,37539
"13576",1968,"33",18714,19326,38040
"13577",1968,"34",18640,19586,38226
"13578",1968,"35",20285,20859,41144
"13579",1968,"36",20557,20968,41525
"13580",1968,"37",21090,21990,43080
"13581",1968,"38",20951,21748,42699
"13582",1968,"39",21743,22124,43867
"13583",1968,"40",21750,22419,44169
"13584",1968,"41",23093,23746,46839
"13585",1968,"42",23084,23767,46851
"13586",1968,"43",24218,25110,49328
"13587",1968,"44",25506,26110,51616
"13588",1968,"45",25847,25854,51701
"13589",1968,"46",26416,26284,52700
"13590",1968,"47",28400,28258,56658
"13591",1968,"48",23662,23848,47510
"13592",1968,"49",25304,24905,50209
"13593",1968,"50",25224,25128,50352
"13594",1968,"51",24262,23719,47981
"13595",1968,"52",24009,23479,47488
"13596",1968,"53",23981,23879,47860
"13597",1968,"54",23868,23527,47395
"13598",1968,"55",23974,23485,47459
"13599",1968,"56",23208,22779,45987
"13600",1968,"57",22814,21990,44804
"13601",1968,"58",22909,21798,44707
"13602",1968,"59",21871,20857,42728
"13603",1968,"60",21477,19756,41233
"13604",1968,"61",21058,19188,40246
"13605",1968,"62",20643,18313,38956
"13606",1968,"63",20389,17855,38244
"13607",1968,"64",20132,17764,37896
"13608",1968,"65",19691,17263,36954
"13609",1968,"66",19208,16526,35734
"13610",1968,"67",18730,15719,34449
"13611",1968,"68",17855,14723,32578
"13612",1968,"69",17573,14453,32026
"13613",1968,"70",16622,13499,30121
"13614",1968,"71",15813,12942,28755
"13615",1968,"72",14920,12109,27029
"13616",1968,"73",13704,11039,24743
"13617",1968,"74",13155,10310,23465
"13618",1968,"75",11847,9213,21060
"13619",1968,"76",11048,8520,19568
"13620",1968,"77",10197,7462,17659
"13621",1968,"78",9065,6568,15633
"13622",1968,"79",8314,5948,14262
"13623",1968,"80",7666,5625,13291
"13624",1968,"81",6735,4726,11461
"13625",1968,"82",5981,4105,10086
"13626",1968,"83",5276,3483,8759
"13627",1968,"84",4531,2949,7480
"13628",1968,"85",3703,2534,6237
"13629",1968,"86",2985,1953,4938
"13630",1968,"87",2497,1634,4131
"13631",1968,"88",2104,1496,3600
"13632",1968,"89",1763,1191,2954
"13633",1968,"90",1378,845,2223
"13634",1968,"91",1064,621,1685
"13635",1968,"92",754,490,1244
"13636",1968,"93",529,319,848
"13637",1968,"94",376,195,571
"13638",1968,"95",268,155,423
"13639",1968,"96",151,79,230
"13640",1968,"97",124,61,185
"13641",1968,"98",69,35,104
"13642",1968,"99",29,20,49
"13643",1968,"100",24,12,36
"13644",1968,"101",18,5,23
"13645",1968,"102",8,3,11
"13646",1968,"103",4,2,6
"13647",1968,"104",1,3,4
"13648",1968,"105",0,0,0
"13649",1968,"106",1,0,1
"13650",1968,"107",1,0,1
"13651",1968,"108",0,0,0
"13652",1968,"109",0,0,0
"13653",1968,"110+",0,0,0
"13654",1969,"0",32381,34285,66666
"13655",1969,"1",31932,33585,65517
"13656",1969,"2",31832,33898,65730
"13657",1969,"3",31440,33529,64969
"13658",1969,"4",31039,33248,64287
"13659",1969,"5",30487,31651,62138
"13660",1969,"6",29722,31198,60920
"13661",1969,"7",29673,31444,61117
"13662",1969,"8",29546,30944,60490
"13663",1969,"9",29917,31618,61535
"13664",1969,"10",30026,31464,61490
"13665",1969,"11",30028,31393,61421
"13666",1969,"12",30618,31837,62455
"13667",1969,"13",30039,31656,61695
"13668",1969,"14",29838,30968,60806
"13669",1969,"15",29991,31240,61231
"13670",1969,"16",29424,31049,60473
"13671",1969,"17",28383,30202,58585
"13672",1969,"18",29241,30753,59994
"13673",1969,"19",29389,31163,60552
"13674",1969,"20",30130,32354,62484
"13675",1969,"21",31334,33056,64390
"13676",1969,"22",32618,34789,67407
"13677",1969,"23",29391,31336,60727
"13678",1969,"24",28110,30427,58537
"13679",1969,"25",25222,26898,52120
"13680",1969,"26",23362,24632,47994
"13681",1969,"27",20743,21571,42314
"13682",1969,"28",21368,22482,43850
"13683",1969,"29",21082,21720,42802
"13684",1969,"30",20503,21124,41627
"13685",1969,"31",19653,20371,40024
"13686",1969,"32",19043,19731,38774
"13687",1969,"33",18657,18906,37563
"13688",1969,"34",18700,19309,38009
"13689",1969,"35",18628,19554,38182
"13690",1969,"36",20278,20828,41106
"13691",1969,"37",20560,20914,41474
"13692",1969,"38",21094,21956,43050
"13693",1969,"39",20932,21721,42653
"13694",1969,"40",21732,22069,43801
"13695",1969,"41",21735,22363,44098
"13696",1969,"42",23075,23691,46766
"13697",1969,"43",23049,23693,46742
"13698",1969,"44",24171,25028,49199
"13699",1969,"45",25430,26006,51436
"13700",1969,"46",25837,25766,51603
"13701",1969,"47",26374,26167,52541
"13702",1969,"48",28334,28114,56448
"13703",1969,"49",23607,23728,47335
"13704",1969,"50",25238,24776,50014
"13705",1969,"51",25160,24965,50125
"13706",1969,"52",24168,23552,47720
"13707",1969,"53",23904,23300,47204
"13708",1969,"54",23906,23688,47594
"13709",1969,"55",23772,23332,47104
"13710",1969,"56",23848,23249,47097
"13711",1969,"57",23074,22530,45604
"13712",1969,"58",22700,21702,44402
"13713",1969,"59",22751,21536,44287
"13714",1969,"60",21713,20549,42262
"13715",1969,"61",21305,19441,40746
"13716",1969,"62",20894,18823,39717
"13717",1969,"63",20454,17941,38395
"13718",1969,"64",20160,17457,37617
"13719",1969,"65",19881,17341,37222
"13720",1969,"66",19432,16788,36220
"13721",1969,"67",18911,16059,34970
"13722",1969,"68",18397,15238,33635
"13723",1969,"69",17501,14191,31692
"13724",1969,"70",17142,13875,31017
"13725",1969,"71",16157,12908,29065
"13726",1969,"72",15358,12332,27690
"13727",1969,"73",14429,11484,25913
"13728",1969,"74",13226,10422,23648
"13729",1969,"75",12607,9734,22341
"13730",1969,"76",11246,8609,19855
"13731",1969,"77",10473,7862,18335
"13732",1969,"78",9554,6877,16431
"13733",1969,"79",8444,6003,14447
"13734",1969,"80",7688,5385,13073
"13735",1969,"81",7030,5015,12045
"13736",1969,"82",6087,4211,10298
"13737",1969,"83",5343,3551,8894
"13738",1969,"84",4672,3021,7693
"13739",1969,"85",3965,2535,6500
"13740",1969,"86",3189,2123,5312
"13741",1969,"87",2518,1630,4148
"13742",1969,"88",2077,1339,3416
"13743",1969,"89",1740,1192,2932
"13744",1969,"90",1413,917,2330
"13745",1969,"91",1078,647,1725
"13746",1969,"92",839,453,1292
"13747",1969,"93",563,364,927
"13748",1969,"94",384,241,625
"13749",1969,"95",275,129,404
"13750",1969,"96",189,111,300
"13751",1969,"97",101,52,153
"13752",1969,"98",90,40,130
"13753",1969,"99",41,20,61
"13754",1969,"100",16,15,31
"13755",1969,"101",15,6,21
"13756",1969,"102",4,2,6
"13757",1969,"103",6,2,8
"13758",1969,"104",2,0,2
"13759",1969,"105",1,2,3
"13760",1969,"106",0,0,0
"13761",1969,"107",0,0,0
"13762",1969,"108",0,0,0
"13763",1969,"109",0,0,0
"13764",1969,"110+",0,0,0
"13765",1970,"0",32669,34461,67130
"13766",1970,"1",32404,34252,66656
"13767",1970,"2",31979,33599,65578
"13768",1970,"3",31840,33868,65708
"13769",1970,"4",31440,33549,64989
"13770",1970,"5",31061,33247,64308
"13771",1970,"6",30490,31680,62170
"13772",1970,"7",29734,31204,60938
"13773",1970,"8",29660,31438,61098
"13774",1970,"9",29576,30947,60523
"13775",1970,"10",29933,31620,61553
"13776",1970,"11",30039,31479,61518
"13777",1970,"12",30040,31392,61432
"13778",1970,"13",30623,31844,62467
"13779",1970,"14",30047,31643,61690
"13780",1970,"15",29831,30966,60797
"13781",1970,"16",29977,31212,61189
"13782",1970,"17",29446,31025,60471
"13783",1970,"18",28383,30185,58568
"13784",1970,"19",29145,30756,59901
"13785",1970,"20",29342,31197,60539
"13786",1970,"21",30094,32346,62440
"13787",1970,"22",31238,33067,64305
"13788",1970,"23",32542,34775,67317
"13789",1970,"24",29350,31292,60642
"13790",1970,"25",28126,30424,58550
"13791",1970,"26",25228,26904,52132
"13792",1970,"27",23369,24621,47990
"13793",1970,"28",20725,21576,42301
"13794",1970,"29",21368,22491,43859
"13795",1970,"30",21074,21722,42796
"13796",1970,"31",20509,21107,41616
"13797",1970,"32",19675,20382,40057
"13798",1970,"33",19057,19736,38793
"13799",1970,"34",18669,18895,37564
"13800",1970,"35",18700,19294,37994
"13801",1970,"36",18621,19529,38150
"13802",1970,"37",20279,20801,41080
"13803",1970,"38",20557,20911,41468
"13804",1970,"39",21100,21915,43015
"13805",1970,"40",20913,21670,42583
"13806",1970,"41",21710,22029,43739
"13807",1970,"42",21721,22319,44040
"13808",1970,"43",23057,23646,46703
"13809",1970,"44",23022,23603,46625
"13810",1970,"45",24119,24947,49066
"13811",1970,"46",25383,25914,51297
"13812",1970,"47",25779,25653,51432
"13813",1970,"48",26334,26052,52386
"13814",1970,"49",28253,27977,56230
"13815",1970,"50",23523,23607,47130
"13816",1970,"51",25141,24646,49787
"13817",1970,"52",25075,24788,49863
"13818",1970,"53",24086,23387,47473
"13819",1970,"54",23818,23102,46920
"13820",1970,"55",23775,23457,47232
"13821",1970,"56",23683,23093,46776
"13822",1970,"57",23728,22980,46708
"13823",1970,"58",22921,22213,45134
"13824",1970,"59",22548,21392,43940
"13825",1970,"60",22586,21219,43805
"13826",1970,"61",21521,20225,41746
"13827",1970,"62",21117,19072,40189
"13828",1970,"63",20702,18441,39143
"13829",1970,"64",20224,17481,37705
"13830",1970,"65",19928,17032,36960
"13831",1970,"66",19589,16887,36476
"13832",1970,"67",19134,16259,35393
"13833",1970,"68",18574,15498,34072
"13834",1970,"69",18021,14642,32663
"13835",1970,"70",17108,13630,30738
"13836",1970,"71",16724,13271,29995
"13837",1970,"72",15671,12268,27939
"13838",1970,"73",14881,11666,26547
"13839",1970,"74",13886,10773,24659
"13840",1970,"75",12648,9748,22396
"13841",1970,"76",11999,9051,21050
"13842",1970,"77",10596,7963,18559
"13843",1970,"78",9861,7280,17141
"13844",1970,"79",8913,6259,15172
"13845",1970,"80",7819,5492,13311
"13846",1970,"81",7022,4817,11839
"13847",1970,"82",6403,4461,10864
"13848",1970,"83",5492,3678,9170
"13849",1970,"84",4718,3047,7765
"13850",1970,"85",4083,2542,6625
"13851",1970,"86",3451,2143,5594
"13852",1970,"87",2733,1731,4464
"13853",1970,"88",2113,1299,3412
"13854",1970,"89",1731,1046,2777
"13855",1970,"90",1401,957,2358
"13856",1970,"91",1109,696,1805
"13857",1970,"92",838,484,1322
"13858",1970,"93",651,332,983
"13859",1970,"94",416,258,674
"13860",1970,"95",279,160,439
"13861",1970,"96",185,93,278
"13862",1970,"97",132,77,209
"13863",1970,"98",63,29,92
"13864",1970,"99",65,30,95
"13865",1970,"100",24,13,37
"13866",1970,"101",10,4,14
"13867",1970,"102",8,2,10
"13868",1970,"103",3,1,4
"13869",1970,"104",2,1,3
"13870",1970,"105",1,0,1
"13871",1970,"106",0,0,0
"13872",1970,"107",0,0,0
"13873",1970,"108",0,0,0
"13874",1970,"109",0,0,0
"13875",1970,"110+",0,0,0
"13876",1971,"0",31115,32987,64102
"13877",1971,"1",32663,34435,67098
"13878",1971,"2",32440,34240,66680
"13879",1971,"3",31980,33584,65564
"13880",1971,"4",31846,33859,65705
"13881",1971,"5",31446,33527,64973
"13882",1971,"6",31073,33253,64326
"13883",1971,"7",30505,31676,62181
"13884",1971,"8",29722,31216,60938
"13885",1971,"9",29682,31435,61117
"13886",1971,"10",29589,30925,60514
"13887",1971,"11",29948,31634,61582
"13888",1971,"12",30032,31472,61504
"13889",1971,"13",30047,31393,61440
"13890",1971,"14",30635,31853,62488
"13891",1971,"15",30043,31635,61678
"13892",1971,"16",29811,30952,60763
"13893",1971,"17",30014,31210,61224
"13894",1971,"18",29413,30979,60392
"13895",1971,"19",28244,30136,58380
"13896",1971,"20",28992,30785,59777
"13897",1971,"21",29222,31155,60377
"13898",1971,"22",29946,32278,62224
"13899",1971,"23",31113,32974,64087
"13900",1971,"24",32407,34662,67069
"13901",1971,"25",29253,31166,60419
"13902",1971,"26",28026,30329,58355
"13903",1971,"27",25128,26772,51900
"13904",1971,"28",23319,24520,47839
"13905",1971,"29",20674,21523,42197
"13906",1971,"30",21391,22437,43828
"13907",1971,"31",21049,21630,42679
"13908",1971,"32",20497,21035,41532
"13909",1971,"33",19644,20279,39923
"13910",1971,"34",19032,19689,38721
"13911",1971,"35",18651,18822,37473
"13912",1971,"36",18681,19263,37944
"13913",1971,"37",18610,19512,38122
"13914",1971,"38",20246,20748,40994
"13915",1971,"39",20552,20853,41405
"13916",1971,"40",21072,21859,42931
"13917",1971,"41",20888,21614,42502
"13918",1971,"42",21669,21974,43643
"13919",1971,"43",21693,22240,43933
"13920",1971,"44",23028,23550,46578
"13921",1971,"45",22980,23494,46474
"13922",1971,"46",24066,24837,48903
"13923",1971,"47",25324,25777,51101
"13924",1971,"48",25715,25532,51247
"13925",1971,"49",26250,25905,52155
"13926",1971,"50",28175,27799,55974
"13927",1971,"51",23452,23446,46898
"13928",1971,"52",25064,24455,49519
"13929",1971,"53",24979,24588,49567
"13930",1971,"54",23980,23198,47178
"13931",1971,"55",23715,22869,46584
"13932",1971,"56",23685,23198,46883
"13933",1971,"57",23551,22829,46380
"13934",1971,"58",23573,22669,46242
"13935",1971,"59",22773,21911,44684
"13936",1971,"60",22407,21081,43488
"13937",1971,"61",22417,20847,43264
"13938",1971,"62",21359,19852,41211
"13939",1971,"63",20942,18670,39612
"13940",1971,"64",20473,18045,38518
"13941",1971,"65",19975,17057,37032
"13942",1971,"66",19656,16566,36222
"13943",1971,"67",19272,16374,35646
"13944",1971,"68",18824,15749,34573
"13945",1971,"69",18214,14926,33140
"13946",1971,"70",17633,14039,31672
"13947",1971,"71",16718,13040,29758
"13948",1971,"72",16258,12625,28883
"13949",1971,"73",15177,11647,26824
"13950",1971,"74",14327,10967,25294
"13951",1971,"75",13329,10091,23420
"13952",1971,"76",12050,9095,21145
"13953",1971,"77",11411,8380,19791
"13954",1971,"78",9995,7313,17308
"13955",1971,"79",9252,6639,15891
"13956",1971,"80",8281,5620,13901
"13957",1971,"81",7160,4909,12069
"13958",1971,"82",6359,4287,10646
"13959",1971,"83",5724,3918,9642
"13960",1971,"84",4882,3182,8064
"13961",1971,"85",4112,2595,6707
"13962",1971,"86",3543,2153,5696
"13963",1971,"87",2954,1759,4713
"13964",1971,"88",2263,1377,3640
"13965",1971,"89",1739,1049,2788
"13966",1971,"90",1383,829,2212
"13967",1971,"91",1124,732,1856
"13968",1971,"92",840,523,1363
"13969",1971,"93",652,339,991
"13970",1971,"94",476,232,708
"13971",1971,"95",311,170,481
"13972",1971,"96",200,109,309
"13973",1971,"97",127,51,178
"13974",1971,"98",99,51,150
"13975",1971,"99",38,17,55
"13976",1971,"100",40,20,60
"13977",1971,"101",11,4,15
"13978",1971,"102",7,3,10
"13979",1971,"103",6,1,7
"13980",1971,"104",1,1,2
"13981",1971,"105",0,1,1
"13982",1971,"106",1,0,1
"13983",1971,"107",0,0,0
"13984",1971,"108",0,0,0
"13985",1971,"109",0,0,0
"13986",1971,"110+",0,0,0
"13987",1972,"0",31695,33193,64888
"13988",1972,"1",31181,32980,64161
"13989",1972,"2",32748,34447,67195
"13990",1972,"3",32460,34283,66743
"13991",1972,"4",32014,33607,65621
"13992",1972,"5",31907,33902,65809
"13993",1972,"6",31482,33563,65045
"13994",1972,"7",31136,33282,64418
"13995",1972,"8",30520,31692,62212
"13996",1972,"9",29729,31209,60938
"13997",1972,"10",29680,31450,61130
"13998",1972,"11",29596,30919,60515
"13999",1972,"12",29951,31640,61591
"14000",1972,"13",30033,31445,61478
"14001",1972,"14",30049,31418,61467
"14002",1972,"15",30637,31872,62509
"14003",1972,"16",30054,31637,61691
"14004",1972,"17",29865,30959,60824
"14005",1972,"18",30005,31219,61224
"14006",1972,"19",29388,31041,60429
"14007",1972,"20",28222,30211,58433
"14008",1972,"21",28987,30889,59876
"14009",1972,"22",29196,31235,60431
"14010",1972,"23",29956,32398,62354
"14011",1972,"24",31074,33079,64153
"14012",1972,"25",32406,34741,67147
"14013",1972,"26",29229,31281,60510
"14014",1972,"27",27992,30362,58354
"14015",1972,"28",25086,26825,51911
"14016",1972,"29",23291,24582,47873
"14017",1972,"30",20635,21549,42184
"14018",1972,"31",21335,22433,43768
"14019",1972,"32",21015,21639,42654
"14020",1972,"33",20471,21050,41521
"14021",1972,"34",19630,20273,39903
"14022",1972,"35",19018,19690,38708
"14023",1972,"36",18625,18796,37421
"14024",1972,"37",18664,19253,37917
"14025",1972,"38",18597,19470,38067
"14026",1972,"39",20217,20762,40979
"14027",1972,"40",20530,20827,41357
"14028",1972,"41",21057,21820,42877
"14029",1972,"42",20862,21589,42451
"14030",1972,"43",21655,21930,43585
"14031",1972,"44",21665,22172,43837
"14032",1972,"45",22974,23466,46440
"14033",1972,"46",22959,23427,46386
"14034",1972,"47",24041,24746,48787
"14035",1972,"48",25254,25674,50928
"14036",1972,"49",25629,25403,51032
"14037",1972,"50",26176,25762,51938
"14038",1972,"51",28123,27624,55747
"14039",1972,"52",23362,23276,46638
"14040",1972,"53",24987,24278,49265
"14041",1972,"54",24884,24384,49268
"14042",1972,"55",23866,22998,46864
"14043",1972,"56",23600,22640,46240
"14044",1972,"57",23587,22938,46525
"14045",1972,"58",23405,22569,45974
"14046",1972,"59",23426,22342,45768
"14047",1972,"60",22630,21561,44191
"14048",1972,"61",22245,20740,42985
"14049",1972,"62",22245,20455,42700
"14050",1972,"63",21162,19437,40599
"14051",1972,"64",20733,18263,38996
"14052",1972,"65",20259,17630,37889
"14053",1972,"66",19709,16610,36319
"14054",1972,"67",19374,16095,35469
"14055",1972,"68",18955,15842,34797
"14056",1972,"69",18473,15245,33718
"14057",1972,"70",17827,14329,32156
"14058",1972,"71",17230,13386,30616
"14059",1972,"72",16208,12402,28610
"14060",1972,"73",15742,11999,27741
"14061",1972,"74",14576,10960,25536
"14062",1972,"75",13737,10311,24048
"14063",1972,"76",12750,9383,22133
"14064",1972,"77",11439,8419,19858
"14065",1972,"78",10752,7703,18455
"14066",1972,"79",9342,6606,15948
"14067",1972,"80",8582,5980,14562
"14068",1972,"81",7621,5002,12623
"14069",1972,"82",6539,4395,10934
"14070",1972,"83",5679,3712,9391
"14071",1972,"84",5105,3393,8498
"14072",1972,"85",4328,2735,7063
"14073",1972,"86",3545,2185,5730
"14074",1972,"87",3017,1804,4821
"14075",1972,"88",2425,1406,3831
"14076",1972,"89",1849,1085,2934
"14077",1972,"90",1388,812,2200
"14078",1972,"91",1092,627,1719
"14079",1972,"92",880,548,1428
"14080",1972,"93",654,378,1032
"14081",1972,"94",476,255,731
"14082",1972,"95",327,160,487
"14083",1972,"96",212,127,339
"14084",1972,"97",133,74,207
"14085",1972,"98",75,31,106
"14086",1972,"99",65,40,105
"14087",1972,"100",22,6,28
"14088",1972,"101",21,14,35
"14089",1972,"102",8,3,11
"14090",1972,"103",2,2,4
"14091",1972,"104",3,0,3
"14092",1972,"105",1,1,2
"14093",1972,"106",0,0,0
"14094",1972,"107",1,0,1
"14095",1972,"108",0,0,0
"14096",1972,"109",0,0,0
"14097",1972,"110+",0,0,0
"14098",1973,"0",31033,32640,63673
"14099",1973,"1",31772,33241,65013
"14100",1973,"2",31197,32970,64167
"14101",1973,"3",32798,34509,67307
"14102",1973,"4",32477,34323,66800
"14103",1973,"5",32063,33649,65712
"14104",1973,"6",32026,34014,66040
"14105",1973,"7",31569,33611,65180
"14106",1973,"8",31262,33382,64644
"14107",1973,"9",30586,31744,62330
"14108",1973,"10",29777,31256,61033
"14109",1973,"11",29735,31467,61202
"14110",1973,"12",29627,30964,60591
"14111",1973,"13",29973,31658,61631
"14112",1973,"14",30054,31462,61516
"14113",1973,"15",30068,31423,61491
"14114",1973,"16",30638,31885,62523
"14115",1973,"17",30103,31658,61761
"14116",1973,"18",29919,30964,60883
"14117",1973,"19",29963,31197,61160
"14118",1973,"20",29412,31101,60513
"14119",1973,"21",28195,30242,58437
"14120",1973,"22",29036,30941,59977
"14121",1973,"23",29212,31247,60459
"14122",1973,"24",29952,32434,62386
"14123",1973,"25",31122,33155,64277
"14124",1973,"26",32428,34761,67189
"14125",1973,"27",29241,31280,60521
"14126",1973,"28",28013,30416,58429
"14127",1973,"29",25128,26858,51986
"14128",1973,"30",23348,24655,48003
"14129",1973,"31",20690,21582,42272
"14130",1973,"32",21379,22474,43853
"14131",1973,"33",21073,21666,42739
"14132",1973,"34",20509,21055,41564
"14133",1973,"35",19661,20269,39930
"14134",1973,"36",19032,19714,38746
"14135",1973,"37",18636,18819,37455
"14136",1973,"38",18680,19259,37939
"14137",1973,"39",18603,19451,38054
"14138",1973,"40",20206,20754,40960
"14139",1973,"41",20536,20814,41350
"14140",1973,"42",21029,21796,42825
"14141",1973,"43",20875,21548,42423
"14142",1973,"44",21642,21892,43534
"14143",1973,"45",21635,22103,43738
"14144",1973,"46",22949,23399,46348
"14145",1973,"47",22945,23344,46289
"14146",1973,"48",24009,24664,48673
"14147",1973,"49",25190,25553,50743
"14148",1973,"50",25573,25305,50878
"14149",1973,"51",26123,25629,51752
"14150",1973,"52",28035,27451,55486
"14151",1973,"53",23295,23148,46443
"14152",1973,"54",24898,24067,48965
"14153",1973,"55",24777,24130,48907
"14154",1973,"56",23776,22798,46574
"14155",1973,"57",23474,22406,45880
"14156",1973,"58",23476,22642,46118
"14157",1973,"59",23249,22280,45529
"14158",1973,"60",23276,22007,45283
"14159",1973,"61",22468,21225,43693
"14160",1973,"62",22073,20365,42438
"14161",1973,"63",22077,20115,42192
"14162",1973,"64",20967,18990,39957
"14163",1973,"65",20507,17839,38346
"14164",1973,"66",19991,17162,37153
"14165",1973,"67",19400,16139,35539
"14166",1973,"68",19061,15594,34655
"14167",1973,"69",18626,15267,33893
"14168",1973,"70",18111,14628,32739
"14169",1973,"71",17408,13690,31098
"14170",1973,"72",16766,12735,29501
"14171",1973,"73",15682,11824,27506
"14172",1973,"74",15208,11323,26531
"14173",1973,"75",13988,10299,24287
"14174",1973,"76",13114,9634,22748
"14175",1973,"77",12121,8712,20833
"14176",1973,"78",10860,7743,18603
"14177",1973,"79",10093,7045,17138
"14178",1973,"80",8689,5966,14655
"14179",1973,"81",7880,5368,13248
"14180",1973,"82",6977,4422,11399
"14181",1973,"83",5899,3824,9723
"14182",1973,"84",5028,3228,8256
"14183",1973,"85",4446,2863,7309
"14184",1973,"86",3748,2303,6051
"14185",1973,"87",3010,1833,4843
"14186",1973,"88",2509,1493,4002
"14187",1973,"89",1950,1119,3069
"14188",1973,"90",1495,852,2347
"14189",1973,"91",1106,611,1717
"14190",1973,"92",858,453,1311
"14191",1973,"93",679,393,1072
"14192",1973,"94",480,275,755
"14193",1973,"95",348,171,519
"14194",1973,"96",231,111,342
"14195",1973,"97",148,91,239
"14196",1973,"98",85,45,130
"14197",1973,"99",48,14,62
"14198",1973,"100",41,25,66
"14199",1973,"101",15,3,18
"14200",1973,"102",15,7,22
"14201",1973,"103",7,2,9
"14202",1973,"104",2,1,3
"14203",1973,"105",3,0,3
"14204",1973,"106",1,0,1
"14205",1973,"107",0,0,0
"14206",1973,"108",0,0,0
"14207",1973,"109",0,0,0
"14208",1973,"110+",0,0,0
"14209",1974,"0",29452,31215,60667
"14210",1974,"1",31114,32667,63781
"14211",1974,"2",31846,33254,65100
"14212",1974,"3",31267,33038,64305
"14213",1974,"4",32827,34496,67323
"14214",1974,"5",32507,34343,66850
"14215",1974,"6",32102,33677,65779
"14216",1974,"7",32038,34041,66079
"14217",1974,"8",31631,33632,65263
"14218",1974,"9",31284,33391,64675
"14219",1974,"10",30606,31780,62386
"14220",1974,"11",29787,31278,61065
"14221",1974,"12",29761,31473,61234
"14222",1974,"13",29656,30981,60637
"14223",1974,"14",29977,31673,61650
"14224",1974,"15",30085,31472,61557
"14225",1974,"16",30072,31421,61493
"14226",1974,"17",30697,31863,62560
"14227",1974,"18",30070,31633,61703
"14228",1974,"19",29893,30965,60858
"14229",1974,"20",29928,31218,61146
"14230",1974,"21",29355,31073,60428
"14231",1974,"22",28167,30276,58443
"14232",1974,"23",28999,30939,59938
"14233",1974,"24",29245,31298,60543
"14234",1974,"25",29970,32450,62420
"14235",1974,"26",31157,33162,64319
"14236",1974,"27",32444,34736,67180
"14237",1974,"28",29280,31237,60517
"14238",1974,"29",28058,30400,58458
"14239",1974,"30",25160,26841,52001
"14240",1974,"31",23376,24614,47990
"14241",1974,"32",20726,21589,42315
"14242",1974,"33",21402,22518,43920
"14243",1974,"34",21095,21714,42809
"14244",1974,"35",20541,21086,41627
"14245",1974,"36",19666,20235,39901
"14246",1974,"37",19031,19718,38749
"14247",1974,"38",18620,18800,37420
"14248",1974,"39",18665,19241,37906
"14249",1974,"40",18627,19433,38060
"14250",1974,"41",20213,20732,40945
"14251",1974,"42",20492,20755,41247
"14252",1974,"43",21017,21763,42780
"14253",1974,"44",20858,21495,42353
"14254",1974,"45",21603,21857,43460
"14255",1974,"46",21607,22031,43638
"14256",1974,"47",22933,23297,46230
"14257",1974,"48",22899,23264,46163
"14258",1974,"49",23964,24562,48526
"14259",1974,"50",25129,25428,50557
"14260",1974,"51",25479,25177,50656
"14261",1974,"52",26035,25445,51480
"14262",1974,"53",27944,27232,55176
"14263",1974,"54",23204,22964,46168
"14264",1974,"55",24804,23861,48665
"14265",1974,"56",24679,23882,48561
"14266",1974,"57",23670,22510,46180
"14267",1974,"58",23353,22149,45502
"14268",1974,"59",23310,22346,45656
"14269",1974,"60",23107,21935,45042
"14270",1974,"61",23119,21665,44784
"14271",1974,"62",22273,20862,43135
"14272",1974,"63",21883,19981,41864
"14273",1974,"64",21848,19686,41534
"14274",1974,"65",20727,18502,39229
"14275",1974,"66",20263,17387,37650
"14276",1974,"67",19745,16681,36426
"14277",1974,"68",19109,15607,34716
"14278",1974,"69",18747,15034,33781
"14279",1974,"70",18262,14662,32924
"14280",1974,"71",17677,13970,31647
"14281",1974,"72",16975,13018,29993
"14282",1974,"73",16264,12065,28329
"14283",1974,"74",15169,11153,26322
"14284",1974,"75",14577,10640,25217
"14285",1974,"76",13368,9574,22942
"14286",1974,"77",12447,8933,21380
"14287",1974,"78",11435,8000,19435
"14288",1974,"79",10154,7070,17224
"14289",1974,"80",9385,6325,15710
"14290",1974,"81",7992,5340,13332
"14291",1974,"82",7162,4738,11900
"14292",1974,"83",6342,3861,10203
"14293",1974,"84",5277,3357,8634
"14294",1974,"85",4361,2708,7069
"14295",1974,"86",3820,2419,6239
"14296",1974,"87",3204,1909,5113
"14297",1974,"88",2542,1487,4029
"14298",1974,"89",2078,1186,3264
"14299",1974,"90",1566,871,2437
"14300",1974,"91",1179,646,1825
"14301",1974,"92",866,456,1322
"14302",1974,"93",644,332,976
"14303",1974,"94",493,275,768
"14304",1974,"95",338,195,533
"14305",1974,"96",238,124,362
"14306",1974,"97",142,78,220
"14307",1974,"98",105,58,163
"14308",1974,"99",52,30,82
"14309",1974,"100",32,9,41
"14310",1974,"101",24,17,41
"14311",1974,"102",12,2,14
"14312",1974,"103",7,2,9
"14313",1974,"104",3,0,3
"14314",1974,"105",1,1,2
"14315",1974,"106",1,0,1
"14316",1974,"107",1,0,1
"14317",1974,"108",0,0,0
"14318",1974,"109",0,0,0
"14319",1974,"110+",0,0,0
"14320",1975,"0",29083,30093,59176
"14321",1975,"1",29606,31305,60911
"14322",1975,"2",31167,32695,63862
"14323",1975,"3",31923,33287,65210
"14324",1975,"4",31336,33063,64399
"14325",1975,"5",32868,34521,67389
"14326",1975,"6",32541,34389,66930
"14327",1975,"7",32152,33713,65865
"14328",1975,"8",32065,34059,66124
"14329",1975,"9",31657,33657,65314
"14330",1975,"10",31306,33402,64708
"14331",1975,"11",30618,31823,62441
"14332",1975,"12",29816,31291,61107
"14333",1975,"13",29760,31500,61260
"14334",1975,"14",29645,30998,60643
"14335",1975,"15",29989,31680,61669
"14336",1975,"16",30066,31482,61548
"14337",1975,"17",30113,31441,61554
"14338",1975,"18",30689,31875,62564
"14339",1975,"19",30068,31659,61727
"14340",1975,"20",29860,31062,60922
"14341",1975,"21",29920,31263,61183
"14342",1975,"22",29361,31132,60493
"14343",1975,"23",28234,30375,58609
"14344",1975,"24",28974,30997,59971
"14345",1975,"25",29287,31392,60679
"14346",1975,"26",30003,32475,62478
"14347",1975,"27",31219,33235,64454
"14348",1975,"28",32467,34757,67224
"14349",1975,"29",29268,31308,60576
"14350",1975,"30",28076,30429,58505
"14351",1975,"31",25170,26883,52053
"14352",1975,"32",23370,24660,48030
"14353",1975,"33",20744,21619,42363
"14354",1975,"34",21409,22542,43951
"14355",1975,"35",21095,21704,42799
"14356",1975,"36",20549,21095,41644
"14357",1975,"37",19674,20226,39900
"14358",1975,"38",19041,19709,38750
"14359",1975,"39",18618,18809,37427
"14360",1975,"40",18663,19220,37883
"14361",1975,"41",18595,19423,38018
"14362",1975,"42",20198,20692,40890
"14363",1975,"43",20491,20731,41222
"14364",1975,"44",20998,21701,42699
"14365",1975,"45",20839,21441,42280
"14366",1975,"46",21570,21787,43357
"14367",1975,"47",21566,21946,43512
"14368",1975,"48",22905,23199,46104
"14369",1975,"49",22821,23128,45949
"14370",1975,"50",23896,24431,48327
"14371",1975,"51",25070,25284,50354
"14372",1975,"52",25409,25014,50423
"14373",1975,"53",25941,25241,51182
"14374",1975,"54",27834,27030,54864
"14375",1975,"55",23100,22757,45857
"14376",1975,"56",24709,23606,48315
"14377",1975,"57",24579,23610,48189
"14378",1975,"58",23542,22233,45775
"14379",1975,"59",23195,21869,45064
"14380",1975,"60",23148,22035,45183
"14381",1975,"61",22927,21605,44532
"14382",1975,"62",22906,21246,44152
"14383",1975,"63",22085,20462,42547
"14384",1975,"64",21657,19536,41193
"14385",1975,"65",21601,19207,40808
"14386",1975,"66",20442,18024,38466
"14387",1975,"67",19991,16925,36916
"14388",1975,"68",19461,16159,35620
"14389",1975,"69",18776,15072,33848
"14390",1975,"70",18409,14484,32893
"14391",1975,"71",17828,14050,31878
"14392",1975,"72",17240,13332,30572
"14393",1975,"73",16453,12379,28832
"14394",1975,"74",15720,11368,27088
"14395",1975,"75",14559,10445,25004
"14396",1975,"76",13957,9958,23915
"14397",1975,"77",12723,8909,21632
"14398",1975,"78",11800,8219,20019
"14399",1975,"79",10740,7341,18081
"14400",1975,"80",9495,6396,15891
"14401",1975,"81",8660,5699,14359
"14402",1975,"82",7320,4771,12091
"14403",1975,"83",6493,4152,10645
"14404",1975,"84",5655,3310,8965
"14405",1975,"85",4655,2875,7530
"14406",1975,"86",3761,2302,6063
"14407",1975,"87",3307,1996,5303
"14408",1975,"88",2687,1588,4275
"14409",1975,"89",2098,1177,3275
"14410",1975,"90",1696,958,2654
"14411",1975,"91",1243,668,1911
"14412",1975,"92",905,483,1388
"14413",1975,"93",653,340,993
"14414",1975,"94",475,236,711
"14415",1975,"95",338,185,523
"14416",1975,"96",242,122,364
"14417",1975,"97",177,81,258
"14418",1975,"98",99,52,151
"14419",1975,"99",72,42,114
"14420",1975,"100",34,17,51
"14421",1975,"101",21,4,25
"14422",1975,"102",11,10,21
"14423",1975,"103",5,2,7
"14424",1975,"104",3,1,4
"14425",1975,"105",0,0,0
"14426",1975,"106",0,1,1
"14427",1975,"107",0,0,0
"14428",1975,"108",0,0,0
"14429",1975,"109",0,0,0
"14430",1975,"110+",0,0,0
"14431",1976,"0",27287,28534,55821
"14432",1976,"1",29231,30149,59380
"14433",1976,"2",29696,31349,61045
"14434",1976,"3",31219,32749,63968
"14435",1976,"4",31968,33292,65260
"14436",1976,"5",31381,33095,64476
"14437",1976,"6",32919,34578,67497
"14438",1976,"7",32583,34422,67005
"14439",1976,"8",32206,33742,65948
"14440",1976,"9",32094,34104,66198
"14441",1976,"10",31667,33685,65352
"14442",1976,"11",31310,33439,64749
"14443",1976,"12",30641,31843,62484
"14444",1976,"13",29816,31324,61140
"14445",1976,"14",29778,31524,61302
"14446",1976,"15",29629,31010,60639
"14447",1976,"16",29995,31710,61705
"14448",1976,"17",30118,31495,61613
"14449",1976,"18",30152,31414,61566
"14450",1976,"19",30708,31877,62585
"14451",1976,"20",30039,31652,61691
"14452",1976,"21",29832,31017,60849
"14453",1976,"22",29923,31266,61189
"14454",1976,"23",29379,31193,60572
"14455",1976,"24",28282,30418,58700
"14456",1976,"25",29039,31073,60112
"14457",1976,"26",29301,31438,60739
"14458",1976,"27",29967,32509,62476
"14459",1976,"28",31225,33232,64457
"14460",1976,"29",32519,34771,67290
"14461",1976,"30",29292,31320,60612
"14462",1976,"31",28116,30413,58529
"14463",1976,"32",25178,26837,52015
"14464",1976,"33",23414,24649,48063
"14465",1976,"34",20760,21609,42369
"14466",1976,"35",21416,22529,43945
"14467",1976,"36",21146,21692,42838
"14468",1976,"37",20548,21110,41658
"14469",1976,"38",19699,20234,39933
"14470",1976,"39",19029,19675,38704
"14471",1976,"40",18621,18769,37390
"14472",1976,"41",18657,19194,37851
"14473",1976,"42",18575,19383,37958
"14474",1976,"43",20173,20625,40798
"14475",1976,"44",20472,20671,41143
"14476",1976,"45",20931,21604,42535
"14477",1976,"46",20784,21356,42140
"14478",1976,"47",21513,21701,43214
"14479",1976,"48",21527,21859,43386
"14480",1976,"49",22843,23079,45922
"14481",1976,"50",22764,23007,45771
"14482",1976,"51",23829,24245,48074
"14483",1976,"52",24992,25106,50098
"14484",1976,"53",25314,24827,50141
"14485",1976,"54",25823,25009,50832
"14486",1976,"55",27708,26768,54476
"14487",1976,"56",22988,22516,45504
"14488",1976,"57",24580,23334,47914
"14489",1976,"58",24469,23324,47793
"14490",1976,"59",23407,21931,45338
"14491",1976,"60",23061,21546,44607
"14492",1976,"61",22994,21649,44643
"14493",1976,"62",22724,21226,43950
"14494",1976,"63",22678,20816,43494
"14495",1976,"64",21872,20034,41906
"14496",1976,"65",21396,19062,40458
"14497",1976,"66",21337,18700,40037
"14498",1976,"67",20181,17507,37688
"14499",1976,"68",19687,16390,36077
"14500",1976,"69",19097,15603,34700
"14501",1976,"70",18432,14476,32908
"14502",1976,"71",18033,13878,31911
"14503",1976,"72",17392,13377,30769
"14504",1976,"73",16743,12659,29402
"14505",1976,"74",15925,11684,27609
"14506",1976,"75",15161,10658,25819
"14507",1976,"76",13906,9749,23655
"14508",1976,"77",13301,9235,22536
"14509",1976,"78",12036,8221,20257
"14510",1976,"79",11074,7493,18567
"14511",1976,"80",10047,6657,16704
"14512",1976,"81",8736,5694,14430
"14513",1976,"82",7948,5045,12993
"14514",1976,"83",6627,4218,10845
"14515",1976,"84",5828,3571,9399
"14516",1976,"85",4976,2824,7800
"14517",1976,"86",4051,2444,6495
"14518",1976,"87",3243,1927,5170
"14519",1976,"88",2799,1644,4443
"14520",1976,"89",2208,1268,3476
"14521",1976,"90",1707,933,2640
"14522",1976,"91",1356,738,2094
"14523",1976,"92",973,504,1477
"14524",1976,"93",688,363,1051
"14525",1976,"94",480,247,727
"14526",1976,"95",349,164,513
"14527",1976,"96",243,133,376
"14528",1976,"97",164,77,241
"14529",1976,"98",116,49,165
"14530",1976,"99",68,35,103
"14531",1976,"100",46,23,69
"14532",1976,"101",21,11,32
"14533",1976,"102",12,4,16
"14534",1976,"103",6,8,14
"14535",1976,"104",2,2,4
"14536",1976,"105",1,1,2
"14537",1976,"106",0,0,0
"14538",1976,"107",0,0,0
"14539",1976,"108",0,0,0
"14540",1976,"109",0,0,0
"14541",1976,"110+",0,0,0
"14542",1977,"0",25916,27167,53083
"14543",1977,"1",27450,28600,56050
"14544",1977,"2",29333,30193,59526
"14545",1977,"3",29731,31425,61156
"14546",1977,"4",31275,32794,64069
"14547",1977,"5",32007,33365,65372
"14548",1977,"6",31419,33128,64547
"14549",1977,"7",32949,34656,67605
"14550",1977,"8",32630,34468,67098
"14551",1977,"9",32223,33783,66006
"14552",1977,"10",32119,34130,66249
"14553",1977,"11",31695,33725,65420
"14554",1977,"12",31325,33480,64805
"14555",1977,"13",30684,31869,62553
"14556",1977,"14",29807,31392,61199
"14557",1977,"15",29785,31591,61376
"14558",1977,"16",29638,31094,60732
"14559",1977,"17",30035,31797,61832
"14560",1977,"18",30117,31510,61627
"14561",1977,"19",30123,31426,61549
"14562",1977,"20",30655,31902,62557
"14563",1977,"21",30030,31617,61647
"14564",1977,"22",29825,30974,60799
"14565",1977,"23",29958,31241,61199
"14566",1977,"24",29451,31200,60651
"14567",1977,"25",28285,30480,58765
"14568",1977,"26",29113,31104,60217
"14569",1977,"27",29363,31475,60838
"14570",1977,"28",30016,32542,62558
"14571",1977,"29",31274,33249,64523
"14572",1977,"30",32552,34763,67315
"14573",1977,"31",29331,31334,60665
"14574",1977,"32",28138,30428,58566
"14575",1977,"33",25213,26845,52058
"14576",1977,"34",23447,24671,48118
"14577",1977,"35",20777,21623,42400
"14578",1977,"36",21448,22513,43961
"14579",1977,"37",21162,21734,42896
"14580",1977,"38",20536,21094,41630
"14581",1977,"39",19725,20231,39956
"14582",1977,"40",19043,19686,38729
"14583",1977,"41",18624,18767,37391
"14584",1977,"42",18651,19179,37830
"14585",1977,"43",18565,19380,37945
"14586",1977,"44",20164,20587,40751
"14587",1977,"45",20477,20625,41102
"14588",1977,"46",20912,21567,42479
"14589",1977,"47",20749,21285,42034
"14590",1977,"48",21483,21638,43121
"14591",1977,"49",21482,21783,43265
"14592",1977,"50",22786,22959,45745
"14593",1977,"51",22697,22892,45589
"14594",1977,"52",23762,24087,47849
"14595",1977,"53",24886,24896,49782
"14596",1977,"54",25228,24643,49871
"14597",1977,"55",25704,24772,50476
"14598",1977,"56",27571,26516,54087
"14599",1977,"57",22889,22279,45168
"14600",1977,"58",24431,23065,47496
"14601",1977,"59",24327,23011,47338
"14602",1977,"60",23246,21579,44825
"14603",1977,"61",22879,21193,44072
"14604",1977,"62",22783,21286,44069
"14605",1977,"63",22524,20775,43299
"14606",1977,"64",22452,20343,42795
"14607",1977,"65",21651,19606,41257
"14608",1977,"66",21160,18590,39750
"14609",1977,"67",21053,18154,39207
"14610",1977,"68",19872,16975,36847
"14611",1977,"69",19351,15825,35176
"14612",1977,"70",18740,14981,33721
"14613",1977,"71",18054,13816,31870
"14614",1977,"72",17594,13272,30866
"14615",1977,"73",16920,12689,29609
"14616",1977,"74",16244,11970,28214
"14617",1977,"75",15382,10972,26354
"14618",1977,"76",14551,9990,24541
"14619",1977,"77",13266,9055,22321
"14620",1977,"78",12618,8571,21189
"14621",1977,"79",11360,7476,18836
"14622",1977,"80",10355,6799,17154
"14623",1977,"81",9290,5990,15280
"14624",1977,"82",8022,5041,13063
"14625",1977,"83",7190,4444,11634
"14626",1977,"84",5990,3673,9663
"14627",1977,"85",5135,3095,8230
"14628",1977,"86",4346,2386,6732
"14629",1977,"87",3470,2038,5508
"14630",1977,"88",2748,1548,4296
"14631",1977,"89",2287,1320,3607
"14632",1977,"90",1799,1000,2799
"14633",1977,"91",1364,705,2069
"14634",1977,"92",1056,564,1620
"14635",1977,"93",751,379,1130
"14636",1977,"94",499,249,748
"14637",1977,"95",335,169,504
"14638",1977,"96",262,103,365
"14639",1977,"97",172,79,251
"14640",1977,"98",106,50,156
"14641",1977,"99",87,30,117
"14642",1977,"100",40,21,61
"14643",1977,"101",30,12,42
"14644",1977,"102",14,7,21
"14645",1977,"103",8,3,11
"14646",1977,"104",4,6,10
"14647",1977,"105",0,1,1
"14648",1977,"106",1,0,1
"14649",1977,"107",0,0,0
"14650",1977,"108",0,0,0
"14651",1977,"109",0,0,0
"14652",1977,"110+",0,0,0
"14653",1978,"0",24663,26000,50663
"14654",1978,"1",26072,27255,53327
"14655",1978,"2",27540,28668,56208
"14656",1978,"3",29428,30274,59702
"14657",1978,"4",29785,31498,61283
"14658",1978,"5",31340,32869,64209
"14659",1978,"6",32035,33430,65465
"14660",1978,"7",31477,33191,64668
"14661",1978,"8",32989,34672,67661
"14662",1978,"9",32669,34487,67156
"14663",1978,"10",32248,33826,66074
"14664",1978,"11",32148,34160,66308
"14665",1978,"12",31733,33744,65477
"14666",1978,"13",31341,33484,64825
"14667",1978,"14",30691,31871,62562
"14668",1978,"15",29837,31406,61243
"14669",1978,"16",29807,31602,61409
"14670",1978,"17",29699,31104,60803
"14671",1978,"18",30092,31814,61906
"14672",1978,"19",30144,31537,61681
"14673",1978,"20",30139,31433,61572
"14674",1978,"21",30688,31869,62557
"14675",1978,"22",30078,31649,61727
"14676",1978,"23",29903,31022,60925
"14677",1978,"24",30057,31291,61348
"14678",1978,"25",29520,31263,60783
"14679",1978,"26",28311,30502,58813
"14680",1978,"27",29124,31143,60267
"14681",1978,"28",29439,31487,60926
"14682",1978,"29",30073,32557,62630
"14683",1978,"30",31322,33307,64629
"14684",1978,"31",32591,34822,67413
"14685",1978,"32",29348,31332,60680
"14686",1978,"33",28161,30410,58571
"14687",1978,"34",25273,26854,52127
"14688",1978,"35",23453,24673,48126
"14689",1978,"36",20817,21616,42433
"14690",1978,"37",21451,22481,43932
"14691",1978,"38",21176,21712,42888
"14692",1978,"39",20541,21072,41613
"14693",1978,"40",19718,20201,39919
"14694",1978,"41",19026,19640,38666
"14695",1978,"42",18638,18754,37392
"14696",1978,"43",18636,19148,37784
"14697",1978,"44",18566,19339,37905
"14698",1978,"45",20141,20521,40662
"14699",1978,"46",20457,20568,41025
"14700",1978,"47",20879,21495,42374
"14701",1978,"48",20716,21204,41920
"14702",1978,"49",21441,21530,42971
"14703",1978,"50",21444,21650,43094
"14704",1978,"51",22734,22810,45544
"14705",1978,"52",22620,22744,45364
"14706",1978,"53",23689,23896,47585
"14707",1978,"54",24809,24687,49496
"14708",1978,"55",25122,24437,49559
"14709",1978,"56",25586,24507,50093
"14710",1978,"57",27403,26206,53609
"14711",1978,"58",22770,22009,44779
"14712",1978,"59",24289,22760,47049
"14713",1978,"60",24172,22687,46859
"14714",1978,"61",23092,21238,44330
"14715",1978,"62",22690,20864,43554
"14716",1978,"63",22596,20920,43516
"14717",1978,"64",22283,20331,42614
"14718",1978,"65",22213,19891,42104
"14719",1978,"66",21412,19116,40528
"14720",1978,"67",20888,18086,38974
"14721",1978,"68",20733,17576,38309
"14722",1978,"69",19523,16394,35917
"14723",1978,"70",18970,15293,34263
"14724",1978,"71",18389,14356,32745
"14725",1978,"72",17612,13187,30799
"14726",1978,"73",17140,12623,29763
"14727",1978,"74",16392,11986,28378
"14728",1978,"75",15679,11259,26938
"14729",1978,"76",14754,10213,24967
"14730",1978,"77",13911,9307,23218
"14731",1978,"78",12626,8327,20953
"14732",1978,"79",11896,7816,19712
"14733",1978,"80",10667,6800,17467
"14734",1978,"81",9625,6142,15767
"14735",1978,"82",8545,5361,13906
"14736",1978,"83",7309,4434,11743
"14737",1978,"84",6486,3906,10392
"14738",1978,"85",5325,3194,8519
"14739",1978,"86",4504,2634,7138
"14740",1978,"87",3757,1952,5709
"14741",1978,"88",2963,1667,4630
"14742",1978,"89",2314,1241,3555
"14743",1978,"90",1894,1075,2969
"14744",1978,"91",1450,786,2236
"14745",1978,"92",1073,521,1594
"14746",1978,"93",816,424,1240
"14747",1978,"94",562,279,841
"14748",1978,"95",386,171,557
"14749",1978,"96",240,107,347
"14750",1978,"97",192,60,252
"14751",1978,"98",122,49,171
"14752",1978,"99",68,31,99
"14753",1978,"100",52,17,69
"14754",1978,"101",24,16,40
"14755",1978,"102",16,7,23
"14756",1978,"103",11,4,15
"14757",1978,"104",5,2,7
"14758",1978,"105",0,3,3
"14759",1978,"106",0,1,1
"14760",1978,"107",0,0,0
"14761",1978,"108",0,0,0
"14762",1978,"109",0,0,0
"14763",1978,"110+",0,0,0
"14764",1979,"0",25059,26439,51498
"14765",1979,"1",24788,26038,50826
"14766",1979,"2",26139,27296,53435
"14767",1979,"3",27573,28685,56258
"14768",1979,"4",29483,30319,59802
"14769",1979,"5",29819,31538,61357
"14770",1979,"6",31387,32907,64294
"14771",1979,"7",32068,33476,65544
"14772",1979,"8",31484,33189,64673
"14773",1979,"9",32997,34706,67703
"14774",1979,"10",32696,34520,67216
"14775",1979,"11",32258,33843,66101
"14776",1979,"12",32166,34179,66345
"14777",1979,"13",31738,33736,65474
"14778",1979,"14",31367,33505,64872
"14779",1979,"15",30707,31894,62601
"14780",1979,"16",29854,31428,61282
"14781",1979,"17",29868,31624,61492
"14782",1979,"18",29743,31149,60892
"14783",1979,"19",30117,31877,61994
"14784",1979,"20",30200,31576,61776
"14785",1979,"21",30126,31429,61555
"14786",1979,"22",30756,31860,62616
"14787",1979,"23",30161,31702,61863
"14788",1979,"24",29965,31055,61020
"14789",1979,"25",30085,31356,61441
"14790",1979,"26",29575,31323,60898
"14791",1979,"27",28358,30521,58879
"14792",1979,"28",29170,31176,60346
"14793",1979,"29",29448,31500,60948
"14794",1979,"30",30102,32562,62664
"14795",1979,"31",31343,33298,64641
"14796",1979,"32",32594,34846,67440
"14797",1979,"33",29371,31293,60664
"14798",1979,"34",28186,30392,58578
"14799",1979,"35",25267,26863,52130
"14800",1979,"36",23466,24665,48131
"14801",1979,"37",20823,21585,42408
"14802",1979,"38",21426,22482,43908
"14803",1979,"39",21162,21700,42862
"14804",1979,"40",20548,21041,41589
"14805",1979,"41",19713,20196,39909
"14806",1979,"42",19008,19576,38584
"14807",1979,"43",18630,18705,37335
"14808",1979,"44",18604,19114,37718
"14809",1979,"45",18559,19285,37844
"14810",1979,"46",20109,20460,40569
"14811",1979,"47",20406,20479,40885
"14812",1979,"48",20850,21375,42225
"14813",1979,"49",20663,21097,41760
"14814",1979,"50",21375,21394,42769
"14815",1979,"51",21370,21523,42893
"14816",1979,"52",22676,22684,45360
"14817",1979,"53",22542,22582,45124
"14818",1979,"54",23619,23700,47319
"14819",1979,"55",24684,24465,49149
"14820",1979,"56",24985,24150,49135
"14821",1979,"57",25438,24220,49658
"14822",1979,"58",27262,25912,53174
"14823",1979,"59",22634,21725,44359
"14824",1979,"60",24144,22397,46541
"14825",1979,"61",24008,22342,46350
"14826",1979,"62",22919,20881,43800
"14827",1979,"63",22488,20466,42954
"14828",1979,"64",22353,20454,42807
"14829",1979,"65",22067,19861,41928
"14830",1979,"66",21921,19365,41286
"14831",1979,"67",21155,18572,39727
"14832",1979,"68",20563,17580,38143
"14833",1979,"69",20400,16995,37395
"14834",1979,"70",19141,15776,34917
"14835",1979,"71",18587,14619,33206
"14836",1979,"72",17947,13714,31661
"14837",1979,"73",17133,12543,29676
"14838",1979,"74",16665,11930,28595
"14839",1979,"75",15849,11250,27099
"14840",1979,"76",15031,10537,25568
"14841",1979,"77",14108,9463,23571
"14842",1979,"78",13192,8582,21774
"14843",1979,"79",11882,7639,19521
"14844",1979,"80",11139,7082,18221
"14845",1979,"81",9940,6125,16065
"14846",1979,"82",8872,5440,14312
"14847",1979,"83",7804,4720,12524
"14848",1979,"84",6598,3893,10491
"14849",1979,"85",5763,3353,9116
"14850",1979,"86",4650,2732,7382
"14851",1979,"87",3906,2205,6111
"14852",1979,"88",3199,1586,4785
"14853",1979,"89",2460,1358,3818
"14854",1979,"90",1908,991,2899
"14855",1979,"91",1560,821,2381
"14856",1979,"92",1128,604,1732
"14857",1979,"93",832,374,1206
"14858",1979,"94",625,307,932
"14859",1979,"95",439,202,641
"14860",1979,"96",277,113,390
"14861",1979,"97",165,78,243
"14862",1979,"98",133,34,167
"14863",1979,"99",87,33,120
"14864",1979,"100",39,22,61
"14865",1979,"101",30,9,39
"14866",1979,"102",16,11,27
"14867",1979,"103",10,2,12
"14868",1979,"104",7,2,9
"14869",1979,"105",2,1,3
"14870",1979,"106",0,1,1
"14871",1979,"107",0,0,0
"14872",1979,"108",0,0,0
"14873",1979,"109",0,0,0
"14874",1979,"110+",0,0,0
"14875",1980,"0",24930,26291,51221
"14876",1980,"1",25137,26478,51615
"14877",1980,"2",24832,26082,50914
"14878",1980,"3",26160,27316,53476
"14879",1980,"4",27578,28708,56286
"14880",1980,"5",29502,30360,59862
"14881",1980,"6",29850,31535,61385
"14882",1980,"7",31415,32932,64347
"14883",1980,"8",32100,33465,65565
"14884",1980,"9",31517,33239,64756
"14885",1980,"10",33019,34729,67748
"14886",1980,"11",32726,34555,67281
"14887",1980,"12",32284,33873,66157
"14888",1980,"13",32162,34203,66365
"14889",1980,"14",31734,33775,65509
"14890",1980,"15",31359,33530,64889
"14891",1980,"16",30750,31931,62681
"14892",1980,"17",29909,31456,61365
"14893",1980,"18",29901,31623,61524
"14894",1980,"19",29785,31151,60936
"14895",1980,"20",30145,31905,62050
"14896",1980,"21",30222,31548,61770
"14897",1980,"22",30138,31414,61552
"14898",1980,"23",30775,31868,62643
"14899",1980,"24",30167,31746,61913
"14900",1980,"25",29965,31065,61030
"14901",1980,"26",30065,31419,61484
"14902",1980,"27",29579,31322,60901
"14903",1980,"28",28382,30489,58871
"14904",1980,"29",29179,31201,60380
"14905",1980,"30",29428,31558,60986
"14906",1980,"31",30086,32551,62637
"14907",1980,"32",31334,33267,64601
"14908",1980,"33",32604,34789,67393
"14909",1980,"34",29386,31280,60666
"14910",1980,"35",28186,30391,58577
"14911",1980,"36",25258,26818,52076
"14912",1980,"37",23468,24631,48099
"14913",1980,"38",20813,21595,42408
"14914",1980,"39",21411,22453,43864
"14915",1980,"40",21139,21649,42788
"14916",1980,"41",20534,21018,41552
"14917",1980,"42",19683,20172,39855
"14918",1980,"43",18981,19530,38511
"14919",1980,"44",18617,18652,37269
"14920",1980,"45",18580,19052,37632
"14921",1980,"46",18525,19215,37740
"14922",1980,"47",20069,20378,40447
"14923",1980,"48",20367,20379,40746
"14924",1980,"49",20820,21266,42086
"14925",1980,"50",20609,20995,41604
"14926",1980,"51",21322,21250,42572
"14927",1980,"52",21308,21345,42653
"14928",1980,"53",22578,22533,45111
"14929",1980,"54",22471,22388,44859
"14930",1980,"55",23526,23468,46994
"14931",1980,"56",24566,24249,48815
"14932",1980,"57",24864,23902,48766
"14933",1980,"58",25324,23916,49240
"14934",1980,"59",27121,25579,52700
"14935",1980,"60",22494,21376,43870
"14936",1980,"61",23962,22032,45994
"14937",1980,"62",23839,21954,45793
"14938",1980,"63",22736,20455,43191
"14939",1980,"64",22265,20016,42281
"14940",1980,"65",22089,19949,42038
"14941",1980,"66",21788,19369,41157
"14942",1980,"67",21638,18829,40467
"14943",1980,"68",20809,18012,38821
"14944",1980,"69",20212,17000,37212
"14945",1980,"70",20015,16354,36369
"14946",1980,"71",18755,15098,33853
"14947",1980,"72",18154,13946,32100
"14948",1980,"73",17511,13082,30593
"14949",1980,"74",16645,11851,28496
"14950",1980,"75",16123,11213,27336
"14951",1980,"76",15223,10531,25754
"14952",1980,"77",14396,9727,24123
"14953",1980,"78",13399,8709,22108
"14954",1980,"79",12442,7793,20235
"14955",1980,"80",11116,6940,18056
"14956",1980,"81",10334,6374,16708
"14957",1980,"82",9144,5486,14630
"14958",1980,"83",8071,4759,12830
"14959",1980,"84",6995,4117,11112
"14960",1980,"85",5890,3376,9266
"14961",1980,"86",5077,2863,7940
"14962",1980,"87",4079,2314,6393
"14963",1980,"88",3314,1811,5125
"14964",1980,"89",2705,1275,3980
"14965",1980,"90",2000,1047,3047
"14966",1980,"91",1554,776,2330
"14967",1980,"92",1192,617,1809
"14968",1980,"93",857,465,1322
"14969",1980,"94",638,263,901
"14970",1980,"95",474,210,684
"14971",1980,"96",300,132,432
"14972",1980,"97",200,76,276
"14973",1980,"98",108,46,154
"14974",1980,"99",82,25,107
"14975",1980,"100",52,19,71
"14976",1980,"101",25,13,38
"14977",1980,"102",16,5,21
"14978",1980,"103",8,8,16
"14979",1980,"104",7,0,7
"14980",1980,"105",2,1,3
"14981",1980,"106",0,1,1
"14982",1980,"107",0,0,0
"14983",1980,"108",0,0,0
"14984",1980,"109",0,0,0
"14985",1980,"110+",0,0,0
"14986",1981,"0",24613,26172,50785
"14987",1981,"1",25073,26358,51431
"14988",1981,"2",25201,26546,51747
"14989",1981,"3",24864,26106,50970
"14990",1981,"4",26218,27364,53582
"14991",1981,"5",27643,28749,56392
"14992",1981,"6",29512,30402,59914
"14993",1981,"7",29885,31604,61489
"14994",1981,"8",31443,32959,64402
"14995",1981,"9",32117,33503,65620
"14996",1981,"10",31538,33275,64813
"14997",1981,"11",33044,34745,67789
"14998",1981,"12",32733,34594,67327
"14999",1981,"13",32298,33906,66204
"15000",1981,"14",32186,34235,66421
"15001",1981,"15",31772,33809,65581
"15002",1981,"16",31400,33560,64960
"15003",1981,"17",30833,31951,62784
"15004",1981,"18",29998,31496,61494
"15005",1981,"19",29944,31632,61576
"15006",1981,"20",29821,31195,61016
"15007",1981,"21",30176,31920,62096
"15008",1981,"22",30233,31553,61786
"15009",1981,"23",30195,31437,61632
"15010",1981,"24",30795,31934,62729
"15011",1981,"25",30204,31787,61991
"15012",1981,"26",30009,31130,61139
"15013",1981,"27",30071,31410,61481
"15014",1981,"28",29572,31359,60931
"15015",1981,"29",28387,30516,58903
"15016",1981,"30",29174,31185,60359
"15017",1981,"31",29413,31534,60947
"15018",1981,"32",30106,32534,62640
"15019",1981,"33",31337,33264,64601
"15020",1981,"34",32626,34778,67404
"15021",1981,"35",29410,31269,60679
"15022",1981,"36",28184,30365,58549
"15023",1981,"37",25233,26765,51998
"15024",1981,"38",23442,24597,48039
"15025",1981,"39",20816,21550,42366
"15026",1981,"40",21420,22412,43832
"15027",1981,"41",21109,21612,42721
"15028",1981,"42",20513,20970,41483
"15029",1981,"43",19664,20106,39770
"15030",1981,"44",18972,19469,38441
"15031",1981,"45",18616,18592,37208
"15032",1981,"46",18561,18989,37550
"15033",1981,"47",18482,19143,37625
"15034",1981,"48",20027,20278,40305
"15035",1981,"49",20320,20281,40601
"15036",1981,"50",20777,21127,41904
"15037",1981,"51",20552,20864,41416
"15038",1981,"52",21252,21109,42361
"15039",1981,"53",21217,21198,42415
"15040",1981,"54",22485,22358,44843
"15041",1981,"55",22383,22198,44581
"15042",1981,"56",23448,23254,46702
"15043",1981,"57",24467,23979,48446
"15044",1981,"58",24733,23595,48328
"15045",1981,"59",25192,23609,48801
"15046",1981,"60",26943,25242,52185
"15047",1981,"61",22326,21020,43346
"15048",1981,"62",23769,21622,45391
"15049",1981,"63",23650,21517,45167
"15050",1981,"64",22522,19996,42518
"15051",1981,"65",22049,19524,41573
"15052",1981,"66",21826,19398,41224
"15053",1981,"67",21505,18790,40295
"15054",1981,"68",21364,18255,39619
"15055",1981,"69",20493,17385,37878
"15056",1981,"70",19835,16401,36236
"15057",1981,"71",19611,15716,35327
"15058",1981,"72",18292,14418,32710
"15059",1981,"73",17678,13247,30925
"15060",1981,"74",17029,12427,29456
"15061",1981,"75",16073,11147,27220
"15062",1981,"76",15497,10458,25955
"15063",1981,"77",14641,9787,24428
"15064",1981,"78",13712,8983,22695
"15065",1981,"79",12649,7974,20623
"15066",1981,"80",11725,7061,18786
"15067",1981,"81",10352,6266,16618
"15068",1981,"82",9502,5716,15218
"15069",1981,"83",8374,4831,13205
"15070",1981,"84",7289,4119,11408
"15071",1981,"85",6274,3574,9848
"15072",1981,"86",5232,2862,8094
"15073",1981,"87",4454,2404,6858
"15074",1981,"88",3521,1888,5409
"15075",1981,"89",2789,1486,4275
"15076",1981,"90",2233,1019,3252
"15077",1981,"91",1608,824,2432
"15078",1981,"92",1234,591,1825
"15079",1981,"93",932,475,1407
"15080",1981,"94",639,352,991
"15081",1981,"95",474,193,667
"15082",1981,"96",337,147,484
"15083",1981,"97",224,86,310
"15084",1981,"98",135,46,181
"15085",1981,"99",77,33,110
"15086",1981,"100",54,16,70
"15087",1981,"101",37,13,50
"15088",1981,"102",16,6,22
"15089",1981,"103",9,1,10
"15090",1981,"104",4,3,7
"15091",1981,"105",4,0,4
"15092",1981,"106",1,1,2
"15093",1981,"107",0,1,1
"15094",1981,"108",0,0,0
"15095",1981,"109",0,0,0
"15096",1981,"110+",0,0,0
"15097",1982,"0",24808,25717,50525
"15098",1982,"1",24763,26303,51066
"15099",1982,"2",25192,26427,51619
"15100",1982,"3",25252,26601,51853
"15101",1982,"4",24944,26152,51096
"15102",1982,"5",26254,27414,53668
"15103",1982,"6",27706,28797,56503
"15104",1982,"7",29585,30448,60033
"15105",1982,"8",29910,31667,61577
"15106",1982,"9",31491,32993,64484
"15107",1982,"10",32170,33554,65724
"15108",1982,"11",31580,33314,64894
"15109",1982,"12",33069,34772,67841
"15110",1982,"13",32778,34625,67403
"15111",1982,"14",32315,33939,66254
"15112",1982,"15",32223,34265,66488
"15113",1982,"16",31829,33843,65672
"15114",1982,"17",31508,33583,65091
"15115",1982,"18",30944,31985,62929
"15116",1982,"19",30053,31553,61606
"15117",1982,"20",30036,31684,61720
"15118",1982,"21",29877,31255,61132
"15119",1982,"22",30256,31966,62222
"15120",1982,"23",30294,31641,61935
"15121",1982,"24",30270,31548,61818
"15122",1982,"25",30905,32064,62969
"15123",1982,"26",30319,31851,62170
"15124",1982,"27",30075,31237,61312
"15125",1982,"28",30111,31449,61560
"15126",1982,"29",29638,31374,61012
"15127",1982,"30",28414,30566,58980
"15128",1982,"31",29227,31230,60457
"15129",1982,"32",29424,31535,60959
"15130",1982,"33",30163,32517,62680
"15131",1982,"34",31352,33283,64635
"15132",1982,"35",32642,34741,67383
"15133",1982,"36",29428,31240,60668
"15134",1982,"37",28176,30337,58513
"15135",1982,"38",25271,26760,52031
"15136",1982,"39",23465,24569,48034
"15137",1982,"40",20810,21530,42340
"15138",1982,"41",21417,22380,43797
"15139",1982,"42",21115,21576,42691
"15140",1982,"43",20505,20926,41431
"15141",1982,"44",19655,20070,39725
"15142",1982,"45",18940,19424,38364
"15143",1982,"46",18582,18538,37120
"15144",1982,"47",18520,18922,37442
"15145",1982,"48",18445,19088,37533
"15146",1982,"49",19997,20190,40187
"15147",1982,"50",20285,20184,40469
"15148",1982,"51",20724,21003,41727
"15149",1982,"52",20484,20731,41215
"15150",1982,"53",21190,20983,42173
"15151",1982,"54",21160,21020,42180
"15152",1982,"55",22402,22150,44552
"15153",1982,"56",22279,21987,44266
"15154",1982,"57",23342,23012,46354
"15155",1982,"58",24329,23674,48003
"15156",1982,"59",24598,23285,47883
"15157",1982,"60",25033,23266,48299
"15158",1982,"61",26748,24870,51618
"15159",1982,"62",22161,20676,42837
"15160",1982,"63",23566,21198,44764
"15161",1982,"64",23440,21047,44487
"15162",1982,"65",22267,19517,41784
"15163",1982,"66",21817,18995,40812
"15164",1982,"67",21571,18865,40436
"15165",1982,"68",21201,18237,39438
"15166",1982,"69",21027,17659,38686
"15167",1982,"70",20151,16745,36896
"15168",1982,"71",19450,15657,35107
"15169",1982,"72",19186,15069,34255
"15170",1982,"73",17844,13698,31542
"15171",1982,"74",17177,12532,29709
"15172",1982,"75",16462,11704,28166
"15173",1982,"76",15489,10468,25957
"15174",1982,"77",14882,9706,24588
"15175",1982,"78",13969,9046,23015
"15176",1982,"79",13009,8258,21267
"15177",1982,"80",11893,7237,19130
"15178",1982,"81",10919,6345,17264
"15179",1982,"82",9564,5561,15125
"15180",1982,"83",8697,5046,13743
"15181",1982,"84",7585,4188,11773
"15182",1982,"85",6534,3524,10058
"15183",1982,"86",5540,3011,8551
"15184",1982,"87",4537,2396,6933
"15185",1982,"88",3834,1961,5795
"15186",1982,"89",3001,1527,4528
"15187",1982,"90",2307,1152,3459
"15188",1982,"91",1781,795,2576
"15189",1982,"92",1286,619,1905
"15190",1982,"93",944,447,1391
"15191",1982,"94",701,350,1051
"15192",1982,"95",462,246,708
"15193",1982,"96",349,136,485
"15194",1982,"97",230,107,337
"15195",1982,"98",144,49,193
"15196",1982,"99",91,30,121
"15197",1982,"100",52,23,75
"15198",1982,"101",30,10,40
"15199",1982,"102",25,5,30
"15200",1982,"103",10,3,13
"15201",1982,"104",6,1,7
"15202",1982,"105",1,1,2
"15203",1982,"106",3,0,3
"15204",1982,"107",1,1,2
"15205",1982,"108",0,0,0
"15206",1982,"109",0,0,0
"15207",1982,"110+",0,0,0
"15208",1983,"0",24722,26276,50998
"15209",1983,"1",24997,25780,50777
"15210",1983,"2",24863,26379,51242
"15211",1983,"3",25240,26497,51737
"15212",1983,"4",25309,26642,51951
"15213",1983,"5",24999,26228,51227
"15214",1983,"6",26261,27456,53717
"15215",1983,"7",27746,28846,56592
"15216",1983,"8",29604,30474,60078
"15217",1983,"9",29946,31740,61686
"15218",1983,"10",31519,33019,64538
"15219",1983,"11",32208,33583,65791
"15220",1983,"12",31601,33353,64954
"15221",1983,"13",33090,34790,67880
"15222",1983,"14",32807,34645,67452
"15223",1983,"15",32319,33968,66287
"15224",1983,"16",32231,34308,66539
"15225",1983,"17",31876,33875,65751
"15226",1983,"18",31561,33578,65139
"15227",1983,"19",30989,32032,63021
"15228",1983,"20",30115,31609,61724
"15229",1983,"21",30112,31690,61802
"15230",1983,"22",29943,31329,61272
"15231",1983,"23",30321,32030,62351
"15232",1983,"24",30436,31720,62156
"15233",1983,"25",30318,31651,61969
"15234",1983,"26",30965,32132,63097
"15235",1983,"27",30384,32008,62392
"15236",1983,"28",30148,31313,61461
"15237",1983,"29",30158,31512,61670
"15238",1983,"30",29698,31419,61117
"15239",1983,"31",28493,30595,59088
"15240",1983,"32",29259,31305,60564
"15241",1983,"33",29471,31609,61080
"15242",1983,"34",30200,32583,62783
"15243",1983,"35",31379,33313,64692
"15244",1983,"36",32662,34774,67436
"15245",1983,"37",29443,31260,60703
"15246",1983,"38",28151,30331,58482
"15247",1983,"39",25278,26741,52019
"15248",1983,"40",23462,24508,47970
"15249",1983,"41",20789,21533,42322
"15250",1983,"42",21412,22329,43741
"15251",1983,"43",21102,21554,42656
"15252",1983,"44",20481,20873,41354
"15253",1983,"45",19648,20003,39651
"15254",1983,"46",18933,19384,38317
"15255",1983,"47",18552,18463,37015
"15256",1983,"48",18500,18867,37367
"15257",1983,"49",18404,19011,37415
"15258",1983,"50",19957,20078,40035
"15259",1983,"51",20230,20049,40279
"15260",1983,"52",20688,20861,41549
"15261",1983,"53",20414,20592,41006
"15262",1983,"54",21117,20837,41954
"15263",1983,"55",21058,20815,41873
"15264",1983,"56",22308,21927,44235
"15265",1983,"57",22170,21765,43935
"15266",1983,"58",23207,22741,45948
"15267",1983,"59",24179,23383,47562
"15268",1983,"60",24416,22970,47386
"15269",1983,"61",24844,22911,47755
"15270",1983,"62",26533,24433,50966
"15271",1983,"63",21967,20284,42251
"15272",1983,"64",23346,20756,44102
"15273",1983,"65",23200,20570,43770
"15274",1983,"66",21991,19013,41004
"15275",1983,"67",21540,18481,40021
"15276",1983,"68",21279,18261,39540
"15277",1983,"69",20853,17601,38454
"15278",1983,"70",20701,17037,37738
"15279",1983,"71",19781,16069,35850
"15280",1983,"72",19022,14944,33966
"15281",1983,"73",18728,14357,33085
"15282",1983,"74",17346,12986,30332
"15283",1983,"75",16664,11771,28435
"15284",1983,"76",15893,10973,26866
"15285",1983,"77",14867,9763,24630
"15286",1983,"78",14236,8952,23188
"15287",1983,"79",13214,8294,21508
"15288",1983,"80",12238,7530,19768
"15289",1983,"81",11159,6519,17678
"15290",1983,"82",10136,5669,15805
"15291",1983,"83",8814,4915,13729
"15292",1983,"84",7931,4400,12331
"15293",1983,"85",6828,3610,10438
"15294",1983,"86",5824,3065,8889
"15295",1983,"87",4847,2536,7383
"15296",1983,"88",3911,1985,5896
"15297",1983,"89",3269,1584,4853
"15298",1983,"90",2508,1253,3761
"15299",1983,"91",1912,911,2823
"15300",1983,"92",1414,602,2016
"15301",1983,"93",1024,450,1474
"15302",1983,"94",744,329,1073
"15303",1983,"95",541,256,797
"15304",1983,"96",343,165,508
"15305",1983,"97",238,97,335
"15306",1983,"98",166,66,232
"15307",1983,"99",103,34,137
"15308",1983,"100",64,20,84
"15309",1983,"101",34,11,45
"15310",1983,"102",23,7,30
"15311",1983,"103",13,3,16
"15312",1983,"104",8,3,11
"15313",1983,"105",5,1,6
"15314",1983,"106",0,1,1
"15315",1983,"107",2,0,2
"15316",1983,"108",1,1,2
"15317",1983,"109",0,0,0
"15318",1983,"110+",0,0,0
"15319",1984,"0",24080,25601,49681
"15320",1984,"1",24816,26333,51149
"15321",1984,"2",25081,25892,50973
"15322",1984,"3",24918,26435,51353
"15323",1984,"4",25247,26548,51795
"15324",1984,"5",25361,26681,52042
"15325",1984,"6",25014,26256,51270
"15326",1984,"7",26295,27489,53784
"15327",1984,"8",27765,28854,56619
"15328",1984,"9",29665,30501,60166
"15329",1984,"10",29972,31748,61720
"15330",1984,"11",31562,33066,64628
"15331",1984,"12",32203,33594,65797
"15332",1984,"13",31632,33355,64987
"15333",1984,"14",33120,34837,67957
"15334",1984,"15",32824,34639,67463
"15335",1984,"16",32368,34018,66386
"15336",1984,"17",32333,34311,66644
"15337",1984,"18",31973,33907,65880
"15338",1984,"19",31665,33606,65271
"15339",1984,"20",31048,32061,63109
"15340",1984,"21",30112,31579,61691
"15341",1984,"22",30114,31701,61815
"15342",1984,"23",29969,31347,61316
"15343",1984,"24",30362,32081,62443
"15344",1984,"25",30477,31762,62239
"15345",1984,"26",30350,31721,62071
"15346",1984,"27",31021,32128,63149
"15347",1984,"28",30405,31995,62400
"15348",1984,"29",30202,31334,61536
"15349",1984,"30",30192,31538,61730
"15350",1984,"31",29733,31426,61159
"15351",1984,"32",28484,30631,59115
"15352",1984,"33",29272,31349,60621
"15353",1984,"34",29497,31640,61137
"15354",1984,"35",30218,32575,62793
"15355",1984,"36",31369,33307,64676
"15356",1984,"37",32661,34764,67425
"15357",1984,"38",29452,31218,60670
"15358",1984,"39",28136,30335,58471
"15359",1984,"40",25284,26730,52014
"15360",1984,"41",23443,24512,47955
"15361",1984,"42",20793,21503,42296
"15362",1984,"43",21383,22304,43687
"15363",1984,"44",21082,21527,42609
"15364",1984,"45",20461,20838,41299
"15365",1984,"46",19629,19924,39553
"15366",1984,"47",18908,19343,38251
"15367",1984,"48",18519,18390,36909
"15368",1984,"49",18474,18797,37271
"15369",1984,"50",18363,18929,37292
"15370",1984,"51",19899,19963,39862
"15371",1984,"52",20162,19938,40100
"15372",1984,"53",20603,20700,41303
"15373",1984,"54",20344,20413,40757
"15374",1984,"55",21019,20663,41682
"15375",1984,"56",20955,20609,41564
"15376",1984,"57",22182,21694,43876
"15377",1984,"58",22046,21518,43564
"15378",1984,"59",23076,22446,45522
"15379",1984,"60",24034,23042,47076
"15380",1984,"61",24256,22580,46836
"15381",1984,"62",24651,22494,47145
"15382",1984,"63",26313,23931,50244
"15383",1984,"64",21776,19872,41648
"15384",1984,"65",23120,20263,43383
"15385",1984,"66",22934,20059,42993
"15386",1984,"67",21712,18498,40210
"15387",1984,"68",21284,17913,39197
"15388",1984,"69",20928,17631,38559
"15389",1984,"70",20498,16937,37435
"15390",1984,"71",20253,16310,36563
"15391",1984,"72",19345,15385,34730
"15392",1984,"73",18558,14226,32784
"15393",1984,"74",18249,13591,31840
"15394",1984,"75",16801,12205,29006
"15395",1984,"76",16098,11064,27162
"15396",1984,"77",15252,10235,25487
"15397",1984,"78",14203,9021,23224
"15398",1984,"79",13539,8202,21741
"15399",1984,"80",12510,7555,20065
"15400",1984,"81",11455,6824,18279
"15401",1984,"82",10336,5851,16187
"15402",1984,"83",9315,5022,14337
"15403",1984,"84",8040,4290,12330
"15404",1984,"85",7150,3838,10988
"15405",1984,"86",6026,3078,9104
"15406",1984,"87",5096,2563,7659
"15407",1984,"88",4202,2120,6322
"15408",1984,"89",3359,1593,4952
"15409",1984,"90",2718,1256,3974
"15410",1984,"91",2057,954,3011
"15411",1984,"92",1538,696,2234
"15412",1984,"93",1115,447,1562
"15413",1984,"94",795,335,1130
"15414",1984,"95",556,225,781
"15415",1984,"96",396,176,572
"15416",1984,"97",245,110,355
"15417",1984,"98",167,66,233
"15418",1984,"99",112,47,159
"15419",1984,"100",70,21,91
"15420",1984,"101",43,11,54
"15421",1984,"102",21,6,27
"15422",1984,"103",15,5,20
"15423",1984,"104",12,2,14
"15424",1984,"105",6,2,8
"15425",1984,"106",4,1,5
"15426",1984,"107",0,1,1
"15427",1984,"108",0,0,0
"15428",1984,"109",1,0,1
"15429",1984,"110+",0,0,0
"15430",1985,"0",24416,25628,50044
"15431",1985,"1",24203,25744,49947
"15432",1985,"2",24906,26434,51340
"15433",1985,"3",25139,25953,51092
"15434",1985,"4",24947,26477,51424
"15435",1985,"5",25303,26594,51897
"15436",1985,"6",25379,26710,52089
"15437",1985,"7",25048,26266,51314
"15438",1985,"8",26342,27509,53851
"15439",1985,"9",27803,28856,56659
"15440",1985,"10",29678,30508,60186
"15441",1985,"11",29978,31756,61734
"15442",1985,"12",31554,33084,64638
"15443",1985,"13",32211,33589,65800
"15444",1985,"14",31656,33386,65042
"15445",1985,"15",33129,34854,67983
"15446",1985,"16",32862,34690,67552
"15447",1985,"17",32434,34019,66453
"15448",1985,"18",32399,34352,66751
"15449",1985,"19",32078,33924,66002
"15450",1985,"20",31704,33600,65304
"15451",1985,"21",31040,32043,63083
"15452",1985,"22",30125,31600,61725
"15453",1985,"23",30149,31697,61846
"15454",1985,"24",30053,31314,61367
"15455",1985,"25",30424,32094,62518
"15456",1985,"26",30523,31782,62305
"15457",1985,"27",30395,31732,62127
"15458",1985,"28",31057,32167,63224
"15459",1985,"29",30494,31975,62469
"15460",1985,"30",30253,31363,61616
"15461",1985,"31",30259,31597,61856
"15462",1985,"32",29712,31439,61151
"15463",1985,"33",28497,30641,59138
"15464",1985,"34",29309,31332,60641
"15465",1985,"35",29522,31615,61137
"15466",1985,"36",30220,32565,62785
"15467",1985,"37",31353,33274,64627
"15468",1985,"38",32662,34765,67427
"15469",1985,"39",29425,31187,60612
"15470",1985,"40",28158,30308,58466
"15471",1985,"41",25268,26702,51970
"15472",1985,"42",23423,24479,47902
"15473",1985,"43",20770,21478,42248
"15474",1985,"44",21378,22250,43628
"15475",1985,"45",21059,21463,42522
"15476",1985,"46",20435,20779,41214
"15477",1985,"47",19609,19857,39466
"15478",1985,"48",18861,19277,38138
"15479",1985,"49",18484,18317,36801
"15480",1985,"50",18431,18709,37140
"15481",1985,"51",18316,18813,37129
"15482",1985,"52",19854,19849,39703
"15483",1985,"53",20090,19826,39916
"15484",1985,"54",20512,20555,41067
"15485",1985,"55",20257,20233,40490
"15486",1985,"56",20926,20458,41384
"15487",1985,"57",20847,20402,41249
"15488",1985,"58",22062,21418,43480
"15489",1985,"59",21914,21232,43146
"15490",1985,"60",22911,22132,45043
"15491",1985,"61",23863,22662,46525
"15492",1985,"62",24072,22222,46294
"15493",1985,"63",24432,22061,46493
"15494",1985,"64",26056,23446,49502
"15495",1985,"65",21553,19435,40988
"15496",1985,"66",22858,19737,42595
"15497",1985,"67",22676,19517,42193
"15498",1985,"68",21403,17938,39341
"15499",1985,"69",20987,17285,38272
"15500",1985,"70",20586,16976,37562
"15501",1985,"71",20106,16258,36364
"15502",1985,"72",19847,15598,35445
"15503",1985,"73",18885,14607,33492
"15504",1985,"74",18041,13471,31512
"15505",1985,"75",17735,12796,30531
"15506",1985,"76",16232,11467,27699
"15507",1985,"77",15509,10292,25801
"15508",1985,"78",14565,9462,24027
"15509",1985,"79",13513,8260,21773
"15510",1985,"80",12763,7496,20259
"15511",1985,"81",11754,6827,18581
"15512",1985,"82",10639,6075,16714
"15513",1985,"83",9509,5178,14687
"15514",1985,"84",8478,4365,12843
"15515",1985,"85",7280,3694,10974
"15516",1985,"86",6358,3284,9642
"15517",1985,"87",5285,2573,7858
"15518",1985,"88",4403,2141,6544
"15519",1985,"89",3541,1709,5250
"15520",1985,"90",2834,1285,4119
"15521",1985,"91",2212,982,3194
"15522",1985,"92",1657,735,2392
"15523",1985,"93",1214,526,1740
"15524",1985,"94",845,320,1165
"15525",1985,"95",613,231,844
"15526",1985,"96",411,157,568
"15527",1985,"97",274,129,403
"15528",1985,"98",170,79,249
"15529",1985,"99",116,40,156
"15530",1985,"100",80,31,111
"15531",1985,"101",47,10,57
"15532",1985,"102",28,8,36
"15533",1985,"103",14,3,17
"15534",1985,"104",7,2,9
"15535",1985,"105",6,0,6
"15536",1985,"106",4,2,6
"15537",1985,"107",0,1,1
"15538",1985,"108",0,1,1
"15539",1985,"109",0,0,0
"15540",1985,"110+",0,0,0
"15541",1986,"0",24799,26175,50974
"15542",1986,"1",24606,25768,50374
"15543",1986,"2",24282,25831,50113
"15544",1986,"3",24967,26518,51485
"15545",1986,"4",25197,26041,51238
"15546",1986,"5",24976,26509,51485
"15547",1986,"6",25321,26631,51952
"15548",1986,"7",25409,26743,52152
"15549",1986,"8",25086,26300,51386
"15550",1986,"9",26362,27545,53907
"15551",1986,"10",27824,28887,56711
"15552",1986,"11",29720,30541,60261
"15553",1986,"12",30004,31793,61797
"15554",1986,"13",31586,33130,64716
"15555",1986,"14",32213,33641,65854
"15556",1986,"15",31685,33392,65077
"15557",1986,"16",33171,34879,68050
"15558",1986,"17",32960,34711,67671
"15559",1986,"18",32582,34076,66658
"15560",1986,"19",32566,34414,66980
"15561",1986,"20",32123,33977,66100
"15562",1986,"21",31753,33663,65416
"15563",1986,"22",31117,32089,63206
"15564",1986,"23",30245,31681,61926
"15565",1986,"24",30199,31843,62042
"15566",1986,"25",30157,31428,61585
"15567",1986,"26",30546,32213,62759
"15568",1986,"27",30619,31917,62536
"15569",1986,"28",30481,31886,62367
"15570",1986,"29",31100,32288,63388
"15571",1986,"30",30515,32063,62578
"15572",1986,"31",30280,31430,61710
"15573",1986,"32",30311,31648,61959
"15574",1986,"33",29736,31491,61227
"15575",1986,"34",28544,30704,59248
"15576",1986,"35",29323,31384,60707
"15577",1986,"36",29542,31649,61191
"15578",1986,"37",30220,32613,62833
"15579",1986,"38",31352,33284,64636
"15580",1986,"39",32678,34770,67448
"15581",1986,"40",29431,31151,60582
"15582",1986,"41",28139,30233,58372
"15583",1986,"42",25249,26672,51921
"15584",1986,"43",23387,24478,47865
"15585",1986,"44",20727,21420,42147
"15586",1986,"45",21352,22181,43533
"15587",1986,"46",21026,21412,42438
"15588",1986,"47",20406,20741,41147
"15589",1986,"48",19544,19793,39337
"15590",1986,"49",18808,19197,38005
"15591",1986,"50",18429,18199,36628
"15592",1986,"51",18366,18616,36982
"15593",1986,"52",18253,18704,36957
"15594",1986,"53",19797,19723,39520
"15595",1986,"54",20016,19635,39651
"15596",1986,"55",20431,20365,40796
"15597",1986,"56",20168,20042,40210
"15598",1986,"57",20831,20248,41079
"15599",1986,"58",20725,20153,40878
"15600",1986,"59",21928,21139,43067
"15601",1986,"60",21766,20950,42716
"15602",1986,"61",22750,21795,44545
"15603",1986,"62",23668,22229,45897
"15604",1986,"63",23883,21822,45705
"15605",1986,"64",24210,21580,45790
"15606",1986,"65",25795,22963,48758
"15607",1986,"66",21291,18994,40285
"15608",1986,"67",22591,19187,41778
"15609",1986,"68",22395,18931,41326
"15610",1986,"69",21121,17335,38456
"15611",1986,"70",20624,16640,37264
"15612",1986,"71",20179,16237,36416
"15613",1986,"72",19667,15508,35175
"15614",1986,"73",19363,14871,34234
"15615",1986,"74",18340,13807,32147
"15616",1986,"75",17467,12676,30143
"15617",1986,"76",17089,11949,29038
"15618",1986,"77",15634,10611,26245
"15619",1986,"78",14817,9496,24313
"15620",1986,"79",13843,8607,22450
"15621",1986,"80",12733,7481,20214
"15622",1986,"81",11917,6746,18663
"15623",1986,"82",10875,6121,16996
"15624",1986,"83",9804,5368,15172
"15625",1986,"84",8692,4530,13222
"15626",1986,"85",7662,3757,11419
"15627",1986,"86",6451,3132,9583
"15628",1986,"87",5544,2766,8310
"15629",1986,"88",4565,2121,6686
"15630",1986,"89",3728,1716,5444
"15631",1986,"90",2890,1367,4257
"15632",1986,"91",2314,1004,3318
"15633",1986,"92",1774,760,2534
"15634",1986,"93",1302,538,1840
"15635",1986,"94",950,385,1335
"15636",1986,"95",621,228,849
"15637",1986,"96",437,158,595
"15638",1986,"97",291,103,394
"15639",1986,"98",186,91,277
"15640",1986,"99",117,49,166
"15641",1986,"100",71,24,95
"15642",1986,"101",49,20,69
"15643",1986,"102",30,2,32
"15644",1986,"103",16,5,21
"15645",1986,"104",6,0,6
"15646",1986,"105",4,1,5
"15647",1986,"106",2,0,2
"15648",1986,"107",2,1,3
"15649",1986,"108",0,1,1
"15650",1986,"109",0,1,1
"15651",1986,"110+",0,0,0
"15652",1987,"0",25363,26923,52286
"15653",1987,"1",24907,26230,51137
"15654",1987,"2",24680,25826,50506
"15655",1987,"3",24348,25919,50267
"15656",1987,"4",25038,26565,51603
"15657",1987,"5",25237,26076,51313
"15658",1987,"6",25009,26568,51577
"15659",1987,"7",25361,26672,52033
"15660",1987,"8",25422,26804,52226
"15661",1987,"9",25104,26340,51444
"15662",1987,"10",26389,27582,53971
"15663",1987,"11",27866,28928,56794
"15664",1987,"12",29742,30582,60324
"15665",1987,"13",30042,31806,61848
"15666",1987,"14",31616,33168,64784
"15667",1987,"15",32265,33719,65984
"15668",1987,"16",31739,33446,65185
"15669",1987,"17",33290,34958,68248
"15670",1987,"18",33125,34778,67903
"15671",1987,"19",32736,34111,66847
"15672",1987,"20",32712,34510,67222
"15673",1987,"21",32227,34036,66263
"15674",1987,"22",31867,33726,65593
"15675",1987,"23",31251,32227,63478
"15676",1987,"24",30402,31873,62275
"15677",1987,"25",30353,32003,62356
"15678",1987,"26",30284,31594,61878
"15679",1987,"27",30639,32375,63014
"15680",1987,"28",30740,32080,62820
"15681",1987,"29",30594,32006,62600
"15682",1987,"30",31207,32403,63610
"15683",1987,"31",30595,32140,62735
"15684",1987,"32",30325,31518,61843
"15685",1987,"33",30328,31725,62053
"15686",1987,"34",29778,31538,61316
"15687",1987,"35",28570,30744,59314
"15688",1987,"36",29349,31346,60695
"15689",1987,"37",29532,31626,61158
"15690",1987,"38",30208,32620,62828
"15691",1987,"39",31359,33276,64635
"15692",1987,"40",32661,34731,67392
"15693",1987,"41",29436,31107,60543
"15694",1987,"42",28126,30201,58327
"15695",1987,"43",25259,26640,51899
"15696",1987,"44",23380,24441,47821
"15697",1987,"45",20711,21383,42094
"15698",1987,"46",21330,22132,43462
"15699",1987,"47",20996,21330,42326
"15700",1987,"48",20363,20655,41018
"15701",1987,"49",19496,19706,39202
"15702",1987,"50",18756,19110,37866
"15703",1987,"51",18373,18108,36481
"15704",1987,"52",18304,18513,36817
"15705",1987,"53",18215,18554,36769
"15706",1987,"54",19703,19548,39251
"15707",1987,"55",19942,19486,39428
"15708",1987,"56",20337,20201,40538
"15709",1987,"57",20070,19846,39916
"15710",1987,"58",20686,19981,40667
"15711",1987,"59",20612,19889,40501
"15712",1987,"60",21794,20823,42617
"15713",1987,"61",21611,20611,42222
"15714",1987,"62",22612,21400,44012
"15715",1987,"63",23473,21826,45299
"15716",1987,"64",23648,21363,45011
"15717",1987,"65",23965,21084,45049
"15718",1987,"66",25499,22421,47920
"15719",1987,"67",21037,18459,39496
"15720",1987,"68",22292,18607,40899
"15721",1987,"69",22072,18293,40365
"15722",1987,"70",20779,16707,37486
"15723",1987,"71",20262,16013,36275
"15724",1987,"72",19762,15522,35284
"15725",1987,"73",19203,14753,33956
"15726",1987,"74",18841,14065,32906
"15727",1987,"75",17824,12996,30820
"15728",1987,"76",16897,11874,28771
"15729",1987,"77",16470,11120,27590
"15730",1987,"78",14927,9822,24749
"15731",1987,"79",14133,8705,22838
"15732",1987,"80",13053,7855,20908
"15733",1987,"81",11987,6733,18720
"15734",1987,"82",11099,6037,17136
"15735",1987,"83",10049,5443,15492
"15736",1987,"84",8935,4703,13638
"15737",1987,"85",7901,3909,11810
"15738",1987,"86",6816,3181,9997
"15739",1987,"87",5676,2650,8326
"15740",1987,"88",4845,2309,7154
"15741",1987,"89",3871,1727,5598
"15742",1987,"90",3133,1373,4506
"15743",1987,"91",2360,1066,3426
"15744",1987,"92",1873,776,2649
"15745",1987,"93",1392,568,1960
"15746",1987,"94",1013,394,1407
"15747",1987,"95",729,269,998
"15748",1987,"96",459,148,607
"15749",1987,"97",326,115,441
"15750",1987,"98",204,63,267
"15751",1987,"99",137,63,200
"15752",1987,"100",74,27,101
"15753",1987,"101",53,17,70
"15754",1987,"102",35,12,47
"15755",1987,"103",18,1,19
"15756",1987,"104",10,3,13
"15757",1987,"105",4,0,4
"15758",1987,"106",2,0,2
"15759",1987,"107",1,0,1
"15760",1987,"108",2,1,3
"15761",1987,"109",0,0,0
"15762",1987,"110+",0,1,1
"15763",1988,"0",26488,27394,53882
"15764",1988,"1",25552,27091,52643
"15765",1988,"2",25034,26395,51429
"15766",1988,"3",24824,25923,50747
"15767",1988,"4",24465,26010,50475
"15768",1988,"5",25111,26629,51740
"15769",1988,"6",25336,26165,51501
"15770",1988,"7",25101,26647,51748
"15771",1988,"8",25454,26736,52190
"15772",1988,"9",25466,26873,52339
"15773",1988,"10",25171,26402,51573
"15774",1988,"11",26427,27629,54056
"15775",1988,"12",27906,29011,56917
"15776",1988,"13",29775,30624,60399
"15777",1988,"14",30102,31844,61946
"15778",1988,"15",31676,33217,64893
"15779",1988,"16",32308,33785,66093
"15780",1988,"17",31874,33559,65433
"15781",1988,"18",33441,35110,68551
"15782",1988,"19",33314,35015,68329
"15783",1988,"20",32872,34415,67287
"15784",1988,"21",32794,34844,67638
"15785",1988,"22",32399,34350,66749
"15786",1988,"23",32089,34219,66308
"15787",1988,"24",31453,32712,64165
"15788",1988,"25",30613,32381,62994
"15789",1988,"26",30577,32399,62976
"15790",1988,"27",30438,32069,62507
"15791",1988,"28",30796,32752,63548
"15792",1988,"29",30930,32438,63368
"15793",1988,"30",30730,32287,63017
"15794",1988,"31",31309,32655,63964
"15795",1988,"32",30707,32366,63073
"15796",1988,"33",30406,31730,62136
"15797",1988,"34",30400,31866,62266
"15798",1988,"35",29824,31647,61471
"15799",1988,"36",28586,30838,59424
"15800",1988,"37",29366,31440,60806
"15801",1988,"38",29552,31701,61253
"15802",1988,"39",30226,32654,62880
"15803",1988,"40",31360,33318,64678
"15804",1988,"41",32663,34759,67422
"15805",1988,"42",29419,31082,60501
"15806",1988,"43",28136,30174,58310
"15807",1988,"44",25243,26623,51866
"15808",1988,"45",23361,24392,47753
"15809",1988,"46",20696,21310,42006
"15810",1988,"47",21292,22072,43364
"15811",1988,"48",20973,21260,42233
"15812",1988,"49",20281,20564,40845
"15813",1988,"50",19457,19595,39052
"15814",1988,"51",18694,18977,37671
"15815",1988,"52",18313,17999,36312
"15816",1988,"53",18235,18366,36601
"15817",1988,"54",18176,18415,36591
"15818",1988,"55",19595,19383,38978
"15819",1988,"56",19862,19272,39134
"15820",1988,"57",20236,19984,40220
"15821",1988,"58",19972,19618,39590
"15822",1988,"59",20561,19707,40268
"15823",1988,"60",20479,19604,40083
"15824",1988,"61",21627,20516,42143
"15825",1988,"62",21438,20216,41654
"15826",1988,"63",22445,21004,43449
"15827",1988,"64",23248,21361,44609
"15828",1988,"65",23426,20855,44281
"15829",1988,"66",23706,20571,44277
"15830",1988,"67",25185,21810,46995
"15831",1988,"68",20766,17886,38652
"15832",1988,"69",21922,17985,39907
"15833",1988,"70",21679,17594,39273
"15834",1988,"71",20386,16050,36436
"15835",1988,"72",19853,15262,35115
"15836",1988,"73",19279,14758,34037
"15837",1988,"74",18686,13997,32683
"15838",1988,"75",18231,13252,31483
"15839",1988,"76",17239,12196,29435
"15840",1988,"77",16267,11064,27331
"15841",1988,"78",15723,10286,26009
"15842",1988,"79",14209,8985,23194
"15843",1988,"80",13354,7887,21241
"15844",1988,"81",12239,7114,19353
"15845",1988,"82",11166,6003,17169
"15846",1988,"83",10237,5331,15568
"15847",1988,"84",9183,4724,13907
"15848",1988,"85",8080,4050,12130
"15849",1988,"86",7068,3346,10414
"15850",1988,"87",6005,2616,8621
"15851",1988,"88",4888,2189,7077
"15852",1988,"89",4139,1888,6027
"15853",1988,"90",3230,1405,4635
"15854",1988,"91",2561,1083,3644
"15855",1988,"92",1922,787,2709
"15856",1988,"93",1472,583,2055
"15857",1988,"94",1073,418,1491
"15858",1988,"95",767,283,1050
"15859",1988,"96",543,183,726
"15860",1988,"97",334,97,431
"15861",1988,"98",229,76,305
"15862",1988,"99",135,36,171
"15863",1988,"100",93,34,127
"15864",1988,"101",54,18,72
"15865",1988,"102",35,9,44
"15866",1988,"103",25,6,31
"15867",1988,"104",11,0,11
"15868",1988,"105",5,2,7
"15869",1988,"106",3,0,3
"15870",1988,"107",0,0,0
"15871",1988,"108",1,0,1
"15872",1988,"109",2,0,2
"15873",1988,"110+",0,0,0
"15874",1989,"0",27948,29332,57280
"15875",1989,"1",26634,27531,54165
"15876",1989,"2",25668,27267,52935
"15877",1989,"3",25147,26471,51618
"15878",1989,"4",24920,26049,50969
"15879",1989,"5",24553,26126,50679
"15880",1989,"6",25166,26714,51880
"15881",1989,"7",25438,26278,51716
"15882",1989,"8",25172,26712,51884
"15883",1989,"9",25507,26799,52306
"15884",1989,"10",25519,26946,52465
"15885",1989,"11",25233,26450,51683
"15886",1989,"12",26470,27674,54144
"15887",1989,"13",27951,29061,57012
"15888",1989,"14",29815,30676,60491
"15889",1989,"15",30136,31896,62032
"15890",1989,"16",31738,33223,64961
"15891",1989,"17",32424,33823,66247
"15892",1989,"18",32032,33572,65604
"15893",1989,"19",33563,35227,68790
"15894",1989,"20",33436,35160,68596
"15895",1989,"21",32963,34532,67495
"15896",1989,"22",32916,35036,67952
"15897",1989,"23",32517,34703,67220
"15898",1989,"24",32246,34538,66784
"15899",1989,"25",31596,33039,64635
"15900",1989,"26",30765,32748,63513
"15901",1989,"27",30785,32712,63497
"15902",1989,"28",30600,32401,63001
"15903",1989,"29",30916,32941,63857
"15904",1989,"30",31037,32609,63646
"15905",1989,"31",30845,32447,63292
"15906",1989,"32",31372,32780,64152
"15907",1989,"33",30751,32508,63259
"15908",1989,"34",30475,31790,62265
"15909",1989,"35",30441,31924,62365
"15910",1989,"36",29827,31731,61558
"15911",1989,"37",28589,30862,59451
"15912",1989,"38",29408,31469,60877
"15913",1989,"39",29564,31707,61271
"15914",1989,"40",30234,32658,62892
"15915",1989,"41",31316,33288,64604
"15916",1989,"42",32609,34727,67336
"15917",1989,"43",29375,31024,60399
"15918",1989,"44",28122,30097,58219
"15919",1989,"45",25218,26561,51779
"15920",1989,"46",23311,24298,47609
"15921",1989,"47",20632,21257,41889
"15922",1989,"48",21246,21984,43230
"15923",1989,"49",20940,21185,42125
"15924",1989,"50",20237,20458,40695
"15925",1989,"51",19411,19488,38899
"15926",1989,"52",18641,18873,37514
"15927",1989,"53",18258,17876,36134
"15928",1989,"54",18167,18225,36392
"15929",1989,"55",18107,18262,36369
"15930",1989,"56",19514,19208,38722
"15931",1989,"57",19773,19074,38847
"15932",1989,"58",20124,19730,39854
"15933",1989,"59",19841,19387,39228
"15934",1989,"60",20417,19422,39839
"15935",1989,"61",20320,19283,39603
"15936",1989,"62",21453,20148,41601
"15937",1989,"63",21248,19849,41097
"15938",1989,"64",22249,20558,42807
"15939",1989,"65",23006,20876,43882
"15940",1989,"66",23164,20366,43530
"15941",1989,"67",23421,20029,43450
"15942",1989,"68",24850,21177,46027
"15943",1989,"69",20456,17349,37805
"15944",1989,"70",21524,17341,38865
"15945",1989,"71",21252,16922,38174
"15946",1989,"72",19977,15351,35328
"15947",1989,"73",19407,14541,33948
"15948",1989,"74",18728,13974,32702
"15949",1989,"75",18111,13189,31300
"15950",1989,"76",17610,12350,29960
"15951",1989,"77",16613,11369,27982
"15952",1989,"78",15584,10227,25811
"15953",1989,"79",14971,9451,24422
"15954",1989,"80",13452,8152,21604
"15955",1989,"81",12494,7132,19626
"15956",1989,"82",11407,6329,17736
"15957",1989,"83",10292,5304,15596
"15958",1989,"84",9338,4687,14025
"15959",1989,"85",8262,4123,12385
"15960",1989,"86",7139,3425,10564
"15961",1989,"87",6231,2801,9032
"15962",1989,"88",5187,2118,7305
"15963",1989,"89",4110,1763,5873
"15964",1989,"90",3453,1526,4979
"15965",1989,"91",2632,1110,3742
"15966",1989,"92",2064,830,2894
"15967",1989,"93",1506,603,2109
"15968",1989,"94",1132,427,1559
"15969",1989,"95",805,287,1092
"15970",1989,"96",543,211,754
"15971",1989,"97",367,132,499
"15972",1989,"98",225,57,282
"15973",1989,"99",153,52,205
"15974",1989,"100",86,28,114
"15975",1989,"101",61,21,82
"15976",1989,"102",27,13,40
"15977",1989,"103",23,3,26
"15978",1989,"104",13,3,16
"15979",1989,"105",5,0,5
"15980",1989,"106",2,2,4
"15981",1989,"107",1,0,1
"15982",1989,"108",0,0,0
"15983",1989,"109",1,0,1
"15984",1989,"110+",2,0,2
"15985",1990,"0",28733,30325,59058
"15986",1990,"1",27988,29434,57422
"15987",1990,"2",26670,27599,54269
"15988",1990,"3",25714,27295,53009
"15989",1990,"4",25175,26520,51695
"15990",1990,"5",24912,26086,50998
"15991",1990,"6",24573,26145,50718
"15992",1990,"7",25238,26742,51980
"15993",1990,"8",25463,26325,51788
"15994",1990,"9",25234,26781,52015
"15995",1990,"10",25552,26825,52377
"15996",1990,"11",25562,26978,52540
"15997",1990,"12",25256,26489,51745
"15998",1990,"13",26485,27724,54209
"15999",1990,"14",27968,29121,57089
"16000",1990,"15",29851,30746,60597
"16001",1990,"16",30166,31921,62087
"16002",1990,"17",31819,33269,65088
"16003",1990,"18",32391,33717,66108
"16004",1990,"19",31853,33324,65177
"16005",1990,"20",33373,35107,68480
"16006",1990,"21",33189,34974,68163
"16007",1990,"22",32863,34256,67119
"16008",1990,"23",32833,34855,67688
"16009",1990,"24",32506,34573,67079
"16010",1990,"25",32246,34465,66711
"16011",1990,"26",31625,33024,64649
"16012",1990,"27",30791,32705,63496
"16013",1990,"28",30803,32634,63437
"16014",1990,"29",30608,32349,62957
"16015",1990,"30",30898,32922,63820
"16016",1990,"31",31020,32577,63597
"16017",1990,"32",30818,32328,63146
"16018",1990,"33",31372,32647,64019
"16019",1990,"34",30786,32421,63207
"16020",1990,"35",30416,31704,62120
"16021",1990,"36",30422,31784,62206
"16022",1990,"37",29800,31648,61448
"16023",1990,"38",28531,30731,59262
"16024",1990,"39",29360,31331,60691
"16025",1990,"40",29518,31554,61072
"16026",1990,"41",30166,32495,62661
"16027",1990,"42",31288,33146,64434
"16028",1990,"43",32570,34541,67111
"16029",1990,"44",29279,30854,60133
"16030",1990,"45",28056,29937,57993
"16031",1990,"46",25180,26411,51591
"16032",1990,"47",23273,24145,47418
"16033",1990,"48",20571,21115,41686
"16034",1990,"49",21179,21842,43021
"16035",1990,"50",20861,21042,41903
"16036",1990,"51",20184,20322,40506
"16037",1990,"52",19336,19356,38692
"16038",1990,"53",18594,18736,37330
"16039",1990,"54",18201,17695,35896
"16040",1990,"55",18085,18045,36130
"16041",1990,"56",18028,18073,36101
"16042",1990,"57",19406,19008,38414
"16043",1990,"58",19642,18867,38509
"16044",1990,"59",20006,19473,39479
"16045",1990,"60",19709,19108,38817
"16046",1990,"61",20272,19129,39401
"16047",1990,"62",20146,18958,39104
"16048",1990,"63",21275,19792,41067
"16049",1990,"64",21051,19443,40494
"16050",1990,"65",22027,20079,42106
"16051",1990,"66",22788,20422,43210
"16052",1990,"67",22884,19796,42680
"16053",1990,"68",23135,19424,42559
"16054",1990,"69",24463,20509,44972
"16055",1990,"70",20121,16759,36880
"16056",1990,"71",21142,16672,37814
"16057",1990,"72",20847,16222,37069
"16058",1990,"73",19531,14600,34131
"16059",1990,"74",18884,13796,32680
"16060",1990,"75",18183,13249,31432
"16061",1990,"76",17505,12393,29898
"16062",1990,"77",16968,11600,28568
"16063",1990,"78",15875,10528,26403
"16064",1990,"79",14857,9351,24208
"16065",1990,"80",14211,8617,22828
"16066",1990,"81",12652,7316,19968
"16067",1990,"82",11712,6394,18106
"16068",1990,"83",10503,5570,16073
"16069",1990,"84",9379,4616,13995
"16070",1990,"85",8424,4060,12484
"16071",1990,"86",7362,3547,10909
"16072",1990,"87",6247,2870,9117
"16073",1990,"88",5409,2327,7736
"16074",1990,"89",4380,1697,6077
"16075",1990,"90",3388,1399,4787
"16076",1990,"91",2832,1185,4017
"16077",1990,"92",2109,854,2963
"16078",1990,"93",1589,607,2196
"16079",1990,"94",1165,464,1629
"16080",1990,"95",848,309,1157
"16081",1990,"96",585,192,777
"16082",1990,"97",375,146,521
"16083",1990,"98",255,80,335
"16084",1990,"99",146,30,176
"16085",1990,"100",96,35,131
"16086",1990,"101",59,16,75
"16087",1990,"102",39,10,49
"16088",1990,"103",11,6,17
"16089",1990,"104",13,2,15
"16090",1990,"105",5,1,6
"16091",1990,"106",2,0,2
"16092",1990,"107",0,0,0
"16093",1990,"108",0,0,0
"16094",1990,"109",0,0,0
"16095",1990,"110+",0,0,0
"16096",1991,"0",29570,31120,60690
"16097",1991,"1",28822,30387,59209
"16098",1991,"2",28014,29520,57534
"16099",1991,"3",26684,27635,54319
"16100",1991,"4",25741,27368,53109
"16101",1991,"5",25233,26554,51787
"16102",1991,"6",24948,26126,51074
"16103",1991,"7",24632,26169,50801
"16104",1991,"8",25255,26796,52051
"16105",1991,"9",25495,26365,51860
"16106",1991,"10",25266,26800,52066
"16107",1991,"11",25598,26850,52448
"16108",1991,"12",25613,27032,52645
"16109",1991,"13",25293,26528,51821
"16110",1991,"14",26541,27758,54299
"16111",1991,"15",27995,29178,57173
"16112",1991,"16",29897,30789,60686
"16113",1991,"17",30281,31989,62270
"16114",1991,"18",31883,33291,65174
"16115",1991,"19",32401,33698,66099
"16116",1991,"20",31886,33381,65267
"16117",1991,"21",33397,35130,68527
"16118",1991,"22",33265,34982,68247
"16119",1991,"23",32876,34262,67138
"16120",1991,"24",32856,34912,67768
"16121",1991,"25",32543,34602,67145
"16122",1991,"26",32318,34394,66712
"16123",1991,"27",31643,33066,64709
"16124",1991,"28",30802,32728,63530
"16125",1991,"29",30840,32582,63422
"16126",1991,"30",30640,32288,62928
"16127",1991,"31",30910,32855,63765
"16128",1991,"32",31002,32492,63494
"16129",1991,"33",30776,32234,63010
"16130",1991,"34",31369,32566,63935
"16131",1991,"35",30796,32315,63111
"16132",1991,"36",30395,31625,62020
"16133",1991,"37",30388,31652,62040
"16134",1991,"38",29806,31528,61334
"16135",1991,"39",28509,30609,59118
"16136",1991,"40",29314,31223,60537
"16137",1991,"41",29453,31443,60896
"16138",1991,"42",30122,32350,62472
"16139",1991,"43",31239,33000,64239
"16140",1991,"44",32510,34404,66914
"16141",1991,"45",29238,30722,59960
"16142",1991,"46",27966,29735,57701
"16143",1991,"47",25101,26281,51382
"16144",1991,"48",23206,24040,47246
"16145",1991,"49",20516,20995,41511
"16146",1991,"50",21134,21691,42825
"16147",1991,"51",20809,20922,41731
"16148",1991,"52",20121,20179,40300
"16149",1991,"53",19282,19217,38499
"16150",1991,"54",18521,18604,37125
"16151",1991,"55",18121,17533,35654
"16152",1991,"56",17996,17846,35842
"16153",1991,"57",17953,17876,35829
"16154",1991,"58",19316,18798,38114
"16155",1991,"59",19541,18634,38175
"16156",1991,"60",19891,19236,39127
"16157",1991,"61",19560,18848,38408
"16158",1991,"62",20121,18820,38941
"16159",1991,"63",20012,18608,38620
"16160",1991,"64",21062,19426,40488
"16161",1991,"65",20811,19019,39830
"16162",1991,"66",21797,19613,41410
"16163",1991,"67",22521,19911,42432
"16164",1991,"68",22587,19200,41787
"16165",1991,"69",22802,18826,41628
"16166",1991,"70",24067,19786,43853
"16167",1991,"71",19748,16135,35883
"16168",1991,"72",20667,15938,36605
"16169",1991,"73",20356,15485,35841
"16170",1991,"74",19016,13834,32850
"16171",1991,"75",18297,13000,31297
"16172",1991,"76",17580,12443,30023
"16173",1991,"77",16845,11536,28381
"16174",1991,"78",16173,10747,26920
"16175",1991,"79",15117,9677,24794
"16176",1991,"80",14030,8522,22552
"16177",1991,"81",13368,7771,21139
"16178",1991,"82",11769,6506,18275
"16179",1991,"83",10813,5678,16491
"16180",1991,"84",9558,4845,14403
"16181",1991,"85",8434,4008,12442
"16182",1991,"86",7500,3430,10930
"16183",1991,"87",6489,2981,9470
"16184",1991,"88",5427,2356,7783
"16185",1991,"89",4564,1867,6431
"16186",1991,"90",3637,1346,4983
"16187",1991,"91",2790,1084,3874
"16188",1991,"92",2270,886,3156
"16189",1991,"93",1656,622,2278
"16190",1991,"94",1215,426,1641
"16191",1991,"95",843,324,1167
"16192",1991,"96",618,213,831
"16193",1991,"97",400,129,529
"16194",1991,"98",269,93,362
"16195",1991,"99",182,51,233
"16196",1991,"100",103,19,122
"16197",1991,"101",68,22,90
"16198",1991,"102",33,13,46
"16199",1991,"103",21,4,25
"16200",1991,"104",6,2,8
"16201",1991,"105",8,1,9
"16202",1991,"106",2,0,2
"16203",1991,"107",2,0,2
"16204",1991,"108",0,0,0
"16205",1991,"109",0,0,0
"16206",1991,"110+",0,0,0
"16207",1992,"0",29452,31170,60622
"16208",1992,"1",29720,31234,60954
"16209",1992,"2",28909,30496,59405
"16210",1992,"3",28098,29608,57706
"16211",1992,"4",26756,27702,54458
"16212",1992,"5",25838,27440,53278
"16213",1992,"6",25271,26599,51870
"16214",1992,"7",25038,26183,51221
"16215",1992,"8",24702,26244,50946
"16216",1992,"9",25323,26846,52169
"16217",1992,"10",25535,26425,51960
"16218",1992,"11",25294,26866,52160
"16219",1992,"12",25622,26918,52540
"16220",1992,"13",25647,27067,52714
"16221",1992,"14",25347,26570,51917
"16222",1992,"15",26587,27818,54405
"16223",1992,"16",28048,29246,57294
"16224",1992,"17",30018,30887,60905
"16225",1992,"18",30436,32083,62519
"16226",1992,"19",31923,33378,65301
"16227",1992,"20",32531,33869,66400
"16228",1992,"21",32047,33541,65588
"16229",1992,"22",33539,35253,68792
"16230",1992,"23",33409,35221,68630
"16231",1992,"24",33020,34472,67492
"16232",1992,"25",33011,35136,68147
"16233",1992,"26",32652,34825,67477
"16234",1992,"27",32427,34539,66966
"16235",1992,"28",31720,33147,64867
"16236",1992,"29",30900,32867,63767
"16237",1992,"30",30864,32660,63524
"16238",1992,"31",30699,32383,63082
"16239",1992,"32",30927,32919,63846
"16240",1992,"33",31030,32568,63598
"16241",1992,"34",30820,32240,63060
"16242",1992,"35",31404,32557,63961
"16243",1992,"36",30824,32333,63157
"16244",1992,"37",30382,31594,61976
"16245",1992,"38",30362,31610,61972
"16246",1992,"39",29797,31520,61317
"16247",1992,"40",28505,30544,59049
"16248",1992,"41",29322,31181,60503
"16249",1992,"42",29473,31401,60874
"16250",1992,"43",30097,32257,62354
"16251",1992,"44",31190,32923,64113
"16252",1992,"45",32481,34285,66766
"16253",1992,"46",29227,30640,59867
"16254",1992,"47",27915,29650,57565
"16255",1992,"48",25056,26171,51227
"16256",1992,"49",23168,23921,47089
"16257",1992,"50",20471,20882,41353
"16258",1992,"51",21072,21592,42664
"16259",1992,"52",20745,20791,41536
"16260",1992,"53",20070,20025,40095
"16261",1992,"54",19226,19075,38301
"16262",1992,"55",18475,18483,36958
"16263",1992,"56",18056,17396,35452
"16264",1992,"57",17918,17645,35563
"16265",1992,"58",17853,17674,35527
"16266",1992,"59",19223,18604,37827
"16267",1992,"60",19421,18396,37817
"16268",1992,"61",19767,18976,38743
"16269",1992,"62",19423,18550,37973
"16270",1992,"63",19964,18515,38479
"16271",1992,"64",19838,18281,38119
"16272",1992,"65",20857,19000,39857
"16273",1992,"66",20601,18623,39224
"16274",1992,"67",21568,19123,40691
"16275",1992,"68",22211,19362,41573
"16276",1992,"69",22248,18596,40844
"16277",1992,"70",22442,18196,40638
"16278",1992,"71",23641,19036,42677
"16279",1992,"72",19365,15467,34832
"16280",1992,"73",20191,15274,35465
"16281",1992,"74",19840,14735,34575
"16282",1992,"75",18495,13138,31633
"16283",1992,"76",17718,12205,29923
"16284",1992,"77",16921,11619,28540
"16285",1992,"78",16150,10696,26846
"16286",1992,"79",15425,9875,25300
"16287",1992,"80",14290,8854,23144
"16288",1992,"81",13250,7728,20978
"16289",1992,"82",12420,6931,19351
"16290",1992,"83",10854,5772,16626
"16291",1992,"84",9959,4917,14876
"16292",1992,"85",8645,4223,12868
"16293",1992,"86",7597,3398,10995
"16294",1992,"87",6606,2876,9482
"16295",1992,"88",5630,2472,8102
"16296",1992,"89",4649,1902,6551
"16297",1992,"90",3806,1496,5302
"16298",1992,"91",2970,1063,4033
"16299",1992,"92",2232,818,3050
"16300",1992,"93",1756,661,2417
"16301",1992,"94",1254,458,1712
"16302",1992,"95",917,295,1212
"16303",1992,"96",616,236,852
"16304",1992,"97",446,154,600
"16305",1992,"98",275,91,366
"16306",1992,"99",187,56,243
"16307",1992,"100",122,28,150
"16308",1992,"101",63,12,75
"16309",1992,"102",41,11,52
"16310",1992,"103",18,8,26
"16311",1992,"104",9,1,10
"16312",1992,"105",4,0,4
"16313",1992,"106",6,1,7
"16314",1992,"107",2,0,2
"16315",1992,"108",1,0,1
"16316",1992,"109",0,0,0
"16317",1992,"110+",0,0,0
"16318",1993,"0",28932,31055,59987
"16319",1993,"1",29659,31410,61069
"16320",1993,"2",29858,31399,61257
"16321",1993,"3",29002,30600,59602
"16322",1993,"4",28222,29700,57922
"16323",1993,"5",26841,27814,54655
"16324",1993,"6",25938,27538,53476
"16325",1993,"7",25360,26725,52085
"16326",1993,"8",25119,26292,51411
"16327",1993,"9",24782,26328,51110
"16328",1993,"10",25405,26908,52313
"16329",1993,"11",25610,26505,52115
"16330",1993,"12",25379,26922,52301
"16331",1993,"13",25661,26964,52625
"16332",1993,"14",25691,27107,52798
"16333",1993,"15",25415,26610,52025
"16334",1993,"16",26653,27882,54535
"16335",1993,"17",28155,29319,57474
"16336",1993,"18",30134,30990,61124
"16337",1993,"19",30478,32134,62612
"16338",1993,"20",32084,33466,65550
"16339",1993,"21",32666,33959,66625
"16340",1993,"22",32184,33646,65830
"16341",1993,"23",33750,35400,69150
"16342",1993,"24",33625,35391,69016
"16343",1993,"25",33208,34635,67843
"16344",1993,"26",33204,35317,68521
"16345",1993,"27",32830,34979,67809
"16346",1993,"28",32568,34750,67318
"16347",1993,"29",31853,33269,65122
"16348",1993,"30",31089,32966,64055
"16349",1993,"31",30957,32786,63743
"16350",1993,"32",30767,32493,63260
"16351",1993,"33",30984,32957,63941
"16352",1993,"34",31076,32609,63685
"16353",1993,"35",30894,32244,63138
"16354",1993,"36",31441,32615,64056
"16355",1993,"37",30855,32345,63200
"16356",1993,"38",30432,31606,62038
"16357",1993,"39",30389,31620,62009
"16358",1993,"40",29786,31481,61267
"16359",1993,"41",28515,30523,59038
"16360",1993,"42",29340,31134,60474
"16361",1993,"43",29462,31344,60806
"16362",1993,"44",30088,32214,62302
"16363",1993,"45",31183,32847,64030
"16364",1993,"46",32443,34206,66649
"16365",1993,"47",29194,30534,59728
"16366",1993,"48",27886,29552,57438
"16367",1993,"49",25046,26062,51108
"16368",1993,"50",23141,23830,46971
"16369",1993,"51",20424,20767,41191
"16370",1993,"52",21061,21476,42537
"16371",1993,"53",20679,20696,41375
"16372",1993,"54",20012,19910,39922
"16373",1993,"55",19157,18948,38105
"16374",1993,"56",18411,18348,36759
"16375",1993,"57",17978,17251,35229
"16376",1993,"58",17818,17447,35265
"16377",1993,"59",17764,17480,35244
"16378",1993,"60",19114,18374,37488
"16379",1993,"61",19296,18157,37453
"16380",1993,"62",19629,18685,38314
"16381",1993,"63",19282,18254,37536
"16382",1993,"64",19780,18153,37933
"16383",1993,"65",19651,17931,37582
"16384",1993,"66",20640,18605,39245
"16385",1993,"67",20363,18178,38541
"16386",1993,"68",21286,18660,39946
"16387",1993,"69",21909,18799,40708
"16388",1993,"70",21899,18000,39899
"16389",1993,"71",22081,17555,39636
"16390",1993,"72",23187,18273,41460
"16391",1993,"73",18943,14795,33738
"16392",1993,"74",19682,14522,34204
"16393",1993,"75",19266,13954,33220
"16394",1993,"76",17933,12323,30256
"16395",1993,"77",17075,11446,28521
"16396",1993,"78",16229,10783,27012
"16397",1993,"79",15431,9885,25316
"16398",1993,"80",14663,9029,23692
"16399",1993,"81",13454,8009,21463
"16400",1993,"82",12374,6912,19286
"16401",1993,"83",11506,6130,17636
"16402",1993,"84",9993,5045,15038
"16403",1993,"85",9025,4264,13289
"16404",1993,"86",7753,3588,11341
"16405",1993,"87",6702,2859,9561
"16406",1993,"88",5728,2373,8101
"16407",1993,"89",4807,2026,6833
"16408",1993,"90",3846,1526,5372
"16409",1993,"91",3153,1127,4280
"16410",1993,"92",2388,798,3186
"16411",1993,"93",1793,611,2404
"16412",1993,"94",1368,488,1856
"16413",1993,"95",987,344,1331
"16414",1993,"96",673,210,883
"16415",1993,"97",439,159,598
"16416",1993,"98",314,99,413
"16417",1993,"99",172,60,232
"16418",1993,"100",120,35,155
"16419",1993,"101",79,12,91
"16420",1993,"102",43,6,49
"16421",1993,"103",26,11,37
"16422",1993,"104",12,2,14
"16423",1993,"105",3,1,4
"16424",1993,"106",2,0,2
"16425",1993,"107",5,0,5
"16426",1993,"108",0,0,0
"16427",1993,"109",1,0,1
"16428",1993,"110+",0,0,0
"16429",1994,"0",29106,30500,59606
"16430",1994,"1",29180,31308,60488
"16431",1994,"2",29884,31620,61504
"16432",1994,"3",30039,31540,61579
"16433",1994,"4",29143,30785,59928
"16434",1994,"5",28377,29850,58227
"16435",1994,"6",27011,27969,54980
"16436",1994,"7",26044,27671,53715
"16437",1994,"8",25486,26857,52343
"16438",1994,"9",25229,26429,51658
"16439",1994,"10",24900,26446,51346
"16440",1994,"11",25532,27015,52547
"16441",1994,"12",25709,26596,52305
"16442",1994,"13",25506,27057,52563
"16443",1994,"14",25743,27031,52774
"16444",1994,"15",25783,27215,52998
"16445",1994,"16",25552,26747,52299
"16446",1994,"17",26840,28023,54863
"16447",1994,"18",28372,29449,57821
"16448",1994,"19",30223,31070,61293
"16449",1994,"20",30660,32226,62886
"16450",1994,"21",32227,33526,65753
"16451",1994,"22",32888,34038,66926
"16452",1994,"23",32411,33804,66215
"16453",1994,"24",33964,35521,69485
"16454",1994,"25",33835,35564,69399
"16455",1994,"26",33378,34809,68187
"16456",1994,"27",33365,35476,68841
"16457",1994,"28",32985,35040,68025
"16458",1994,"29",32689,34814,67503
"16459",1994,"30",31983,33303,65286
"16460",1994,"31",31195,33016,64211
"16461",1994,"32",31068,32818,63886
"16462",1994,"33",30853,32470,63323
"16463",1994,"34",31092,32964,64056
"16464",1994,"35",31191,32619,63810
"16465",1994,"36",30974,32253,63227
"16466",1994,"37",31534,32638,64172
"16467",1994,"38",30917,32284,63201
"16468",1994,"39",30504,31601,62105
"16469",1994,"40",30436,31589,62025
"16470",1994,"41",29818,31462,61280
"16471",1994,"42",28566,30488,59054
"16472",1994,"43",29412,31085,60497
"16473",1994,"44",29526,31311,60837
"16474",1994,"45",30113,32168,62281
"16475",1994,"46",31186,32764,63950
"16476",1994,"47",32447,34096,66543
"16477",1994,"48",29195,30458,59653
"16478",1994,"49",27873,29475,57348
"16479",1994,"50",25025,25990,51015
"16480",1994,"51",23091,23724,46815
"16481",1994,"52",20390,20701,41091
"16482",1994,"53",21029,21396,42425
"16483",1994,"54",20638,20571,41209
"16484",1994,"55",19955,19810,39765
"16485",1994,"56",19092,18823,37915
"16486",1994,"57",18350,18214,36564
"16487",1994,"58",17908,17101,35009
"16488",1994,"59",17750,17258,35008
"16489",1994,"60",17668,17297,34965
"16490",1994,"61",18997,18130,37127
"16491",1994,"62",19190,17876,37066
"16492",1994,"63",19479,18403,37882
"16493",1994,"64",19111,17943,37054
"16494",1994,"65",19612,17775,37387
"16495",1994,"66",19430,17535,36965
"16496",1994,"67",20391,18199,38590
"16497",1994,"68",20123,17718,37841
"16498",1994,"69",20976,18086,39062
"16499",1994,"70",21573,18188,39761
"16500",1994,"71",21523,17328,38851
"16501",1994,"72",21646,16828,38474
"16502",1994,"73",22686,17406,40092
"16503",1994,"74",18461,14039,32500
"16504",1994,"75",19141,13762,32903
"16505",1994,"76",18648,13079,31727
"16506",1994,"77",17279,11572,28851
"16507",1994,"78",16361,10640,27001
"16508",1994,"79",15470,9923,25393
"16509",1994,"80",14551,8982,23533
"16510",1994,"81",13770,8152,21922
"16511",1994,"82",12574,7167,19741
"16512",1994,"83",11410,6129,17539
"16513",1994,"84",10561,5362,15923
"16514",1994,"85",9023,4302,13325
"16515",1994,"86",8034,3564,11598
"16516",1994,"87",6817,2973,9790
"16517",1994,"88",5751,2324,8075
"16518",1994,"89",4853,1905,6758
"16519",1994,"90",3964,1612,5576
"16520",1994,"91",3172,1183,4355
"16521",1994,"92",2479,819,3298
"16522",1994,"93",1854,559,2413
"16523",1994,"94",1342,415,1757
"16524",1994,"95",990,335,1325
"16525",1994,"96",675,237,912
"16526",1994,"97",480,147,627
"16527",1994,"98",294,108,402
"16528",1994,"99",222,61,283
"16529",1994,"100",125,37,162
"16530",1994,"101",73,21,94
"16531",1994,"102",46,5,51
"16532",1994,"103",25,3,28
"16533",1994,"104",18,6,24
"16534",1994,"105",6,1,7
"16535",1994,"106",2,1,3
"16536",1994,"107",2,0,2
"16537",1994,"108",2,0,2
"16538",1994,"109",0,0,0
"16539",1994,"110+",0,0,0
"16540",1995,"0",29053,30842,59895
"16541",1995,"1",29259,30630,59889
"16542",1995,"2",29299,31432,60731
"16543",1995,"3",29972,31723,61695
"16544",1995,"4",30076,31640,61716
"16545",1995,"5",29223,30850,60073
"16546",1995,"6",28418,29910,58328
"16547",1995,"7",27064,28027,55091
"16548",1995,"8",26066,27755,53821
"16549",1995,"9",25550,26908,52458
"16550",1995,"10",25308,26493,51801
"16551",1995,"11",24943,26510,51453
"16552",1995,"12",25568,27076,52644
"16553",1995,"13",25761,26642,52403
"16554",1995,"14",25568,27109,52677
"16555",1995,"15",25827,27100,52927
"16556",1995,"16",25832,27248,53080
"16557",1995,"17",25711,26810,52521
"16558",1995,"18",26953,28085,55038
"16559",1995,"19",28405,29488,57893
"16560",1995,"20",30397,31083,61480
"16561",1995,"21",30746,32214,62960
"16562",1995,"22",32399,33535,65934
"16563",1995,"23",33052,34103,67155
"16564",1995,"24",32608,33885,66493
"16565",1995,"25",34117,35592,69709
"16566",1995,"26",33965,35627,69592
"16567",1995,"27",33487,34861,68348
"16568",1995,"28",33466,35550,69016
"16569",1995,"29",33092,35107,68199
"16570",1995,"30",32794,34838,67632
"16571",1995,"31",32083,33339,65422
"16572",1995,"32",31269,33029,64298
"16573",1995,"33",31153,32794,63947
"16574",1995,"34",30928,32419,63347
"16575",1995,"35",31127,32967,64094
"16576",1995,"36",31217,32613,63830
"16577",1995,"37",31032,32233,63265
"16578",1995,"38",31557,32639,64196
"16579",1995,"39",30944,32272,63216
"16580",1995,"40",30560,31596,62156
"16581",1995,"41",30467,31564,62031
"16582",1995,"42",29853,31417,61270
"16583",1995,"43",28571,30452,59023
"16584",1995,"44",29385,31039,60424
"16585",1995,"45",29530,31262,60792
"16586",1995,"46",30080,32093,62173
"16587",1995,"47",31139,32656,63795
"16588",1995,"48",32378,34021,66399
"16589",1995,"49",29121,30326,59447
"16590",1995,"50",27808,29379,57187
"16591",1995,"51",24965,25847,50812
"16592",1995,"52",23046,23600,46646
"16593",1995,"53",20363,20586,40949
"16594",1995,"54",20972,21306,42278
"16595",1995,"55",20601,20434,41035
"16596",1995,"56",19891,19671,39562
"16597",1995,"57",19024,18680,37704
"16598",1995,"58",18257,18068,36325
"16599",1995,"59",17818,16944,34762
"16600",1995,"60",17656,17039,34695
"16601",1995,"61",17574,17091,34665
"16602",1995,"62",18866,17903,36769
"16603",1995,"63",19059,17631,36690
"16604",1995,"64",19334,18086,37420
"16605",1995,"65",18954,17585,36539
"16606",1995,"66",19410,17399,36809
"16607",1995,"67",19219,17096,36315
"16608",1995,"68",20167,17753,37920
"16609",1995,"69",19853,17211,37064
"16610",1995,"70",20665,17525,38190
"16611",1995,"71",21164,17552,38716
"16612",1995,"72",21148,16687,37835
"16613",1995,"73",21186,16115,37301
"16614",1995,"74",22166,16642,38808
"16615",1995,"75",17958,13325,31283
"16616",1995,"76",18518,13005,31523
"16617",1995,"77",18048,12275,30323
"16618",1995,"78",16683,10787,27470
"16619",1995,"79",15685,9873,25558
"16620",1995,"80",14717,9103,23820
"16621",1995,"81",13764,8174,21938
"16622",1995,"82",12918,7334,20252
"16623",1995,"83",11672,6347,18019
"16624",1995,"84",10524,5370,15894
"16625",1995,"85",9593,4662,14255
"16626",1995,"86",8120,3719,11839
"16627",1995,"87",7098,3008,10106
"16628",1995,"88",5948,2451,8399
"16629",1995,"89",4925,1888,6813
"16630",1995,"90",4079,1550,5629
"16631",1995,"91",3257,1274,4531
"16632",1995,"92",2593,921,3514
"16633",1995,"93",1960,610,2570
"16634",1995,"94",1390,389,1779
"16635",1995,"95",981,271,1252
"16636",1995,"96",711,234,945
"16637",1995,"97",495,158,653
"16638",1995,"98",324,97,421
"16639",1995,"99",203,65,268
"16640",1995,"100",142,34,176
"16641",1995,"101",76,26,102
"16642",1995,"102",45,11,56
"16643",1995,"103",31,3,34
"16644",1995,"104",15,1,16
"16645",1995,"105",9,2,11
"16646",1995,"106",4,1,5
"16647",1995,"107",1,0,1
"16648",1995,"108",1,0,1
"16649",1995,"109",0,0,0
"16650",1995,"110+",0,0,0
"16651",1996,"0",29263,30940,60203
"16652",1996,"1",29255,30953,60208
"16653",1996,"2",29402,30723,60125
"16654",1996,"3",29392,31498,60890
"16655",1996,"4",30068,31798,61866
"16656",1996,"5",30159,31694,61853
"16657",1996,"6",29268,30872,60140
"16658",1996,"7",28447,29940,58387
"16659",1996,"8",27116,28080,55196
"16660",1996,"9",26102,27793,53895
"16661",1996,"10",25600,26926,52526
"16662",1996,"11",25364,26532,51896
"16663",1996,"12",24965,26549,51514
"16664",1996,"13",25610,27112,52722
"16665",1996,"14",25773,26655,52428
"16666",1996,"15",25592,27150,52742
"16667",1996,"16",25904,27143,53047
"16668",1996,"17",25957,27329,53286
"16669",1996,"18",25846,26878,52724
"16670",1996,"19",27024,28112,55136
"16671",1996,"20",28581,29529,58110
"16672",1996,"21",30474,31073,61547
"16673",1996,"22",30807,32227,63034
"16674",1996,"23",32569,33589,66158
"16675",1996,"24",33142,34158,67300
"16676",1996,"25",32759,33946,66705
"16677",1996,"26",34240,35664,69904
"16678",1996,"27",34062,35661,69723
"16679",1996,"28",33569,34917,68486
"16680",1996,"29",33557,35587,69144
"16681",1996,"30",33215,35152,68367
"16682",1996,"31",32881,34903,67784
"16683",1996,"32",32116,33364,65480
"16684",1996,"33",31310,33013,64323
"16685",1996,"34",31149,32786,63935
"16686",1996,"35",30992,32456,63448
"16687",1996,"36",31166,32980,64146
"16688",1996,"37",31272,32586,63858
"16689",1996,"38",31058,32220,63278
"16690",1996,"39",31577,32612,64189
"16691",1996,"40",30933,32220,63153
"16692",1996,"41",30519,31577,62096
"16693",1996,"42",30464,31504,61968
"16694",1996,"43",29858,31383,61241
"16695",1996,"44",28569,30388,58957
"16696",1996,"45",29384,30967,60351
"16697",1996,"46",29502,31151,60653
"16698",1996,"47",30004,31996,62000
"16699",1996,"48",31100,32536,63636
"16700",1996,"49",32315,33885,66200
"16701",1996,"50",29041,30195,59236
"16702",1996,"51",27730,29226,56956
"16703",1996,"52",24885,25712,50597
"16704",1996,"53",22996,23445,46441
"16705",1996,"54",20329,20484,40813
"16706",1996,"55",20879,21163,42042
"16707",1996,"56",20543,20295,40838
"16708",1996,"57",19810,19493,39303
"16709",1996,"58",18929,18500,37429
"16710",1996,"59",18165,17880,36045
"16711",1996,"60",17751,16750,34501
"16712",1996,"61",17561,16844,34405
"16713",1996,"62",17471,16863,34334
"16714",1996,"63",18736,17659,36395
"16715",1996,"64",18912,17345,36257
"16716",1996,"65",19139,17757,36896
"16717",1996,"66",18762,17218,35980
"16718",1996,"67",19222,16978,36200
"16719",1996,"68",18995,16667,35662
"16720",1996,"69",19883,17247,37130
"16721",1996,"70",19531,16681,36212
"16722",1996,"71",20328,16906,37234
"16723",1996,"72",20749,16913,37662
"16724",1996,"73",20716,15976,36692
"16725",1996,"74",20667,15409,36076
"16726",1996,"75",21539,15804,37343
"16727",1996,"76",17422,12555,29977
"16728",1996,"77",17890,12203,30093
"16729",1996,"78",17392,11415,28807
"16730",1996,"79",15990,9952,25942
"16731",1996,"80",14906,9057,23963
"16732",1996,"81",13940,8259,22199
"16733",1996,"82",12901,7332,20233
"16734",1996,"83",12047,6515,18562
"16735",1996,"84",10740,5525,16265
"16736",1996,"85",9568,4672,14240
"16737",1996,"86",8598,3951,12549
"16738",1996,"87",7197,3119,10316
"16739",1996,"88",6138,2430,8568
"16740",1996,"89",5041,1978,7019
"16741",1996,"90",4125,1492,5617
"16742",1996,"91",3349,1178,4527
"16743",1996,"92",2648,955,3603
"16744",1996,"93",2046,671,2717
"16745",1996,"94",1491,430,1921
"16746",1996,"95",1020,269,1289
"16747",1996,"96",718,191,909
"16748",1996,"97",497,153,650
"16749",1996,"98",333,107,440
"16750",1996,"99",221,60,281
"16751",1996,"100",135,44,179
"16752",1996,"101",84,15,99
"16753",1996,"102",52,18,70
"16754",1996,"103",29,7,36
"16755",1996,"104",15,2,17
"16756",1996,"105",8,0,8
"16757",1996,"106",4,2,6
"16758",1996,"107",0,0,0
"16759",1996,"108",0,0,0
"16760",1996,"109",1,0,1
"16761",1996,"110+",0,0,0
"16762",1997,"0",29432,31403,60835
"16763",1997,"1",29402,31078,60480
"16764",1997,"2",29366,31040,60406
"16765",1997,"3",29482,30791,60273
"16766",1997,"4",29499,31556,61055
"16767",1997,"5",30110,31808,61918
"16768",1997,"6",30194,31706,61900
"16769",1997,"7",29287,30894,60181
"16770",1997,"8",28489,29973,58462
"16771",1997,"9",27152,28098,55250
"16772",1997,"10",26123,27833,53956
"16773",1997,"11",25629,26975,52604
"16774",1997,"12",25395,26583,51978
"16775",1997,"13",24991,26573,51564
"16776",1997,"14",25636,27139,52775
"16777",1997,"15",25801,26702,52503
"16778",1997,"16",25659,27203,52862
"16779",1997,"17",26061,27228,53289
"16780",1997,"18",26099,27411,53510
"16781",1997,"19",25927,26879,52806
"16782",1997,"20",27151,28159,55310
"16783",1997,"21",28682,29493,58175
"16784",1997,"22",30577,31095,61672
"16785",1997,"23",30998,32286,63284
"16786",1997,"24",32659,33655,66314
"16787",1997,"25",33310,34228,67538
"16788",1997,"26",32934,34002,66936
"16789",1997,"27",34391,35713,70104
"16790",1997,"28",34202,35742,69944
"16791",1997,"29",33692,34977,68669
"16792",1997,"30",33643,35580,69223
"16793",1997,"31",33321,35217,68538
"16794",1997,"32",32905,34946,67851
"16795",1997,"33",32153,33373,65526
"16796",1997,"34",31354,33008,64362
"16797",1997,"35",31140,32788,63928
"16798",1997,"36",31022,32447,63469
"16799",1997,"37",31168,32947,64115
"16800",1997,"38",31271,32551,63822
"16801",1997,"39",31015,32168,63183
"16802",1997,"40",31559,32556,64115
"16803",1997,"41",30917,32158,63075
"16804",1997,"42",30523,31494,62017
"16805",1997,"43",30463,31436,61899
"16806",1997,"44",29834,31303,61137
"16807",1997,"45",28533,30297,58830
"16808",1997,"46",29325,30888,60213
"16809",1997,"47",29455,31062,60517
"16810",1997,"48",29967,31895,61862
"16811",1997,"49",31018,32382,63400
"16812",1997,"50",32231,33690,65921
"16813",1997,"51",28969,30046,59015
"16814",1997,"52",27669,29070,56739
"16815",1997,"53",24799,25575,50374
"16816",1997,"54",22931,23327,46258
"16817",1997,"55",20227,20355,40582
"16818",1997,"56",20810,21021,41831
"16819",1997,"57",20458,20165,40623
"16820",1997,"58",19725,19319,39044
"16821",1997,"59",18817,18304,37121
"16822",1997,"60",18086,17682,35768
"16823",1997,"61",17653,16541,34194
"16824",1997,"62",17454,16592,34046
"16825",1997,"63",17351,16642,33993
"16826",1997,"64",18605,17400,36005
"16827",1997,"65",18710,17054,35764
"16828",1997,"66",18949,17402,36351
"16829",1997,"67",18571,16857,35428
"16830",1997,"68",19000,16570,35570
"16831",1997,"69",18758,16247,35005
"16832",1997,"70",19582,16751,36333
"16833",1997,"71",19204,16115,35319
"16834",1997,"72",19987,16305,36292
"16835",1997,"73",20339,16194,36533
"16836",1997,"74",20242,15255,35497
"16837",1997,"75",20187,14619,34806
"16838",1997,"76",20908,14908,35816
"16839",1997,"77",16838,11792,28630
"16840",1997,"78",17239,11383,28622
"16841",1997,"79",16687,10590,27277
"16842",1997,"80",15260,9160,24420
"16843",1997,"81",14068,8233,22301
"16844",1997,"82",13081,7435,20516
"16845",1997,"83",12012,6611,18623
"16846",1997,"84",11115,5704,16819
"16847",1997,"85",9833,4789,14622
"16848",1997,"86",8607,4028,12635
"16849",1997,"87",7674,3343,11017
"16850",1997,"88",6260,2572,8832
"16851",1997,"89",5302,1986,7288
"16852",1997,"90",4238,1576,5814
"16853",1997,"91",3396,1177,4573
"16854",1997,"92",2716,911,3627
"16855",1997,"93",2065,704,2769
"16856",1997,"94",1604,486,2090
"16857",1997,"95",1113,307,1420
"16858",1997,"96",746,178,924
"16859",1997,"97",498,126,624
"16860",1997,"98",327,102,429
"16861",1997,"99",231,64,295
"16862",1997,"100",143,38,181
"16863",1997,"101",65,28,93
"16864",1997,"102",61,8,69
"16865",1997,"103",34,10,44
"16866",1997,"104",11,4,15
"16867",1997,"105",9,0,9
"16868",1997,"106",6,0,6
"16869",1997,"107",3,2,5
"16870",1997,"108",0,0,0
"16871",1997,"109",0,0,0
"16872",1997,"110+",1,0,1
"16873",1998,"0",29027,30668,59695
"16874",1998,"1",29680,31558,61238
"16875",1998,"2",29567,31261,60828
"16876",1998,"3",29454,31147,60601
"16877",1998,"4",29545,30890,60435
"16878",1998,"5",29574,31636,61210
"16879",1998,"6",30148,31898,62046
"16880",1998,"7",30252,31800,62052
"16881",1998,"8",29360,30957,60317
"16882",1998,"9",28587,30027,58614
"16883",1998,"10",27203,28174,55377
"16884",1998,"11",26173,27891,54064
"16885",1998,"12",25683,27045,52728
"16886",1998,"13",25420,26614,52034
"16887",1998,"14",25063,26617,51680
"16888",1998,"15",25671,27214,52885
"16889",1998,"16",25883,26771,52654
"16890",1998,"17",25792,27286,53078
"16891",1998,"18",26152,27321,53473
"16892",1998,"19",26299,27424,53723
"16893",1998,"20",26124,26956,53080
"16894",1998,"21",27261,28210,55471
"16895",1998,"22",28847,29620,58467
"16896",1998,"23",30758,31195,61953
"16897",1998,"24",31221,32394,63615
"16898",1998,"25",32884,33804,66688
"16899",1998,"26",33531,34407,67938
"16900",1998,"27",33165,34191,67356
"16901",1998,"28",34564,35904,70468
"16902",1998,"29",34319,35901,70220
"16903",1998,"30",33815,35150,68965
"16904",1998,"31",33758,35658,69416
"16905",1998,"32",33404,35333,68737
"16906",1998,"33",32994,35078,68072
"16907",1998,"34",32222,33419,65641
"16908",1998,"35",31419,33000,64419
"16909",1998,"36",31193,32790,63983
"16910",1998,"37",31082,32452,63534
"16911",1998,"38",31242,32914,64156
"16912",1998,"39",31287,32559,63846
"16913",1998,"40",31056,32140,63196
"16914",1998,"41",31576,32481,64057
"16915",1998,"42",30937,32136,63073
"16916",1998,"43",30510,31427,61937
"16917",1998,"44",30441,31400,61841
"16918",1998,"45",29804,31231,61035
"16919",1998,"46",28485,30212,58697
"16920",1998,"47",29283,30804,60087
"16921",1998,"48",29409,31012,60421
"16922",1998,"49",29920,31792,61712
"16923",1998,"50",30952,32248,63200
"16924",1998,"51",32144,33570,65714
"16925",1998,"52",28876,29924,58800
"16926",1998,"53",27602,28938,56540
"16927",1998,"54",24714,25404,50118
"16928",1998,"55",22854,23204,46058
"16929",1998,"56",20145,20225,40370
"16930",1998,"57",20741,20867,41608
"16931",1998,"58",20338,20015,40353
"16932",1998,"59",19610,19142,38752
"16933",1998,"60",18750,18131,36881
"16934",1998,"61",18017,17464,35481
"16935",1998,"62",17532,16324,33856
"16936",1998,"63",17347,16385,33732
"16937",1998,"64",17200,16356,33556
"16938",1998,"65",18432,17140,35572
"16939",1998,"66",18551,16738,35289
"16940",1998,"67",18751,17065,35816
"16941",1998,"68",18353,16463,34816
"16942",1998,"69",18753,16123,34876
"16943",1998,"70",18492,15788,34280
"16944",1998,"71",19285,16189,35474
"16945",1998,"72",18832,15540,34372
"16946",1998,"73",19594,15660,35254
"16947",1998,"74",19865,15478,35343
"16948",1998,"75",19736,14504,34240
"16949",1998,"76",19599,13820,33419
"16950",1998,"77",20271,14022,34293
"16951",1998,"78",16190,11067,27257
"16952",1998,"79",16520,10533,27053
"16953",1998,"80",15950,9720,25670
"16954",1998,"81",14452,8331,22783
"16955",1998,"82",13184,7380,20564
"16956",1998,"83",12193,6677,18870
"16957",1998,"84",11029,5808,16837
"16958",1998,"85",10133,4960,15093
"16959",1998,"86",8853,4118,12971
"16960",1998,"87",7636,3370,11006
"16961",1998,"88",6699,2738,9437
"16962",1998,"89",5379,2081,7460
"16963",1998,"90",4463,1594,6057
"16964",1998,"91",3450,1213,4663
"16965",1998,"92",2773,903,3676
"16966",1998,"93",2114,682,2796
"16967",1998,"94",1561,486,2047
"16968",1998,"95",1177,336,1513
"16969",1998,"96",804,207,1011
"16970",1998,"97",526,116,642
"16971",1998,"98",347,76,423
"16972",1998,"99",221,61,282
"16973",1998,"100",150,33,183
"16974",1998,"101",79,19,98
"16975",1998,"102",40,15,55
"16976",1998,"103",35,8,43
"16977",1998,"104",20,5,25
"16978",1998,"105",4,3,7
"16979",1998,"106",6,0,6
"16980",1998,"107",3,0,3
"16981",1998,"108",2,2,4
"16982",1998,"109",0,0,0
"16983",1998,"110+",1,0,1
"16984",1999,"0",28430,29852,58282
"16985",1999,"1",29299,30910,60209
"16986",1999,"2",29929,31722,61651
"16987",1999,"3",29665,31361,61026
"16988",1999,"4",29544,31251,60795
"16989",1999,"5",29644,30959,60603
"16990",1999,"6",29620,31735,61355
"16991",1999,"7",30233,32005,62238
"16992",1999,"8",30326,31870,62196
"16993",1999,"9",29449,31049,60498
"16994",1999,"10",28647,30127,58774
"16995",1999,"11",27264,28275,55539
"16996",1999,"12",26259,27956,54215
"16997",1999,"13",25749,27113,52862
"16998",1999,"14",25484,26681,52165
"16999",1999,"15",25127,26712,51839
"17000",1999,"16",25766,27314,53080
"17001",1999,"17",26051,26891,52942
"17002",1999,"18",25957,27415,53372
"17003",1999,"19",26552,27435,53987
"17004",1999,"20",26572,27574,54146
"17005",1999,"21",26404,27128,53532
"17006",1999,"22",27514,28363,55877
"17007",1999,"23",29133,29833,58966
"17008",1999,"24",31028,31467,62495
"17009",1999,"25",31514,32644,64158
"17010",1999,"26",33176,34090,67266
"17011",1999,"27",33791,34671,68462
"17012",1999,"28",33430,34462,67892
"17013",1999,"29",34752,36073,70825
"17014",1999,"30",34495,36096,70591
"17015",1999,"31",33982,35338,69320
"17016",1999,"32",33850,35821,69671
"17017",1999,"33",33477,35426,68903
"17018",1999,"34",33106,35169,68275
"17019",1999,"35",32316,33534,65850
"17020",1999,"36",31510,33094,64604
"17021",1999,"37",31287,32822,64109
"17022",1999,"38",31113,32492,63605
"17023",1999,"39",31301,32952,64253
"17024",1999,"40",31336,32574,63910
"17025",1999,"41",31072,32093,63165
"17026",1999,"42",31608,32510,64118
"17027",1999,"43",30914,32133,63047
"17028",1999,"44",30514,31410,61924
"17029",1999,"45",30440,31343,61783
"17030",1999,"46",29803,31173,60976
"17031",1999,"47",28466,30139,58605
"17032",1999,"48",29245,30744,59989
"17033",1999,"49",29362,30910,60272
"17034",1999,"50",29861,31686,61547
"17035",1999,"51",30859,32124,62983
"17036",1999,"52",32059,33454,65513
"17037",1999,"53",28770,29783,58553
"17038",1999,"54",27499,28806,56305
"17039",1999,"55",24625,25258,49883
"17040",1999,"56",22758,23049,45807
"17041",1999,"57",20061,20070,40131
"17042",1999,"58",20666,20715,41381
"17043",1999,"59",20253,19828,40081
"17044",1999,"60",19513,18921,38434
"17045",1999,"61",18644,17964,36608
"17046",1999,"62",17903,17223,35126
"17047",1999,"63",17433,16073,33506
"17048",1999,"64",17211,16090,33301
"17049",1999,"65",17043,16084,33127
"17050",1999,"66",18283,16833,35116
"17051",1999,"67",18364,16399,34763
"17052",1999,"68",18533,16694,35227
"17053",1999,"69",18142,16012,34154
"17054",1999,"70",18478,15660,34138
"17055",1999,"71",18192,15291,33483
"17056",1999,"72",18943,15590,34533
"17057",1999,"73",18461,14955,33416
"17058",1999,"74",19199,15016,34215
"17059",1999,"75",19376,14750,34126
"17060",1999,"76",19182,13743,32925
"17061",1999,"77",18976,13007,31983
"17062",1999,"78",19495,13098,32593
"17063",1999,"79",15478,10255,25733
"17064",1999,"80",15753,9704,25457
"17065",1999,"81",15079,8851,23930
"17066",1999,"82",13616,7541,21157
"17067",1999,"83",12286,6548,18834
"17068",1999,"84",11300,5883,17183
"17069",1999,"85",10048,5065,15113
"17070",1999,"86",9159,4279,13438
"17071",1999,"87",7887,3497,11384
"17072",1999,"88",6642,2794,9436
"17073",1999,"89",5780,2217,7997
"17074",1999,"90",4548,1683,6231
"17075",1999,"91",3689,1263,4952
"17076",1999,"92",2794,931,3725
"17077",1999,"93",2147,678,2825
"17078",1999,"94",1642,490,2132
"17079",1999,"95",1164,350,1514
"17080",1999,"96",855,233,1088
"17081",1999,"97",594,151,745
"17082",1999,"98",361,72,433
"17083",1999,"99",233,48,281
"17084",1999,"100",147,35,182
"17085",1999,"101",82,20,102
"17086",1999,"102",48,8,56
"17087",1999,"103",23,7,30
"17088",1999,"104",23,4,27
"17089",1999,"105",10,4,14
"17090",1999,"106",3,3,6
"17091",1999,"107",3,0,3
"17092",1999,"108",0,0,0
"17093",1999,"109",1,0,1
"17094",1999,"110+",0,0,0
"17095",2000,"0",28887,30485,59372
"17096",2000,"1",28745,30134,58879
"17097",2000,"2",29548,31151,60699
"17098",2000,"3",30121,31893,62014
"17099",2000,"4",29828,31595,61423
"17100",2000,"5",29726,31426,61152
"17101",2000,"6",29797,31138,60935
"17102",2000,"7",29779,31890,61669
"17103",2000,"8",30356,32192,62548
"17104",2000,"9",30482,32038,62520
"17105",2000,"10",29606,31238,60844
"17106",2000,"11",28796,30284,59080
"17107",2000,"12",27419,28431,55850
"17108",2000,"13",26434,28120,54554
"17109",2000,"14",25897,27281,53178
"17110",2000,"15",25623,26818,52441
"17111",2000,"16",25276,26901,52177
"17112",2000,"17",25957,27552,53509
"17113",2000,"18",26211,27082,53293
"17114",2000,"19",26407,27563,53970
"17115",2000,"20",26731,27640,54371
"17116",2000,"21",26788,27759,54547
"17117",2000,"22",26587,27345,53932
"17118",2000,"23",27835,28600,56435
"17119",2000,"24",29364,30083,59447
"17120",2000,"25",31292,31733,63025
"17121",2000,"26",31813,32877,64690
"17122",2000,"27",33433,34347,67780
"17123",2000,"28",34036,34917,68953
"17124",2000,"29",33713,34666,68379
"17125",2000,"30",35024,36326,71350
"17126",2000,"31",34750,36290,71040
"17127",2000,"32",34189,35516,69705
"17128",2000,"33",34013,36014,70027
"17129",2000,"34",33646,35570,69216
"17130",2000,"35",33258,35311,68569
"17131",2000,"36",32462,33681,66143
"17132",2000,"37",31651,33256,64907
"17133",2000,"38",31408,32936,64344
"17134",2000,"39",31184,32564,63748
"17135",2000,"40",31356,32979,64335
"17136",2000,"41",31399,32650,64049
"17137",2000,"42",31143,32149,63292
"17138",2000,"43",31679,32551,64230
"17139",2000,"44",30954,32164,63118
"17140",2000,"45",30528,31414,61942
"17141",2000,"46",30473,31319,61792
"17142",2000,"47",29790,31128,60918
"17143",2000,"48",28453,30120,58573
"17144",2000,"49",29202,30669,59871
"17145",2000,"50",29347,30823,60170
"17146",2000,"51",29813,31547,61360
"17147",2000,"52",30829,32008,62837
"17148",2000,"53",31977,33310,65287
"17149",2000,"54",28694,29678,58372
"17150",2000,"55",27423,28634,56057
"17151",2000,"56",24543,25116,49659
"17152",2000,"57",22700,22928,45628
"17153",2000,"58",20009,19931,39940
"17154",2000,"59",20561,20569,41130
"17155",2000,"60",20173,19668,39841
"17156",2000,"61",19432,18724,38156
"17157",2000,"62",18524,17770,36294
"17158",2000,"63",17771,16983,34754
"17159",2000,"64",17315,15830,33145
"17160",2000,"65",17045,15804,32849
"17161",2000,"66",16893,15783,32676
"17162",2000,"67",18087,16481,34568
"17163",2000,"68",18139,16022,34161
"17164",2000,"69",18299,16275,34574
"17165",2000,"70",17901,15613,33514
"17166",2000,"71",18198,15175,33373
"17167",2000,"72",17888,14743,32631
"17168",2000,"73",18546,14986,33532
"17169",2000,"74",18081,14333,32414
"17170",2000,"75",18711,14311,33022
"17171",2000,"76",18856,13973,32829
"17172",2000,"77",18580,12935,31515
"17173",2000,"78",18299,12170,30469
"17174",2000,"79",18709,12174,30883
"17175",2000,"80",14778,9471,24249
"17176",2000,"81",14865,8830,23695
"17177",2000,"82",14153,8008,22161
"17178",2000,"83",12706,6689,19395
"17179",2000,"84",11344,5740,17084
"17180",2000,"85",10274,5083,15357
"17181",2000,"86",9112,4301,13413
"17182",2000,"87",8100,3593,11693
"17183",2000,"88",6893,2902,9795
"17184",2000,"89",5737,2269,8006
"17185",2000,"90",4833,1739,6572
"17186",2000,"91",3753,1327,5080
"17187",2000,"92",2946,961,3907
"17188",2000,"93",2166,680,2846
"17189",2000,"94",1644,473,2117
"17190",2000,"95",1206,323,1529
"17191",2000,"96",826,233,1059
"17192",2000,"97",576,143,719
"17193",2000,"98",377,104,481
"17194",2000,"99",234,46,280
"17195",2000,"100",146,26,172
"17196",2000,"101",88,19,107
"17197",2000,"102",41,15,56
"17198",2000,"103",32,5,37
"17199",2000,"104",11,5,16
"17200",2000,"105",16,1,17
"17201",2000,"106",7,2,9
"17202",2000,"107",1,2,3
"17203",2000,"108",0,0,0
"17204",2000,"109",0,0,0
"17205",2000,"110+",1,0,1
"17206",2001,"0",28805,30388,59193
"17207",2001,"1",29090,30655,59745
"17208",2001,"2",28891,30257,59148
"17209",2001,"3",29589,31181,60770
"17210",2001,"4",30155,31943,62098
"17211",2001,"5",29874,31630,61504
"17212",2001,"6",29751,31493,61244
"17213",2001,"7",29812,31173,60985
"17214",2001,"8",29832,31955,61787
"17215",2001,"9",30410,32218,62628
"17216",2001,"10",30527,32084,62611
"17217",2001,"11",29623,31304,60927
"17218",2001,"12",28864,30324,59188
"17219",2001,"13",27484,28474,55958
"17220",2001,"14",26463,28182,54645
"17221",2001,"15",25925,27361,53286
"17222",2001,"16",25707,26910,52617
"17223",2001,"17",25421,27102,52523
"17224",2001,"18",26128,27745,53873
"17225",2001,"19",26502,27159,53661
"17226",2001,"20",26484,27663,54147
"17227",2001,"21",26852,27780,54632
"17228",2001,"22",26962,27947,54909
"17229",2001,"23",26753,27547,54300
"17230",2001,"24",28053,28895,56948
"17231",2001,"25",29639,30371,60010
"17232",2001,"26",31507,32100,63607
"17233",2001,"27",31997,33135,65132
"17234",2001,"28",33572,34653,68225
"17235",2001,"29",34206,35142,69348
"17236",2001,"30",33809,34926,68735
"17237",2001,"31",35131,36489,71620
"17238",2001,"32",34870,36410,71280
"17239",2001,"33",34269,35622,69891
"17240",2001,"34",34080,36131,70211
"17241",2001,"35",33690,35631,69321
"17242",2001,"36",33280,35308,68588
"17243",2001,"37",32515,33680,66195
"17244",2001,"38",31674,33286,64960
"17245",2001,"39",31409,32909,64318
"17246",2001,"40",31211,32614,63825
"17247",2001,"41",31351,32962,64313
"17248",2001,"42",31365,32629,63994
"17249",2001,"43",31125,32084,63209
"17250",2001,"44",31657,32475,64132
"17251",2001,"45",30939,32060,62999
"17252",2001,"46",30497,31341,61838
"17253",2001,"47",30428,31228,61656
"17254",2001,"48",29742,31033,60775
"17255",2001,"49",28383,30012,58395
"17256",2001,"50",29145,30572,59717
"17257",2001,"51",29306,30679,59985
"17258",2001,"52",29722,31409,61131
"17259",2001,"53",30744,31829,62573
"17260",2001,"54",31857,33101,64958
"17261",2001,"55",28576,29491,58067
"17262",2001,"56",27297,28423,55720
"17263",2001,"57",24415,24922,49337
"17264",2001,"58",22586,22745,45331
"17265",2001,"59",19883,19723,39606
"17266",2001,"60",20440,20389,40829
"17267",2001,"61",20005,19451,39456
"17268",2001,"62",19289,18491,37780
"17269",2001,"63",18364,17507,35871
"17270",2001,"64",17622,16723,34345
"17271",2001,"65",17152,15565,32717
"17272",2001,"66",16905,15504,32409
"17273",2001,"67",16716,15493,32209
"17274",2001,"68",17875,16081,33956
"17275",2001,"69",17909,15634,33543
"17276",2001,"70",18028,15830,33858
"17277",2001,"71",17585,15170,32755
"17278",2001,"72",17883,14682,32565
"17279",2001,"73",17513,14193,31706
"17280",2001,"74",18145,14381,32526
"17281",2001,"75",17648,13707,31355
"17282",2001,"76",18207,13595,31802
"17283",2001,"77",18278,13206,31484
"17284",2001,"78",17944,12169,30113
"17285",2001,"79",17601,11326,28927
"17286",2001,"80",17882,11254,29136
"17287",2001,"81",13991,8673,22664
"17288",2001,"82",13973,7977,21950
"17289",2001,"83",13274,7135,20409
"17290",2001,"84",11699,5896,17595
"17291",2001,"85",10422,5000,15422
"17292",2001,"86",9226,4359,13585
"17293",2001,"87",8076,3662,11738
"17294",2001,"88",7089,2994,10083
"17295",2001,"89",5907,2383,8290
"17296",2001,"90",4830,1826,6656
"17297",2001,"91",3993,1380,5373
"17298",2001,"92",3040,997,4037
"17299",2001,"93",2328,706,3034
"17300",2001,"94",1692,482,2174
"17301",2001,"95",1250,318,1568
"17302",2001,"96",866,225,1091
"17303",2001,"97",573,150,723
"17304",2001,"98",395,93,488
"17305",2001,"99",247,72,319
"17306",2001,"100",149,32,181
"17307",2001,"101",80,18,98
"17308",2001,"102",48,10,58
"17309",2001,"103",25,6,31
"17310",2001,"104",20,2,22
"17311",2001,"105",5,4,9
"17312",2001,"106",11,0,11
"17313",2001,"107",5,0,5
"17314",2001,"108",0,1,1
"17315",2001,"109",0,0,0
"17316",2001,"110+",0,0,0
"17317",2002,"0",27665,29042,56707
"17318",2002,"1",29039,30549,59588
"17319",2002,"2",29193,30760,59953
"17320",2002,"3",28937,30319,59256
"17321",2002,"4",29619,31238,60857
"17322",2002,"5",30194,32008,62202
"17323",2002,"6",29890,31688,61578
"17324",2002,"7",29788,31542,61330
"17325",2002,"8",29873,31223,61096
"17326",2002,"9",29878,32005,61883
"17327",2002,"10",30475,32255,62730
"17328",2002,"11",30582,32158,62740
"17329",2002,"12",29702,31346,61048
"17330",2002,"13",28885,30387,59272
"17331",2002,"14",27524,28536,56060
"17332",2002,"15",26517,28279,54796
"17333",2002,"16",25993,27460,53453
"17334",2002,"17",25851,27089,52940
"17335",2002,"18",25577,27258,52835
"17336",2002,"19",26385,27794,54179
"17337",2002,"20",26612,27202,53814
"17338",2002,"21",26637,27721,54358
"17339",2002,"22",27038,27852,54890
"17340",2002,"23",27176,28082,55258
"17341",2002,"24",27021,27662,54683
"17342",2002,"25",28309,29050,57359
"17343",2002,"26",29867,30481,60348
"17344",2002,"27",31716,32231,63947
"17345",2002,"28",32151,33231,65382
"17346",2002,"29",33718,34704,68422
"17347",2002,"30",34311,35226,69537
"17348",2002,"31",33921,35082,69003
"17349",2002,"32",35206,36525,71731
"17350",2002,"33",34995,36418,71413
"17351",2002,"34",34334,35607,69941
"17352",2002,"35",34117,36133,70250
"17353",2002,"36",33749,35664,69413
"17354",2002,"37",33335,35271,68606
"17355",2002,"38",32534,33662,66196
"17356",2002,"39",31687,33244,64931
"17357",2002,"40",31425,32900,64325
"17358",2002,"41",31245,32574,63819
"17359",2002,"42",31358,32927,64285
"17360",2002,"43",31382,32568,63950
"17361",2002,"44",31146,32034,63180
"17362",2002,"45",31616,32390,64006
"17363",2002,"46",30890,31971,62861
"17364",2002,"47",30435,31268,61703
"17365",2002,"48",30368,31107,61475
"17366",2002,"49",29709,30907,60616
"17367",2002,"50",28312,29882,58194
"17368",2002,"51",29075,30446,59521
"17369",2002,"52",29233,30543,59776
"17370",2002,"53",29632,31217,60849
"17371",2002,"54",30642,31635,62277
"17372",2002,"55",31739,32884,64623
"17373",2002,"56",28453,29297,57750
"17374",2002,"57",27183,28224,55407
"17375",2002,"58",24297,24748,49045
"17376",2002,"59",22440,22526,44966
"17377",2002,"60",19750,19528,39278
"17378",2002,"61",20330,20182,40512
"17379",2002,"62",19861,19216,39077
"17380",2002,"63",19124,18226,37350
"17381",2002,"64",18195,17220,35415
"17382",2002,"65",17469,16443,33912
"17383",2002,"66",16994,15308,32302
"17384",2002,"67",16719,15202,31921
"17385",2002,"68",16522,15145,31667
"17386",2002,"69",17646,15695,33341
"17387",2002,"70",17656,15188,32844
"17388",2002,"71",17757,15375,33132
"17389",2002,"72",17238,14664,31902
"17390",2002,"73",17538,14197,31735
"17391",2002,"74",17178,13647,30825
"17392",2002,"75",17679,13768,31447
"17393",2002,"76",17196,13054,30250
"17394",2002,"77",17651,12853,30504
"17395",2002,"78",17662,12331,29993
"17396",2002,"79",17244,11343,28587
"17397",2002,"80",16801,10511,27312
"17398",2002,"81",16980,10300,27280
"17399",2002,"82",13187,7848,21035
"17400",2002,"83",13010,7104,20114
"17401",2002,"84",12338,6292,18630
"17402",2002,"85",10675,5118,15793
"17403",2002,"86",9401,4300,13701
"17404",2002,"87",8246,3729,11975
"17405",2002,"88",7091,3076,10167
"17406",2002,"89",6162,2444,8606
"17407",2002,"90",5006,1893,6899
"17408",2002,"91",3983,1432,5415
"17409",2002,"92",3188,1039,4227
"17410",2002,"93",2416,738,3154
"17411",2002,"94",1806,523,2329
"17412",2002,"95",1261,344,1605
"17413",2002,"96",922,216,1138
"17414",2002,"97",598,137,735
"17415",2002,"98",394,93,487
"17416",2002,"99",256,47,303
"17417",2002,"100",156,44,200
"17418",2002,"101",87,24,111
"17419",2002,"102",43,8,51
"17420",2002,"103",28,3,31
"17421",2002,"104",17,3,20
"17422",2002,"105",10,0,10
"17423",2002,"106",4,2,6
"17424",2002,"107",5,0,5
"17425",2002,"108",2,0,2
"17426",2002,"109",0,1,1
"17427",2002,"110+",0,0,0
"17428",2003,"0",27193,28427,55620
"17429",2003,"1",28025,29269,57294
"17430",2003,"2",29290,30673,59963
"17431",2003,"3",29331,30859,60190
"17432",2003,"4",29077,30450,59527
"17433",2003,"5",29760,31376,61136
"17434",2003,"6",30329,32156,62485
"17435",2003,"7",30053,31843,61896
"17436",2003,"8",29944,31698,61642
"17437",2003,"9",30021,31345,61366
"17438",2003,"10",30080,32197,62277
"17439",2003,"11",30619,32411,63030
"17440",2003,"12",30740,32326,63066
"17441",2003,"13",29809,31495,61304
"17442",2003,"14",28997,30535,59532
"17443",2003,"15",27654,28712,56366
"17444",2003,"16",26662,28437,55099
"17445",2003,"17",26196,27722,53918
"17446",2003,"18",26041,27308,53349
"17447",2003,"19",25937,27411,53348
"17448",2003,"20",26617,27892,54509
"17449",2003,"21",26859,27322,54181
"17450",2003,"22",26970,27893,54863
"17451",2003,"23",27423,28080,55503
"17452",2003,"24",27562,28295,55857
"17453",2003,"25",27454,27879,55333
"17454",2003,"26",28751,29290,58041
"17455",2003,"27",30240,30692,60932
"17456",2003,"28",32026,32485,64511
"17457",2003,"29",32446,33503,65949
"17458",2003,"30",33968,34898,68866
"17459",2003,"31",34544,35390,69934
"17460",2003,"32",34180,35283,69463
"17461",2003,"33",35404,36628,72032
"17462",2003,"34",35135,36528,71663
"17463",2003,"35",34477,35717,70194
"17464",2003,"36",34231,36193,70424
"17465",2003,"37",33866,35760,69626
"17466",2003,"38",33453,35343,68796
"17467",2003,"39",32667,33690,66357
"17468",2003,"40",31752,33260,65012
"17469",2003,"41",31504,32884,64388
"17470",2003,"42",31274,32595,63869
"17471",2003,"43",31448,32933,64381
"17472",2003,"44",31429,32530,63959
"17473",2003,"45",31148,32017,63165
"17474",2003,"46",31618,32362,63980
"17475",2003,"47",30885,31912,62797
"17476",2003,"48",30413,31221,61634
"17477",2003,"49",30336,31035,61371
"17478",2003,"50",29681,30833,60514
"17479",2003,"51",28257,29797,58054
"17480",2003,"52",28994,30336,59330
"17481",2003,"53",29161,30426,59587
"17482",2003,"54",29544,31039,60583
"17483",2003,"55",30517,31416,61933
"17484",2003,"56",31597,32696,64293
"17485",2003,"57",28325,29099,57424
"17486",2003,"58",27071,28002,55073
"17487",2003,"59",24141,24549,48690
"17488",2003,"60",22302,22311,44613
"17489",2003,"61",19620,19272,38892
"17490",2003,"62",20180,19944,40124
"17491",2003,"63",19705,18925,38630
"17492",2003,"64",18965,17973,36938
"17493",2003,"65",18038,16962,35000
"17494",2003,"66",17291,16142,33433
"17495",2003,"67",16807,15001,31808
"17496",2003,"68",16529,14835,31364
"17497",2003,"69",16340,14765,31105
"17498",2003,"70",17428,15296,32724
"17499",2003,"71",17373,14757,32130
"17500",2003,"72",17452,14896,32348
"17501",2003,"73",16899,14164,31063
"17502",2003,"74",17195,13634,30829
"17503",2003,"75",16740,13049,29789
"17504",2003,"76",17205,13100,30305
"17505",2003,"77",16712,12359,29071
"17506",2003,"78",17038,12101,29139
"17507",2003,"79",16911,11494,28405
"17508",2003,"80",16548,10500,27048
"17509",2003,"81",15967,9639,25606
"17510",2003,"82",16009,9380,25389
"17511",2003,"83",12324,7043,19367
"17512",2003,"84",11993,6316,18309
"17513",2003,"85",11297,5496,16793
"17514",2003,"86",9612,4390,14002
"17515",2003,"87",8359,3670,12029
"17516",2003,"88",7224,3056,10280
"17517",2003,"89",6105,2498,8603
"17518",2003,"90",5213,1920,7133
"17519",2003,"91",4130,1508,5638
"17520",2003,"92",3220,1066,4286
"17521",2003,"93",2494,753,3247
"17522",2003,"94",1810,521,2331
"17523",2003,"95",1338,377,1715
"17524",2003,"96",889,232,1121
"17525",2003,"97",638,132,770
"17526",2003,"98",407,90,497
"17527",2003,"99",268,55,323
"17528",2003,"100",163,33,196
"17529",2003,"101",93,26,119
"17530",2003,"102",54,14,68
"17531",2003,"103",23,6,29
"17532",2003,"104",14,2,16
"17533",2003,"105",9,2,11
"17534",2003,"106",3,0,3
"17535",2003,"107",2,0,2
"17536",2003,"108",2,0,2
"17537",2003,"109",2,0,2
"17538",2003,"110+",0,1,1
"17539",2004,"0",27523,29076,56599
"17540",2004,"1",27618,28641,56259
"17541",2004,"2",28195,29417,57612
"17542",2004,"3",29353,30750,60103
"17543",2004,"4",29419,30897,60316
"17544",2004,"5",29157,30510,59667
"17545",2004,"6",29836,31488,61324
"17546",2004,"7",30427,32261,62688
"17547",2004,"8",30147,31943,62090
"17548",2004,"9",30055,31790,61845
"17549",2004,"10",30111,31424,61535
"17550",2004,"11",30187,32310,62497
"17551",2004,"12",30700,32513,63213
"17552",2004,"13",30829,32417,63246
"17553",2004,"14",29933,31609,61542
"17554",2004,"15",29081,30656,59737
"17555",2004,"16",27760,28875,56635
"17556",2004,"17",26797,28621,55418
"17557",2004,"18",26377,27916,54293
"17558",2004,"19",26309,27428,53737
"17559",2004,"20",26098,27563,53661
"17560",2004,"21",26840,28039,54879
"17561",2004,"22",27091,27381,54472
"17562",2004,"23",27226,28049,55275
"17563",2004,"24",27716,28195,55911
"17564",2004,"25",27789,28506,56295
"17565",2004,"26",27758,28078,55836
"17566",2004,"27",28996,29391,58387
"17567",2004,"28",30502,30847,61349
"17568",2004,"29",32254,32570,64824
"17569",2004,"30",32599,33631,66230
"17570",2004,"31",34088,34994,69082
"17571",2004,"32",34675,35405,70080
"17572",2004,"33",34310,35316,69626
"17573",2004,"34",35521,36640,72161
"17574",2004,"35",35219,36562,71781
"17575",2004,"36",34571,35724,70295
"17576",2004,"37",34347,36186,70533
"17577",2004,"38",33961,35793,69754
"17578",2004,"39",33533,35338,68871
"17579",2004,"40",32694,33661,66355
"17580",2004,"41",31770,33268,65038
"17581",2004,"42",31538,32846,64384
"17582",2004,"43",31296,32553,63849
"17583",2004,"44",31462,32907,64369
"17584",2004,"45",31417,32432,63849
"17585",2004,"46",31148,31943,63091
"17586",2004,"47",31612,32285,63897
"17587",2004,"48",30866,31835,62701
"17588",2004,"49",30383,31137,61520
"17589",2004,"50",30279,30946,61225
"17590",2004,"51",29642,30697,60339
"17591",2004,"52",28185,29666,57851
"17592",2004,"53",28925,30176,59101
"17593",2004,"54",29077,30259,59336
"17594",2004,"55",29443,30870,60313
"17595",2004,"56",30366,31234,61600
"17596",2004,"57",31448,32445,63893
"17597",2004,"58",28193,28880,57073
"17598",2004,"59",26929,27763,54692
"17599",2004,"60",23982,24330,48312
"17600",2004,"61",22164,22104,44268
"17601",2004,"62",19465,19010,38475
"17602",2004,"63",20046,19684,39730
"17603",2004,"64",19523,18656,38179
"17604",2004,"65",18794,17712,36506
"17605",2004,"66",17874,16649,34523
"17606",2004,"67",17079,15793,32872
"17607",2004,"68",16637,14673,31310
"17608",2004,"69",16312,14488,30800
"17609",2004,"70",16122,14404,30526
"17610",2004,"71",17167,14890,32057
"17611",2004,"72",17087,14321,31408
"17612",2004,"73",17098,14426,31524
"17613",2004,"74",16561,13613,30174
"17614",2004,"75",16803,13142,29945
"17615",2004,"76",16278,12458,28736
"17616",2004,"77",16699,12462,29161
"17617",2004,"78",16159,11682,27841
"17618",2004,"79",16416,11374,27790
"17619",2004,"80",16196,10767,26963
"17620",2004,"81",15757,9695,25452
"17621",2004,"82",15129,8784,23913
"17622",2004,"83",15032,8447,23479
"17623",2004,"84",11489,6268,17757
"17624",2004,"85",11047,5591,16638
"17625",2004,"86",10250,4762,15012
"17626",2004,"87",8579,3735,12314
"17627",2004,"88",7350,3044,10394
"17628",2004,"89",6264,2522,8786
"17629",2004,"90",5138,2008,7146
"17630",2004,"91",4368,1501,5869
"17631",2004,"92",3370,1127,4497
"17632",2004,"93",2586,792,3378
"17633",2004,"94",1904,550,2454
"17634",2004,"95",1358,370,1728
"17635",2004,"96",997,262,1259
"17636",2004,"97",618,166,784
"17637",2004,"98",429,84,513
"17638",2004,"99",264,57,321
"17639",2004,"100",181,33,214
"17640",2004,"101",92,16,108
"17641",2004,"102",62,15,77
"17642",2004,"103",26,10,36
"17643",2004,"104",11,1,12
"17644",2004,"105",8,1,9
"17645",2004,"106",4,1,5
"17646",2004,"107",2,0,2
"17647",2004,"108",1,0,1
"17648",2004,"109",1,0,1
"17649",2004,"110+",1,0,1
"17650",2005,"0",27815,29272,57087
"17651",2005,"1",28066,29346,57412
"17652",2005,"2",27823,28793,56616
"17653",2005,"3",28283,29490,57773
"17654",2005,"4",29407,30851,60258
"17655",2005,"5",29483,30997,60480
"17656",2005,"6",29217,30579,59796
"17657",2005,"7",29909,31598,61507
"17658",2005,"8",30525,32343,62868
"17659",2005,"9",30222,32065,62287
"17660",2005,"10",30140,31881,62021
"17661",2005,"11",30194,31531,61725
"17662",2005,"12",30268,32384,62652
"17663",2005,"13",30791,32627,63418
"17664",2005,"14",30932,32486,63418
"17665",2005,"15",30014,31694,61708
"17666",2005,"16",29236,30802,60038
"17667",2005,"17",27887,29082,56969
"17668",2005,"18",26928,28776,55704
"17669",2005,"19",26623,28001,54624
"17670",2005,"20",26516,27536,54052
"17671",2005,"21",26252,27628,53880
"17672",2005,"22",27098,28104,55202
"17673",2005,"23",27450,27518,54968
"17674",2005,"24",27535,28269,55804
"17675",2005,"25",28079,28359,56438
"17676",2005,"26",28117,28739,56856
"17677",2005,"27",28045,28275,56320
"17678",2005,"28",29232,29605,58837
"17679",2005,"29",30775,31027,61802
"17680",2005,"30",32522,32783,65305
"17681",2005,"31",32747,33772,66519
"17682",2005,"32",34226,35148,69374
"17683",2005,"33",34806,35546,70352
"17684",2005,"34",34451,35395,69846
"17685",2005,"35",35606,36728,72334
"17686",2005,"36",35332,36637,71969
"17687",2005,"37",34621,35768,70389
"17688",2005,"38",34402,36241,70643
"17689",2005,"39",34010,35783,69793
"17690",2005,"40",33597,35371,68968
"17691",2005,"41",32747,33627,66374
"17692",2005,"42",31813,33244,65057
"17693",2005,"43",31543,32879,64422
"17694",2005,"44",31322,32535,63857
"17695",2005,"45",31473,32859,64332
"17696",2005,"46",31434,32390,63824
"17697",2005,"47",31123,31932,63055
"17698",2005,"48",31590,32240,63830
"17699",2005,"49",30822,31786,62608
"17700",2005,"50",30338,31069,61407
"17701",2005,"51",30225,30843,61068
"17702",2005,"52",29572,30567,60139
"17703",2005,"53",28124,29542,57666
"17704",2005,"54",28842,30028,58870
"17705",2005,"55",28980,30103,59083
"17706",2005,"56",29357,30674,60031
"17707",2005,"57",30242,31001,61243
"17708",2005,"58",31274,32197,63471
"17709",2005,"59",28033,28645,56678
"17710",2005,"60",26776,27502,54278
"17711",2005,"61",23837,24099,47936
"17712",2005,"62",22044,21860,43904
"17713",2005,"63",19351,18782,38133
"17714",2005,"64",19918,19447,39365
"17715",2005,"65",19357,18399,37756
"17716",2005,"66",18636,17394,36030
"17717",2005,"67",17674,16359,34033
"17718",2005,"68",16915,15499,32414
"17719",2005,"69",16428,14339,30767
"17720",2005,"70",16104,14161,30265
"17721",2005,"71",15897,14010,29907
"17722",2005,"72",16907,14461,31368
"17723",2005,"73",16773,13912,30685
"17724",2005,"74",16815,13905,30720
"17725",2005,"75",16190,13118,29308
"17726",2005,"76",16398,12595,28993
"17727",2005,"77",15798,11892,27690
"17728",2005,"78",16152,11852,28004
"17729",2005,"79",15620,11005,26625
"17730",2005,"80",15777,10594,26371
"17731",2005,"81",15405,9886,25291
"17732",2005,"82",14963,8870,23833
"17733",2005,"83",14243,7976,22219
"17734",2005,"84",14009,7584,21593
"17735",2005,"85",10582,5565,16147
"17736",2005,"86",10124,4919,15043
"17737",2005,"87",9220,4106,13326
"17738",2005,"88",7610,3148,10758
"17739",2005,"89",6402,2532,8934
"17740",2005,"90",5351,2040,7391
"17741",2005,"91",4290,1600,5890
"17742",2005,"92",3634,1162,4796
"17743",2005,"93",2683,829,3512
"17744",2005,"94",2019,582,2601
"17745",2005,"95",1458,412,1870
"17746",2005,"96",1023,237,1260
"17747",2005,"97",717,167,884
"17748",2005,"98",432,116,548
"17749",2005,"99",291,65,356
"17750",2005,"100",180,36,216
"17751",2005,"101",119,18,137
"17752",2005,"102",58,7,65
"17753",2005,"103",43,8,51
"17754",2005,"104",13,4,17
"17755",2005,"105",5,0,5
"17756",2005,"106",4,0,4
"17757",2005,"107",2,0,2
"17758",2005,"108",0,0,0
"17759",2005,"109",0,0,0
"17760",2005,"110+",0,0,0
"17761",2006,"0",27808,29165,56973
"17762",2006,"1",28221,29535,57756
"17763",2006,"2",28361,29504,57865
"17764",2006,"3",27899,28894,56793
"17765",2006,"4",28420,29576,57996
"17766",2006,"5",29479,30953,60432
"17767",2006,"6",29573,31138,60711
"17768",2006,"7",29358,30705,60063
"17769",2006,"8",30040,31732,61772
"17770",2006,"9",30635,32495,63130
"17771",2006,"10",30358,32204,62562
"17772",2006,"11",30271,31994,62265
"17773",2006,"12",30303,31649,61952
"17774",2006,"13",30374,32497,62871
"17775",2006,"14",30927,32743,63670
"17776",2006,"15",31045,32617,63662
"17777",2006,"16",30139,31807,61946
"17778",2006,"17",29348,30961,60309
"17779",2006,"18",28031,29205,57236
"17780",2006,"19",27178,28844,56022
"17781",2006,"20",26852,28111,54963
"17782",2006,"21",26716,27636,54352
"17783",2006,"22",26555,27785,54340
"17784",2006,"23",27509,28328,55837
"17785",2006,"24",27788,27728,55516
"17786",2006,"25",27948,28564,56512
"17787",2006,"26",28523,28661,57184
"17788",2006,"27",28520,29052,57572
"17789",2006,"28",28446,28571,57017
"17790",2006,"29",29584,29942,59526
"17791",2006,"30",31054,31353,62407
"17792",2006,"31",32742,33067,65809
"17793",2006,"32",32959,34033,66992
"17794",2006,"33",34437,35453,69890
"17795",2006,"34",35013,35768,70781
"17796",2006,"35",34636,35626,70262
"17797",2006,"36",35759,36869,72628
"17798",2006,"37",35467,36818,72285
"17799",2006,"38",34749,35899,70648
"17800",2006,"39",34471,36361,70832
"17801",2006,"40",34092,35849,69941
"17802",2006,"41",33674,35425,69099
"17803",2006,"42",32793,33745,66538
"17804",2006,"43",31869,33338,65207
"17805",2006,"44",31571,32914,64485
"17806",2006,"45",31350,32598,63948
"17807",2006,"46",31477,32877,64354
"17808",2006,"47",31433,32431,63864
"17809",2006,"48",31094,31919,63013
"17810",2006,"49",31541,32188,63729
"17811",2006,"50",30793,31728,62521
"17812",2006,"51",30274,30995,61269
"17813",2006,"52",30158,30764,60922
"17814",2006,"53",29512,30467,59979
"17815",2006,"54",28038,29416,57454
"17816",2006,"55",28765,29878,58643
"17817",2006,"56",28881,29937,58818
"17818",2006,"57",29226,30512,59738
"17819",2006,"58",30121,30780,60901
"17820",2006,"59",31118,31948,63066
"17821",2006,"60",27894,28395,56289
"17822",2006,"61",26607,27265,53872
"17823",2006,"62",23687,23806,47493
"17824",2006,"63",21896,21631,43527
"17825",2006,"64",19187,18554,37741
"17826",2006,"65",19743,19163,38906
"17827",2006,"66",19206,18147,37353
"17828",2006,"67",18460,17134,35594
"17829",2006,"68",17500,16042,33542
"17830",2006,"69",16729,15177,31906
"17831",2006,"70",16228,14004,30232
"17832",2006,"71",15854,13815,29669
"17833",2006,"72",15667,13674,29341
"17834",2006,"73",16647,14011,30658
"17835",2006,"74",16462,13424,29886
"17836",2006,"75",16448,13390,29838
"17837",2006,"76",15794,12568,28362
"17838",2006,"77",15952,12029,27981
"17839",2006,"78",15340,11267,26607
"17840",2006,"79",15575,11143,26718
"17841",2006,"80",15016,10301,25317
"17842",2006,"81",15106,9806,24912
"17843",2006,"82",14633,9077,23710
"17844",2006,"83",14137,8048,22185
"17845",2006,"84",13398,7169,20567
"17846",2006,"85",12983,6707,19690
"17847",2006,"86",9622,4837,14459
"17848",2006,"87",9155,4243,13398
"17849",2006,"88",8235,3452,11687
"17850",2006,"89",6632,2628,9260
"17851",2006,"90",5524,2014,7538
"17852",2006,"91",4485,1613,6098
"17853",2006,"92",3534,1237,4771
"17854",2006,"93",2936,902,3838
"17855",2006,"94",2102,607,2709
"17856",2006,"95",1545,410,1955
"17857",2006,"96",1061,280,1341
"17858",2006,"97",768,159,927
"17859",2006,"98",473,120,593
"17860",2006,"99",305,75,380
"17861",2006,"100",178,40,218
"17862",2006,"101",109,22,131
"17863",2006,"102",78,9,87
"17864",2006,"103",32,5,37
"17865",2006,"104",20,4,24
"17866",2006,"105",7,3,10
"17867",2006,"106",4,0,4
"17868",2006,"107",2,0,2
"17869",2006,"108",1,0,1
"17870",2006,"109",0,0,0
"17871",2006,"110+",0,0,0
"17872",2007,"0",28654,30077,58731
"17873",2007,"1",28197,29507,57704
"17874",2007,"2",28510,29732,58242
"17875",2007,"3",28449,29656,58105
"17876",2007,"4",28002,29001,57003
"17877",2007,"5",28536,29728,58264
"17878",2007,"6",29588,31075,60663
"17879",2007,"7",29682,31267,60949
"17880",2007,"8",29505,30835,60340
"17881",2007,"9",30125,31853,61978
"17882",2007,"10",30769,32617,63386
"17883",2007,"11",30463,32311,62774
"17884",2007,"12",30385,32127,62512
"17885",2007,"13",30423,31802,62225
"17886",2007,"14",30464,32591,63055
"17887",2007,"15",31025,32858,63883
"17888",2007,"16",31182,32743,63925
"17889",2007,"17",30314,31950,62264
"17890",2007,"18",29513,31074,60587
"17891",2007,"19",28321,29290,57611
"17892",2007,"20",27371,29001,56372
"17893",2007,"21",27055,28267,55322
"17894",2007,"22",27034,27902,54936
"17895",2007,"23",27000,28152,55152
"17896",2007,"24",27973,28742,56715
"17897",2007,"25",28162,28257,56419
"17898",2007,"26",28437,29163,57600
"17899",2007,"27",29024,29244,58268
"17900",2007,"28",29024,29581,58605
"17901",2007,"29",28801,29145,57946
"17902",2007,"30",29941,30475,60416
"17903",2007,"31",31353,31762,63115
"17904",2007,"32",33011,33483,66494
"17905",2007,"33",33138,34397,67535
"17906",2007,"34",34658,35790,70448
"17907",2007,"35",35207,36106,71313
"17908",2007,"36",34842,35914,70756
"17909",2007,"37",35933,37154,73087
"17910",2007,"38",35591,37064,72655
"17911",2007,"39",34882,36111,70993
"17912",2007,"40",34540,36568,71108
"17913",2007,"41",34166,36054,70220
"17914",2007,"42",33750,35598,69348
"17915",2007,"43",32822,33909,66731
"17916",2007,"44",31880,33512,65392
"17917",2007,"45",31604,33022,64626
"17918",2007,"46",31356,32712,64068
"17919",2007,"47",31451,32951,64402
"17920",2007,"48",31452,32507,63959
"17921",2007,"49",31045,31969,63014
"17922",2007,"50",31530,32218,63748
"17923",2007,"51",30762,31708,62470
"17924",2007,"52",30214,30972,61186
"17925",2007,"53",30104,30690,60794
"17926",2007,"54",29447,30384,59831
"17927",2007,"55",27984,29303,57287
"17928",2007,"56",28664,29754,58418
"17929",2007,"57",28761,29789,58550
"17930",2007,"58",29110,30323,59433
"17931",2007,"59",30000,30544,60544
"17932",2007,"60",30951,31705,62656
"17933",2007,"61",27735,28121,55856
"17934",2007,"62",26442,26961,53403
"17935",2007,"63",23495,23531,47026
"17936",2007,"64",21734,21385,43119
"17937",2007,"65",19058,18301,37359
"17938",2007,"66",19596,18895,38491
"17939",2007,"67",19034,17850,36884
"17940",2007,"68",18267,16822,35089
"17941",2007,"69",17308,15702,33010
"17942",2007,"70",16566,14878,31444
"17943",2007,"71",16021,13714,29735
"17944",2007,"72",15612,13444,29056
"17945",2007,"73",15420,13242,28662
"17946",2007,"74",16330,13599,29929
"17947",2007,"75",16104,12946,29050
"17948",2007,"76",16051,12880,28931
"17949",2007,"77",15369,12049,27418
"17950",2007,"78",15494,11444,26938
"17951",2007,"79",14795,10644,25439
"17952",2007,"80",15023,10469,25492
"17953",2007,"81",14355,9583,23938
"17954",2007,"82",14318,9053,23371
"17955",2007,"83",13731,8259,21990
"17956",2007,"84",13190,7262,20452
"17957",2007,"85",12360,6352,18712
"17958",2007,"86",11881,5876,17757
"17959",2007,"87",8698,4179,12877
"17960",2007,"88",8163,3606,11769
"17961",2007,"89",7183,2894,10077
"17962",2007,"90",5651,2138,7789
"17963",2007,"91",4660,1609,6269
"17964",2007,"92",3662,1260,4922
"17965",2007,"93",2836,937,3773
"17966",2007,"94",2313,692,3005
"17967",2007,"95",1579,445,2024
"17968",2007,"96",1134,300,1434
"17969",2007,"97",738,170,908
"17970",2007,"98",525,111,636
"17971",2007,"99",319,74,393
"17972",2007,"100",199,49,248
"17973",2007,"101",126,22,148
"17974",2007,"102",70,14,84
"17975",2007,"103",40,4,44
"17976",2007,"104",21,1,22
"17977",2007,"105",10,3,13
"17978",2007,"106",3,1,4
"17979",2007,"107",3,0,3
"17980",2007,"108",1,0,1
"17981",2007,"109",0,0,0
"17982",2007,"110+",0,0,0
"17983",2008,"0",28571,30054,58625
"17984",2008,"1",29022,30519,59541
"17985",2008,"2",28592,29799,58391
"17986",2008,"3",28715,29980,58695
"17987",2008,"4",28673,29878,58551
"17988",2008,"5",28212,29149,57361
"17989",2008,"6",28691,29914,58605
"17990",2008,"7",29773,31258,61031
"17991",2008,"8",29833,31440,61273
"17992",2008,"9",29666,31025,60691
"17993",2008,"10",30297,32067,62364
"17994",2008,"11",30958,32778,63736
"17995",2008,"12",30624,32518,63142
"17996",2008,"13",30545,32279,62824
"17997",2008,"14",30578,31969,62547
"17998",2008,"15",30605,32747,63352
"17999",2008,"16",31173,33037,64210
"18000",2008,"17",31378,32962,64340
"18001",2008,"18",30457,32117,62574
"18002",2008,"19",29821,31272,61093
"18003",2008,"20",28630,29609,58239
"18004",2008,"21",27757,29364,57121
"18005",2008,"22",27533,28819,56352
"18006",2008,"23",27619,28566,56185
"18007",2008,"24",27717,28961,56678
"18008",2008,"25",28712,29640,58352
"18009",2008,"26",29047,29277,58324
"18010",2008,"27",29270,30220,59490
"18011",2008,"28",29775,30257,60032
"18012",2008,"29",29640,30519,60159
"18013",2008,"30",29306,30083,59389
"18014",2008,"31",30412,31352,61764
"18015",2008,"32",31747,32593,64340
"18016",2008,"33",33342,34269,67611
"18017",2008,"34",33448,35096,68544
"18018",2008,"35",34966,36431,71397
"18019",2008,"36",35457,36746,72203
"18020",2008,"37",35065,36518,71583
"18021",2008,"38",36134,37647,73781
"18022",2008,"39",35790,37534,73324
"18023",2008,"40",35027,36597,71624
"18024",2008,"41",34678,36973,71651
"18025",2008,"42",34276,36470,70746
"18026",2008,"43",33837,35937,69774
"18027",2008,"44",32930,34261,67191
"18028",2008,"45",31939,33816,65755
"18029",2008,"46",31661,33286,64947
"18030",2008,"47",31388,32973,64361
"18031",2008,"48",31491,33147,64638
"18032",2008,"49",31449,32644,64093
"18033",2008,"50",31046,32126,63172
"18034",2008,"51",31512,32346,63858
"18035",2008,"52",30746,31741,62487
"18036",2008,"53",30186,30968,61154
"18037",2008,"54",30053,30668,60721
"18038",2008,"55",29375,30349,59724
"18039",2008,"56",27901,29227,57128
"18040",2008,"57",28592,29619,58211
"18041",2008,"58",28663,29652,58315
"18042",2008,"59",28987,30158,59145
"18043",2008,"60",29842,30305,60147
"18044",2008,"61",30799,31462,62261
"18045",2008,"62",27596,27854,55450
"18046",2008,"63",26258,26669,52927
"18047",2008,"64",23313,23256,46569
"18048",2008,"65",21563,21057,42620
"18049",2008,"66",18914,18046,36960
"18050",2008,"67",19408,18571,37979
"18051",2008,"68",18839,17517,36356
"18052",2008,"69",18086,16499,34585
"18053",2008,"70",17100,15374,32474
"18054",2008,"71",16375,14550,30925
"18055",2008,"72",15785,13346,29131
"18056",2008,"73",15364,13085,28449
"18057",2008,"74",15126,12825,27951
"18058",2008,"75",15963,13106,29069
"18059",2008,"76",15727,12436,28163
"18060",2008,"77",15618,12293,27911
"18061",2008,"78",14901,11438,26339
"18062",2008,"79",14984,10818,25802
"18063",2008,"80",14224,9959,24183
"18064",2008,"81",14392,9714,24106
"18065",2008,"82",13589,8852,22441
"18066",2008,"83",13473,8221,21694
"18067",2008,"84",12820,7438,20258
"18068",2008,"85",12180,6465,18645
"18069",2008,"86",11303,5539,16842
"18070",2008,"87",10746,5043,15789
"18071",2008,"88",7747,3555,11302
"18072",2008,"89",7120,3007,10127
"18073",2008,"90",6167,2361,8528
"18074",2008,"91",4764,1685,6449
"18075",2008,"92",3864,1231,5095
"18076",2008,"93",2949,946,3895
"18077",2008,"94",2226,677,2903
"18078",2008,"95",1771,482,2253
"18079",2008,"96",1164,308,1472
"18080",2008,"97",813,194,1007
"18081",2008,"98",489,113,602
"18082",2008,"99",359,71,430
"18083",2008,"100",198,44,242
"18084",2008,"101",112,24,136
"18085",2008,"102",85,10,95
"18086",2008,"103",39,6,45
"18087",2008,"104",24,3,27
"18088",2008,"105",13,1,14
"18089",2008,"106",6,3,9
"18090",2008,"107",2,1,3
"18091",2008,"108",3,0,3
"18092",2008,"109",1,0,1
"18093",2008,"110+",0,0,0
"18094",2009,"0",29434,31239,60673
"18095",2009,"1",29004,30466,59470
"18096",2009,"2",29375,30875,60250
"18097",2009,"3",28859,30030,58889
"18098",2009,"4",28944,30234,59178
"18099",2009,"5",28880,30111,58991
"18100",2009,"6",28436,29349,57785
"18101",2009,"7",28892,30152,59044
"18102",2009,"8",29993,31447,61440
"18103",2009,"9",30056,31621,61677
"18104",2009,"10",29876,31243,61119
"18105",2009,"11",30535,32285,62820
"18106",2009,"12",31159,32966,64125
"18107",2009,"13",30804,32735,63539
"18108",2009,"14",30755,32461,63216
"18109",2009,"15",30744,32165,62909
"18110",2009,"16",30781,32974,63755
"18111",2009,"17",31355,33246,64601
"18112",2009,"18",31579,33175,64754
"18113",2009,"19",30794,32401,63195
"18114",2009,"20",30176,31565,61741
"18115",2009,"21",29104,30003,59107
"18116",2009,"22",28348,29946,58294
"18117",2009,"23",28267,29505,57772
"18118",2009,"24",28447,29375,57822
"18119",2009,"25",28672,29912,58584
"18120",2009,"26",29660,30719,60379
"18121",2009,"27",29944,30317,60261
"18122",2009,"28",30184,31316,61500
"18123",2009,"29",30517,31343,61860
"18124",2009,"30",30309,31480,61789
"18125",2009,"31",29890,30870,60760
"18126",2009,"32",30931,32174,63105
"18127",2009,"33",32190,33285,65475
"18128",2009,"34",33738,34974,68712
"18129",2009,"35",33798,35792,69590
"18130",2009,"36",35312,37014,72326
"18131",2009,"37",35768,37347,73115
"18132",2009,"38",35331,37031,72362
"18133",2009,"39",36381,38069,74450
"18134",2009,"40",36030,37965,73995
"18135",2009,"41",35236,37005,72241
"18136",2009,"42",34845,37345,72190
"18137",2009,"43",34411,36794,71205
"18138",2009,"44",33964,36237,70201
"18139",2009,"45",33078,34539,67617
"18140",2009,"46",32070,34050,66120
"18141",2009,"47",31761,33479,65240
"18142",2009,"48",31438,33160,64598
"18143",2009,"49",31553,33301,64854
"18144",2009,"50",31488,32792,64280
"18145",2009,"51",31050,32200,63250
"18146",2009,"52",31500,32354,63854
"18147",2009,"53",30734,31752,62486
"18148",2009,"54",30141,30948,61089
"18149",2009,"55",30002,30614,60616
"18150",2009,"56",29346,30232,59578
"18151",2009,"57",27831,29117,56948
"18152",2009,"58",28485,29449,57934
"18153",2009,"59",28552,29497,58049
"18154",2009,"60",28855,29922,58777
"18155",2009,"61",29714,30067,59781
"18156",2009,"62",30602,31161,61763
"18157",2009,"63",27393,27500,54893
"18158",2009,"64",26086,26361,52447
"18159",2009,"65",23126,22963,46089
"18160",2009,"66",21361,20748,42109
"18161",2009,"67",18744,17756,36500
"18162",2009,"68",19207,18220,37427
"18163",2009,"69",18635,17209,35844
"18164",2009,"70",17909,16191,34100
"18165",2009,"71",16878,15028,31906
"18166",2009,"72",16138,14193,30331
"18167",2009,"73",15490,12975,28465
"18168",2009,"74",15116,12688,27804
"18169",2009,"75",14801,12390,27191
"18170",2009,"76",15624,12631,28255
"18171",2009,"77",15317,11903,27220
"18172",2009,"78",15145,11666,26811
"18173",2009,"79",14394,10735,25129
"18174",2009,"80",14449,10141,24590
"18175",2009,"81",13579,9284,22863
"18176",2009,"82",13706,8977,22683
"18177",2009,"83",12794,8114,20908
"18178",2009,"84",12583,7416,19999
"18179",2009,"85",11870,6608,18478
"18180",2009,"86",11193,5672,16865
"18181",2009,"87",10209,4718,14927
"18182",2009,"88",9595,4274,13869
"18183",2009,"89",6884,2983,9867
"18184",2009,"90",6161,2463,8624
"18185",2009,"91",5216,1883,7099
"18186",2009,"92",3936,1239,5175
"18187",2009,"93",3142,927,4069
"18188",2009,"94",2323,693,3016
"18189",2009,"95",1743,472,2215
"18190",2009,"96",1297,338,1635
"18191",2009,"97",861,198,1059
"18192",2009,"98",560,128,688
"18193",2009,"99",339,66,405
"18194",2009,"100",223,44,267
"18195",2009,"101",126,20,146
"18196",2009,"102",70,10,80
"18197",2009,"103",48,8,56
"18198",2009,"104",20,4,24
"18199",2009,"105",11,1,12
"18200",2009,"106",4,1,5
"18201",2009,"107",3,1,4
"18202",2009,"108",0,1,1
"18203",2009,"109",3,0,3
"18204",2009,"110+",0,0,0
"18205",2010,"0",30136,31928,62064
"18206",2010,"1",29865,31697,61562
"18207",2010,"2",29333,30815,60148
"18208",2010,"3",29645,31161,60806
"18209",2010,"4",29067,30281,59348
"18210",2010,"5",29151,30518,59669
"18211",2010,"6",29061,30289,59350
"18212",2010,"7",28598,29573,58171
"18213",2010,"8",29081,30352,59433
"18214",2010,"9",30166,31684,61850
"18215",2010,"10",30251,31845,62096
"18216",2010,"11",30064,31461,61525
"18217",2010,"12",30733,32488,63221
"18218",2010,"13",31338,33186,64524
"18219",2010,"14",30983,32975,63958
"18220",2010,"15",30915,32702,63617
"18221",2010,"16",30945,32486,63431
"18222",2010,"17",30933,33450,64383
"18223",2010,"18",31562,33629,65191
"18224",2010,"19",31929,33481,65410
"18225",2010,"20",31166,32626,63792
"18226",2010,"21",30711,31900,62611
"18227",2010,"22",29765,30359,60124
"18228",2010,"23",29126,30522,59648
"18229",2010,"24",29144,30195,59339
"18230",2010,"25",29452,30233,59685
"18231",2010,"26",29658,30830,60488
"18232",2010,"27",30555,31553,62108
"18233",2010,"28",30732,31058,61790
"18234",2010,"29",30966,32066,63032
"18235",2010,"30",31121,32004,63125
"18236",2010,"31",30841,32132,62973
"18237",2010,"32",30282,31441,61723
"18238",2010,"33",31289,32672,63961
"18239",2010,"34",32620,33756,66376
"18240",2010,"35",34138,35345,69483
"18241",2010,"36",34121,36144,70265
"18242",2010,"37",35598,37338,72936
"18243",2010,"38",36031,37626,73657
"18244",2010,"39",35583,37379,72962
"18245",2010,"40",36579,38314,74893
"18246",2010,"41",36241,38176,74417
"18247",2010,"42",35431,37225,72656
"18248",2010,"43",35020,37515,72535
"18249",2010,"44",34568,36950,71518
"18250",2010,"45",34104,36402,70506
"18251",2010,"46",33148,34671,67819
"18252",2010,"47",32169,34141,66310
"18253",2010,"48",31831,33547,65378
"18254",2010,"49",31490,33173,64663
"18255",2010,"50",31586,33367,64953
"18256",2010,"51",31510,32806,64316
"18257",2010,"52",31046,32136,63182
"18258",2010,"53",31485,32325,63810
"18259",2010,"54",30693,31645,62338
"18260",2010,"55",30137,30846,60983
"18261",2010,"56",29956,30455,60411
"18262",2010,"57",29292,30132,59424
"18263",2010,"58",27741,28957,56698
"18264",2010,"59",28424,29275,57699
"18265",2010,"60",28459,29310,57769
"18266",2010,"61",28731,29688,58419
"18267",2010,"62",29555,29821,59376
"18268",2010,"63",30391,30842,61233
"18269",2010,"64",27210,27175,54385
"18270",2010,"65",25891,26049,51940
"18271",2010,"66",22949,22641,45590
"18272",2010,"67",21175,20429,41604
"18273",2010,"68",18569,17434,36003
"18274",2010,"69",19010,17914,36924
"18275",2010,"70",18406,16880,35286
"18276",2010,"71",17677,15856,33533
"18277",2010,"72",16681,14678,31359
"18278",2010,"73",15904,13833,29737
"18279",2010,"74",15233,12586,27819
"18280",2010,"75",14831,12261,27092
"18281",2010,"76",14449,11967,26416
"18282",2010,"77",15264,12112,27376
"18283",2010,"78",14895,11341,26236
"18284",2010,"79",14679,11057,25736
"18285",2010,"80",13848,10134,23982
"18286",2010,"81",13812,9484,23296
"18287",2010,"82",12950,8562,21512
"18288",2010,"83",12915,8239,21154
"18289",2010,"84",11955,7355,19310
"18290",2010,"85",11664,6638,18302
"18291",2010,"86",10854,5793,16647
"18292",2010,"87",10160,4938,15098
"18293",2010,"88",9096,4042,13138
"18294",2010,"89",8429,3596,12025
"18295",2010,"90",5982,2423,8405
"18296",2010,"91",5258,1976,7234
"18297",2010,"92",4309,1470,5779
"18298",2010,"93",3200,950,4150
"18299",2010,"94",2478,686,3164
"18300",2010,"95",1785,515,2300
"18301",2010,"96",1286,316,1602
"18302",2010,"97",926,229,1155
"18303",2010,"98",613,130,743
"18304",2010,"99",376,81,457
"18305",2010,"100",210,42,252
"18306",2010,"101",143,28,171
"18307",2010,"102",74,11,85
"18308",2010,"103",36,6,42
"18309",2010,"104",25,3,28
"18310",2010,"105",10,1,11
"18311",2010,"106",6,0,6
"18312",2010,"107",3,1,4
"18313",2010,"108",1,0,1
"18314",2010,"109",0,1,1
"18315",2010,"110+",2,0,2
"18316",2011,"0",30079,31573,61652
"18317",2011,"1",30586,32375,62961
"18318",2011,"2",30213,32053,62266
"18319",2011,"3",29648,31118,60766
"18320",2011,"4",29848,31333,61181
"18321",2011,"5",29231,30519,59750
"18322",2011,"6",29326,30703,60029
"18323",2011,"7",29245,30447,59692
"18324",2011,"8",28758,29777,58535
"18325",2011,"9",29267,30506,59773
"18326",2011,"10",30354,31859,62213
"18327",2011,"11",30431,32062,62493
"18328",2011,"12",30244,31659,61903
"18329",2011,"13",30897,32681,63578
"18330",2011,"14",31522,33395,64917
"18331",2011,"15",31113,33202,64315
"18332",2011,"16",31100,33033,64133
"18333",2011,"17",31150,33067,64217
"18334",2011,"18",31155,33839,64994
"18335",2011,"19",31982,33983,65965
"18336",2011,"20",32490,33873,66363
"18337",2011,"21",31847,33163,65010
"18338",2011,"22",31526,32555,64081
"18339",2011,"23",30723,31160,61883
"18340",2011,"24",30177,31502,61679
"18341",2011,"25",30242,31179,61421
"18342",2011,"26",30561,31267,61828
"18343",2011,"27",30616,31894,62510
"18344",2011,"28",31445,32545,63990
"18345",2011,"29",31397,31964,63361
"18346",2011,"30",31568,32895,64463
"18347",2011,"31",31557,32667,64224
"18348",2011,"32",31252,32813,64065
"18349",2011,"33",30737,32098,62835
"18350",2011,"34",31672,33216,64888
"18351",2011,"35",32950,34207,67157
"18352",2011,"36",34466,35826,70292
"18353",2011,"37",34391,36500,70891
"18354",2011,"38",35835,37687,73522
"18355",2011,"39",36260,37917,74177
"18356",2011,"40",35798,37649,73447
"18357",2011,"41",36776,38575,75351
"18358",2011,"42",36430,38410,74840
"18359",2011,"43",35565,37439,73004
"18360",2011,"44",35158,37683,72841
"18361",2011,"45",34692,37085,71777
"18362",2011,"46",34216,36579,70795
"18363",2011,"47",33268,34755,68023
"18364",2011,"48",32233,34254,66487
"18365",2011,"49",31849,33560,65409
"18366",2011,"50",31546,33197,64743
"18367",2011,"51",31586,33368,64954
"18368",2011,"52",31503,32817,64320
"18369",2011,"53",31010,32122,63132
"18370",2011,"54",31440,32276,63716
"18371",2011,"55",30647,31557,62204
"18372",2011,"56",30081,30738,60819
"18373",2011,"57",29873,30321,60194
"18374",2011,"58",29201,30000,59201
"18375",2011,"59",27651,28773,56424
"18376",2011,"60",28290,29111,57401
"18377",2011,"61",28307,29110,57417
"18378",2011,"62",28580,29427,58007
"18379",2011,"63",29382,29484,58866
"18380",2011,"64",30207,30510,60717
"18381",2011,"65",27002,26846,53848
"18382",2011,"66",25700,25658,51358
"18383",2011,"67",22725,22305,45030
"18384",2011,"68",20981,20083,41064
"18385",2011,"69",18363,17104,35467
"18386",2011,"70",18820,17588,36408
"18387",2011,"71",18167,16507,34674
"18388",2011,"72",17432,15498,32930
"18389",2011,"73",16416,14289,30705
"18390",2011,"74",15606,13453,29059
"18391",2011,"75",14923,12196,27119
"18392",2011,"76",14482,11812,26294
"18393",2011,"77",14107,11445,25552
"18394",2011,"78",14857,11566,26423
"18395",2011,"79",14401,10758,25159
"18396",2011,"80",14154,10458,24612
"18397",2011,"81",13237,9453,22690
"18398",2011,"82",13193,8779,21972
"18399",2011,"83",12232,7860,20092
"18400",2011,"84",12114,7448,19562
"18401",2011,"85",11137,6616,17753
"18402",2011,"86",10733,5879,16612
"18403",2011,"87",9891,5027,14918
"18404",2011,"88",9085,4264,13349
"18405",2011,"89",8033,3378,11411
"18406",2011,"90",7286,2984,10270
"18407",2011,"91",5085,1928,7013
"18408",2011,"92",4378,1552,5930
"18409",2011,"93",3500,1115,4615
"18410",2011,"94",2525,690,3215
"18411",2011,"95",1916,491,2407
"18412",2011,"96",1310,371,1681
"18413",2011,"97",924,221,1145
"18414",2011,"98",642,143,785
"18415",2011,"99",435,81,516
"18416",2011,"100",223,46,269
"18417",2011,"101",128,23,151
"18418",2011,"102",92,11,103
"18419",2011,"103",42,6,48
"18420",2011,"104",22,5,27
"18421",2011,"105",17,1,18
"18422",2011,"106",4,0,4
"18423",2011,"107",1,0,1
"18424",2011,"108",3,0,3
"18425",2011,"109",1,0,1
"18426",2011,"110+",0,0,0
"18427",2012,"0",29330,31136,60466
"18428",2012,"1",30517,32004,62521
"18429",2012,"2",30948,32765,63713
"18430",2012,"3",30441,32369,62810
"18431",2012,"4",29868,31389,61257
"18432",2012,"5",30073,31598,61671
"18433",2012,"6",29439,30681,60120
"18434",2012,"7",29516,30917,60433
"18435",2012,"8",29406,30604,60010
"18436",2012,"9",28910,29925,58835
"18437",2012,"10",29451,30657,60108
"18438",2012,"11",30533,32039,62572
"18439",2012,"12",30572,32271,62843
"18440",2012,"13",30397,31838,62235
"18441",2012,"14",31080,32901,63981
"18442",2012,"15",31682,33590,65272
"18443",2012,"16",31335,33438,64773
"18444",2012,"17",31264,33341,64605
"18445",2012,"18",31359,33369,64728
"18446",2012,"19",31522,34090,65612
"18447",2012,"20",32401,34358,66759
"18448",2012,"21",33083,34366,67449
"18449",2012,"22",32603,33914,66517
"18450",2012,"23",32440,33452,65892
"18451",2012,"24",31716,32262,63978
"18452",2012,"25",31291,32779,64070
"18453",2012,"26",31328,32398,63726
"18454",2012,"27",31534,32473,64007
"18455",2012,"28",31511,33084,64595
"18456",2012,"29",32170,33624,65794
"18457",2012,"30",32072,32899,64971
"18458",2012,"31",32085,33866,65951
"18459",2012,"32",32014,33596,65610
"18460",2012,"33",31675,33611,65286
"18461",2012,"34",31157,32864,64021
"18462",2012,"35",32019,33971,65990
"18463",2012,"36",33271,34873,68144
"18464",2012,"37",34768,36400,71168
"18465",2012,"38",34680,37030,71710
"18466",2012,"39",36102,38221,74323
"18467",2012,"40",36475,38341,74816
"18468",2012,"41",36047,38053,74100
"18469",2012,"42",36982,38952,75934
"18470",2012,"43",36618,38727,75345
"18471",2012,"44",35736,37719,73455
"18472",2012,"45",35256,37910,73166
"18473",2012,"46",34851,37315,72166
"18474",2012,"47",34317,36743,71060
"18475",2012,"48",33320,34942,68262
"18476",2012,"49",32322,34381,66703
"18477",2012,"50",31915,33664,65579
"18478",2012,"51",31559,33284,64843
"18479",2012,"52",31600,33431,65031
"18480",2012,"53",31494,32859,64353
"18481",2012,"54",30985,32122,63107
"18482",2012,"55",31390,32257,63647
"18483",2012,"56",30591,31501,62092
"18484",2012,"57",29982,30633,60615
"18485",2012,"58",29789,30211,60000
"18486",2012,"59",29086,29823,58909
"18487",2012,"60",27545,28603,56148
"18488",2012,"61",28181,28898,57079
"18489",2012,"62",28136,28844,56980
"18490",2012,"63",28390,29129,57519
"18491",2012,"64",29210,29211,58421
"18492",2012,"65",29985,30120,60105
"18493",2012,"66",26807,26501,53308
"18494",2012,"67",25473,25242,50715
"18495",2012,"68",22513,21968,44481
"18496",2012,"69",20760,19737,40497
"18497",2012,"70",18174,16783,34957
"18498",2012,"71",18611,17217,35828
"18499",2012,"72",17942,16138,34080
"18500",2012,"73",17172,15120,32292
"18501",2012,"74",16135,13832,29967
"18502",2012,"75",15331,13000,28331
"18503",2012,"76",14615,11770,26385
"18504",2012,"77",14102,11360,25462
"18505",2012,"78",13716,10934,24650
"18506",2012,"79",14410,10963,25373
"18507",2012,"80",13886,10211,24097
"18508",2012,"81",13570,9748,23318
"18509",2012,"82",12636,8805,21441
"18510",2012,"83",12487,8097,20584
"18511",2012,"84",11510,7095,18605
"18512",2012,"85",11298,6667,17965
"18513",2012,"86",10201,5874,16075
"18514",2012,"87",9768,5094,14862
"18515",2012,"88",8875,4311,13186
"18516",2012,"89",8025,3613,11638
"18517",2012,"90",6992,2800,9792
"18518",2012,"91",6106,2433,8539
"18519",2012,"92",4241,1485,5726
"18520",2012,"93",3537,1224,4761
"18521",2012,"94",2768,844,3612
"18522",2012,"95",1950,490,2440
"18523",2012,"96",1426,327,1753
"18524",2012,"97",949,252,1201
"18525",2012,"98",662,149,811
"18526",2012,"99",462,86,548
"18527",2012,"100",285,58,343
"18528",2012,"101",136,26,162
"18529",2012,"102",80,14,94
"18530",2012,"103",53,6,59
"18531",2012,"104",21,4,25
"18532",2012,"105",11,2,13
"18533",2012,"106",12,0,12
"18534",2012,"107",2,0,2
"18535",2012,"108",0,0,0
"18536",2012,"109",1,0,1
"18537",2012,"110+",0,0,0
"18538",2013,"0",29504,31026,60530
"18539",2013,"1",29776,31653,61429
"18540",2013,"2",30995,32432,63427
"18541",2013,"3",31342,33101,64443
"18542",2013,"4",30739,32647,63386
"18543",2013,"5",30128,31671,61799
"18544",2013,"6",30319,31789,62108
"18545",2013,"7",29637,30886,60523
"18546",2013,"8",29703,31126,60829
"18547",2013,"9",29614,30829,60443
"18548",2013,"10",29066,30117,59183
"18549",2013,"11",29618,30825,60443
"18550",2013,"12",30724,32256,62980
"18551",2013,"13",30756,32502,63258
"18552",2013,"14",30559,32044,62603
"18553",2013,"15",31266,33137,64403
"18554",2013,"16",31921,33870,65791
"18555",2013,"17",31576,33743,65319
"18556",2013,"18",31499,33593,65092
"18557",2013,"19",31769,33695,65464
"18558",2013,"20",32002,34549,66551
"18559",2013,"21",32905,34817,67722
"18560",2013,"22",33787,34977,68764
"18561",2013,"23",33443,34734,68177
"18562",2013,"24",33421,34412,67833
"18563",2013,"25",32886,33416,66302
"18564",2013,"26",32444,34031,66475
"18565",2013,"27",32367,33602,65969
"18566",2013,"28",32514,33596,66110
"18567",2013,"29",32350,34227,66577
"18568",2013,"30",32915,34725,67640
"18569",2013,"31",32554,33920,66474
"18570",2013,"32",32616,34747,67363
"18571",2013,"33",32485,34482,66967
"18572",2013,"34",32129,34396,66525
"18573",2013,"35",31601,33555,65156
"18574",2013,"36",32379,34571,66950
"18575",2013,"37",33584,35415,68999
"18576",2013,"38",35081,36874,71955
"18577",2013,"39",35012,37495,72507
"18578",2013,"40",36359,38622,74981
"18579",2013,"41",36651,38699,75350
"18580",2013,"42",36244,38375,74619
"18581",2013,"43",37118,39233,76351
"18582",2013,"44",36778,38973,75751
"18583",2013,"45",35861,37895,73756
"18584",2013,"46",35356,38068,73424
"18585",2013,"47",34941,37445,72386
"18586",2013,"48",34394,36838,71232
"18587",2013,"49",33378,35042,68420
"18588",2013,"50",32353,34412,66765
"18589",2013,"51",31953,33714,65667
"18590",2013,"52",31587,33294,64881
"18591",2013,"53",31592,33453,65045
"18592",2013,"54",31466,32855,64321
"18593",2013,"55",30955,32053,63008
"18594",2013,"56",31347,32202,63549
"18595",2013,"57",30530,31386,61916
"18596",2013,"58",29905,30490,60395
"18597",2013,"59",29692,30037,59729
"18598",2013,"60",28970,29623,58593
"18599",2013,"61",27441,28378,55819
"18600",2013,"62",28025,28610,56635
"18601",2013,"63",28003,28569,56572
"18602",2013,"64",28195,28832,57027
"18603",2013,"65",28995,28886,57881
"18604",2013,"66",29764,29757,59521
"18605",2013,"67",26564,26071,52635
"18606",2013,"68",25223,24842,50065
"18607",2013,"69",22253,21617,43870
"18608",2013,"70",20529,19383,39912
"18609",2013,"71",17945,16450,34395
"18610",2013,"72",18316,16807,35123
"18611",2013,"73",17666,15730,33396
"18612",2013,"74",16876,14702,31578
"18613",2013,"75",15801,13455,29256
"18614",2013,"76",15005,12560,27565
"18615",2013,"77",14274,11355,25629
"18616",2013,"78",13715,10856,24571
"18617",2013,"79",13273,10359,23632
"18618",2013,"80",13912,10407,24319
"18619",2013,"81",13344,9572,22916
"18620",2013,"82",12921,9045,21966
"18621",2013,"83",11898,8060,19958
"18622",2013,"84",11731,7317,19048
"18623",2013,"85",10706,6384,17090
"18624",2013,"86",10412,5930,16342
"18625",2013,"87",9237,5175,14412
"18626",2013,"88",8771,4353,13124
"18627",2013,"89",7853,3662,11515
"18628",2013,"90",6880,2951,9831
"18629",2013,"91",5978,2240,8218
"18630",2013,"92",5037,1912,6949
"18631",2013,"93",3437,1110,4547
"18632",2013,"94",2767,895,3662
"18633",2013,"95",2123,631,2754
"18634",2013,"96",1420,329,1749
"18635",2013,"97",1000,230,1230
"18636",2013,"98",656,150,806
"18637",2013,"99",424,99,523
"18638",2013,"100",295,62,357
"18639",2013,"101",170,42,212
"18640",2013,"102",75,14,89
"18641",2013,"103",39,7,46
"18642",2013,"104",33,1,34
"18643",2013,"105",12,3,15
"18644",2013,"106",6,0,6
"18645",2013,"107",3,0,3
"18646",2013,"108",1,0,1
"18647",2013,"109",0,0,0
"18648",2013,"110+",0,0,0
"18649",2014,"0",29005,30330,59335
"18650",2014,"1",29908,31532,61440
"18651",2014,"2",30149,32035,62184
"18652",2014,"3",31228,32758,63986
"18653",2014,"4",31605,33362,64967
"18654",2014,"5",30973,32859,63832
"18655",2014,"6",30340,31906,62246
"18656",2014,"7",30509,31972,62481
"18657",2014,"8",29825,31115,60940
"18658",2014,"9",29938,31313,61251
"18659",2014,"10",29774,31032,60806
"18660",2014,"11",29263,30339,59602
"18661",2014,"12",29797,30954,60751
"18662",2014,"13",30933,32449,63382
"18663",2014,"14",30945,32697,63642
"18664",2014,"15",30727,32289,63016
"18665",2014,"16",31498,33426,64924
"18666",2014,"17",32160,34216,66376
"18667",2014,"18",31802,34039,65841
"18668",2014,"19",31790,33858,65648
"18669",2014,"20",32026,34010,66036
"18670",2014,"21",32448,34981,67429
"18671",2014,"22",33535,35379,68914
"18672",2014,"23",34511,35712,70223
"18673",2014,"24",34295,35531,69826
"18674",2014,"25",34418,35358,69776
"18675",2014,"26",33833,34376,68209
"18676",2014,"27",33459,35092,68551
"18677",2014,"28",33333,34572,67905
"18678",2014,"29",33314,34581,67895
"18679",2014,"30",33014,35117,68131
"18680",2014,"31",33413,35486,68899
"18681",2014,"32",33035,34594,67629
"18682",2014,"33",33035,35391,68426
"18683",2014,"34",32876,35102,67978
"18684",2014,"35",32509,34955,67464
"18685",2014,"36",31933,34031,65964
"18686",2014,"37",32701,34970,67671
"18687",2014,"38",33853,35759,69612
"18688",2014,"39",35348,37269,72617
"18689",2014,"40",35218,37795,73013
"18690",2014,"41",36557,38908,75465
"18691",2014,"42",36848,38900,75748
"18692",2014,"43",36385,38581,74966
"18693",2014,"44",37241,39373,76614
"18694",2014,"45",36854,39085,75939
"18695",2014,"46",35919,37984,73903
"18696",2014,"47",35440,38149,73589
"18697",2014,"48",35012,37478,72490
"18698",2014,"49",34451,36856,71307
"18699",2014,"50",33391,35006,68397
"18700",2014,"51",32348,34377,66725
"18701",2014,"52",31923,33663,65586
"18702",2014,"53",31582,33231,64813
"18703",2014,"54",31585,33349,64934
"18704",2014,"55",31448,32703,64151
"18705",2014,"56",30878,31891,62769
"18706",2014,"57",31256,32035,63291
"18707",2014,"58",30441,31164,61605
"18708",2014,"59",29812,30291,60103
"18709",2014,"60",29566,29791,59357
"18710",2014,"61",28853,29377,58230
"18711",2014,"62",27304,28129,55433
"18712",2014,"63",27845,28323,56168
"18713",2014,"64",27820,28277,56097
"18714",2014,"65",27993,28527,56520
"18715",2014,"66",28798,28518,57316
"18716",2014,"67",29510,29315,58825
"18717",2014,"68",26303,25647,51950
"18718",2014,"69",24952,24412,49364
"18719",2014,"70",22021,21223,43244
"18720",2014,"71",20297,19046,39343
"18721",2014,"72",17682,16096,33778
"18722",2014,"73",18055,16410,34465
"18723",2014,"74",17366,15277,32643
"18724",2014,"75",16541,14273,30814
"18725",2014,"76",15466,13027,28493
"18726",2014,"77",14643,12031,26674
"18727",2014,"78",13889,10870,24759
"18728",2014,"79",13269,10341,23610
"18729",2014,"80",12826,9783,22609
"18730",2014,"81",13331,9772,23103
"18731",2014,"82",12728,8886,21614
"18732",2014,"83",12283,8368,20651
"18733",2014,"84",11259,7299,18558
"18734",2014,"85",10893,6592,17485
"18735",2014,"86",9840,5692,15532
"18736",2014,"87",9488,5193,14681
"18737",2014,"88",8298,4499,12797
"18738",2014,"89",7797,3697,11494
"18739",2014,"90",6794,3039,9833
"18740",2014,"91",5909,2404,8313
"18741",2014,"92",5033,1776,6809
"18742",2014,"93",4128,1479,5607
"18743",2014,"94",2728,850,3578
"18744",2014,"95",2092,669,2761
"18745",2014,"96",1598,444,2042
"18746",2014,"97",1019,220,1239
"18747",2014,"98",690,147,837
"18748",2014,"99",457,103,560
"18749",2014,"100",277,60,337
"18750",2014,"101",192,33,225
"18751",2014,"102",97,22,119
"18752",2014,"103",43,12,55
"18753",2014,"104",27,4,31
"18754",2014,"105",10,0,10
"18755",2014,"106",6,1,7
"18756",2014,"107",3,0,3
"18757",2014,"108",2,0,2
"18758",2014,"109",1,0,1
"18759",2014,"110+",0,0,0
"18760",2015,"0",28839,30544,59383
"18761",2015,"1",29423,30674,60097
"18762",2015,"2",30243,31840,62083
"18763",2015,"3",30383,32289,62672
"18764",2015,"4",31420,32943,64363
"18765",2015,"5",31802,33554,65356
"18766",2015,"6",31153,33018,64171
"18767",2015,"7",30506,32086,62592
"18768",2015,"8",30655,32160,62815
"18769",2015,"9",30011,31290,61301
"18770",2015,"10",30085,31497,61582
"18771",2015,"11",29944,31219,61163
"18772",2015,"12",29456,30498,59954
"18773",2015,"13",29964,31158,61122
"18774",2015,"14",31100,32639,63739
"18775",2015,"15",31121,32904,64025
"18776",2015,"16",30975,32680,63655
"18777",2015,"17",31705,33826,65531
"18778",2015,"18",32391,34478,66869
"18779",2015,"19",32086,34340,66426
"18780",2015,"20",32186,34208,66394
"18781",2015,"21",32539,34530,67069
"18782",2015,"22",33004,35478,68482
"18783",2015,"23",34230,36047,70277
"18784",2015,"24",35298,36557,71855
"18785",2015,"25",35253,36480,71733
"18786",2015,"26",35415,36411,71826
"18787",2015,"27",34663,35343,70006
"18788",2015,"28",34220,36025,70245
"18789",2015,"29",33995,35515,69510
"18790",2015,"30",33923,35358,69281
"18791",2015,"31",33407,35841,69248
"18792",2015,"32",33808,36104,69912
"18793",2015,"33",33379,35190,68569
"18794",2015,"34",33390,35950,69340
"18795",2015,"35",33172,35569,68741
"18796",2015,"36",32831,35366,68197
"18797",2015,"37",32182,34398,66580
"18798",2015,"38",32968,35393,68361
"18799",2015,"39",34062,36102,70164
"18800",2015,"40",35533,37573,73106
"18801",2015,"41",35406,38059,73465
"18802",2015,"42",36730,39133,75863
"18803",2015,"43",36999,39065,76064
"18804",2015,"44",36524,38701,75225
"18805",2015,"45",37343,39505,76848
"18806",2015,"46",36910,39159,76069
"18807",2015,"47",35996,38108,74104
"18808",2015,"48",35496,38211,73707
"18809",2015,"49",35029,37519,72548
"18810",2015,"50",34482,36848,71330
"18811",2015,"51",33409,34974,68383
"18812",2015,"52",32360,34322,66682
"18813",2015,"53",31913,33591,65504
"18814",2015,"54",31543,33172,64715
"18815",2015,"55",31522,33246,64768
"18816",2015,"56",31392,32590,63982
"18817",2015,"57",30800,31722,62522
"18818",2015,"58",31182,31866,63048
"18819",2015,"59",30358,31026,61384
"18820",2015,"60",29716,30102,59818
"18821",2015,"61",29453,29578,59031
"18822",2015,"62",28739,29137,57876
"18823",2015,"63",27160,27860,55020
"18824",2015,"64",27696,28053,55749
"18825",2015,"65",27647,27967,55614
"18826",2015,"66",27762,28185,55947
"18827",2015,"67",28567,28153,56720
"18828",2015,"68",29257,28875,58132
"18829",2015,"69",26050,25239,51289
"18830",2015,"70",24711,23967,48678
"18831",2015,"71",21756,20833,42589
"18832",2015,"72",20060,18642,38702
"18833",2015,"73",17437,15717,33154
"18834",2015,"74",17794,15946,33740
"18835",2015,"75",17089,14836,31925
"18836",2015,"76",16183,13804,29987
"18837",2015,"77",15126,12562,27688
"18838",2015,"78",14256,11552,25808
"18839",2015,"79",13492,10400,23892
"18840",2015,"80",12839,9806,22645
"18841",2015,"81",12321,9189,21510
"18842",2015,"82",12763,9123,21886
"18843",2015,"83",12092,8201,20293
"18844",2015,"84",11560,7710,19270
"18845",2015,"85",10485,6596,17081
"18846",2015,"86",10068,5911,15979
"18847",2015,"87",9029,5041,14070
"18848",2015,"88",8585,4476,13061
"18849",2015,"89",7386,3872,11258
"18850",2015,"90",6826,3081,9907
"18851",2015,"91",5767,2430,8197
"18852",2015,"92",4971,1916,6887
"18853",2015,"93",4139,1375,5514
"18854",2015,"94",3334,1077,4411
"18855",2015,"95",2137,608,2745
"18856",2015,"96",1590,478,2068
"18857",2015,"97",1189,320,1509
"18858",2015,"98",694,146,840
"18859",2015,"99",469,95,564
"18860",2015,"100",300,65,365
"18861",2015,"101",175,38,213
"18862",2015,"102",117,18,135
"18863",2015,"103",56,9,65
"18864",2015,"104",24,4,28
"18865",2015,"105",16,3,19
"18866",2015,"106",6,0,6
"18867",2015,"107",1,1,2
"18868",2015,"108",1,0,1
"18869",2015,"109",1,0,1
"18870",2015,"110+",1,0,1
"18871",2016,"0",28851,30545,59396
"18872",2016,"1",29195,30896,60091
"18873",2016,"2",29631,30827,60458
"18874",2016,"3",30416,32053,62469
"18875",2016,"4",30582,32399,62981
"18876",2016,"5",31567,33159,64726
"18877",2016,"6",31963,33716,65679
"18878",2016,"7",31318,33240,64558
"18879",2016,"8",30710,32282,62992
"18880",2016,"9",30882,32344,63226
"18881",2016,"10",30248,31540,61788
"18882",2016,"11",30309,31726,62035
"18883",2016,"12",30140,31420,61560
"18884",2016,"13",29656,30748,60404
"18885",2016,"14",30138,31454,61592
"18886",2016,"15",31319,32969,64288
"18887",2016,"16",31399,33353,64752
"18888",2016,"17",31233,33174,64407
"18889",2016,"18",31933,34106,66039
"18890",2016,"19",32579,34759,67338
"18891",2016,"20",32302,34662,66964
"18892",2016,"21",32534,34618,67152
"18893",2016,"22",32869,34968,67837
"18894",2016,"23",33535,36011,69546
"18895",2016,"24",34775,36560,71335
"18896",2016,"25",36051,37225,73276
"18897",2016,"26",35952,37317,73269
"18898",2016,"27",36145,37143,73288
"18899",2016,"28",35234,35994,71228
"18900",2016,"29",34793,36653,71446
"18901",2016,"30",34362,36139,70501
"18902",2016,"31",34271,35857,70128
"18903",2016,"32",33579,36284,69863
"18904",2016,"33",34106,36462,70568
"18905",2016,"34",33628,35454,69082
"18906",2016,"35",33727,36250,69977
"18907",2016,"36",33380,35791,69171
"18908",2016,"37",33046,35649,68695
"18909",2016,"38",32360,34618,66978
"18910",2016,"39",33121,35583,68704
"18911",2016,"40",34239,36287,70526
"18912",2016,"41",35739,37716,73455
"18913",2016,"42",35553,38166,73719
"18914",2016,"43",36873,39229,76102
"18915",2016,"44",37099,39115,76214
"18916",2016,"45",36654,38742,75396
"18917",2016,"46",37383,39554,76937
"18918",2016,"47",36984,39153,76137
"18919",2016,"48",36061,38066,74127
"18920",2016,"49",35508,38166,73674
"18921",2016,"50",35053,37461,72514
"18922",2016,"51",34456,36758,71214
"18923",2016,"52",33425,34894,68319
"18924",2016,"53",32333,34225,66558
"18925",2016,"54",31877,33461,65338
"18926",2016,"55",31492,33039,64531
"18927",2016,"56",31425,33054,64479
"18928",2016,"57",31332,32433,63765
"18929",2016,"58",30692,31554,62246
"18930",2016,"59",31096,31667,62763
"18931",2016,"60",30217,30803,61020
"18932",2016,"61",29594,29880,59474
"18933",2016,"62",29280,29292,58572
"18934",2016,"63",28591,28851,57442
"18935",2016,"64",26984,27592,54576
"18936",2016,"65",27525,27764,55289
"18937",2016,"66",27471,27644,55115
"18938",2016,"67",27563,27814,55377
"18939",2016,"68",28325,27746,56071
"18940",2016,"69",28973,28402,57375
"18941",2016,"70",25792,24794,50586
"18942",2016,"71",24402,23535,47937
"18943",2016,"72",21484,20399,41883
"18944",2016,"73",19799,18231,38030
"18945",2016,"74",17164,15335,32499
"18946",2016,"75",17480,15506,32986
"18947",2016,"76",16750,14357,31107
"18948",2016,"77",15809,13324,29133
"18949",2016,"78",14740,12059,26799
"18950",2016,"79",13827,11061,24888
"18951",2016,"80",13017,9879,22896
"18952",2016,"81",12336,9254,21590
"18953",2016,"82",11776,8607,20383
"18954",2016,"83",12099,8420,20519
"18955",2016,"84",11425,7516,18941
"18956",2016,"85",10833,6976,17809
"18957",2016,"86",9733,5875,15608
"18958",2016,"87",9204,5215,14419
"18959",2016,"88",8154,4397,12551
"18960",2016,"89",7636,3831,11467
"18961",2016,"90",6456,3198,9654
"18962",2016,"91",5785,2501,8286
"18963",2016,"92",4781,1925,6706
"18964",2016,"93",4075,1472,5547
"18965",2016,"94",3297,1024,4321
"18966",2016,"95",2598,783,3381
"18967",2016,"96",1611,449,2060
"18968",2016,"97",1141,320,1461
"18969",2016,"98",837,212,1049
"18970",2016,"99",472,101,573
"18971",2016,"100",315,52,367
"18972",2016,"101",189,37,226
"18973",2016,"102",113,19,132
"18974",2016,"103",72,12,84
"18975",2016,"104",31,4,35
"18976",2016,"105",11,3,14
"18977",2016,"106",10,1,11
"18978",2016,"107",0,0,0
"18979",2016,"108",1,1,2
"18980",2016,"109",1,0,1
"18981",2016,"110+",1,0,1
"18982",2017,"0",28685,30650,59335
"18983",2017,"1",29138,30862,60000
"18984",2017,"2",29464,31108,60572
"18985",2017,"3",29783,31024,60807
"18986",2017,"4",30566,32213,62779
"18987",2017,"5",30743,32536,63279
"18988",2017,"6",31683,33356,65039
"18989",2017,"7",32158,33931,66089
"18990",2017,"8",31560,33435,64995
"18991",2017,"9",30918,32491,63409
"18992",2017,"10",31083,32587,63670
"18993",2017,"11",30456,31748,62204
"18994",2017,"12",30541,31954,62495
"18995",2017,"13",30325,31744,62069
"18996",2017,"14",29844,31124,60968
"18997",2017,"15",30322,31993,62315
"18998",2017,"16",31573,33697,65270
"18999",2017,"17",31614,34142,65756
"19000",2017,"18",31480,33659,65139
"19001",2017,"19",32071,34469,66540
"19002",2017,"20",32828,35210,68038
"19003",2017,"21",32593,35210,67803
"19004",2017,"22",32912,35134,68046
"19005",2017,"23",33339,35448,68787
"19006",2017,"24",34071,36557,70628
"19007",2017,"25",35420,37175,72595
"19008",2017,"26",36683,37874,74557
"19009",2017,"27",36507,37881,74388
"19010",2017,"28",36601,37689,74290
"19011",2017,"29",35648,36460,72108
"19012",2017,"30",35115,37026,72141
"19013",2017,"31",34616,36454,71070
"19014",2017,"32",34420,36176,70596
"19015",2017,"33",33812,36422,70234
"19016",2017,"34",34271,36571,70842
"19017",2017,"35",33763,35485,69248
"19018",2017,"36",33975,36388,70363
"19019",2017,"37",33545,35872,69417
"19020",2017,"38",33250,35696,68946
"19021",2017,"39",32532,34636,67168
"19022",2017,"40",33240,35592,68832
"19023",2017,"41",34358,36268,70626
"19024",2017,"42",35857,37717,73574
"19025",2017,"43",35647,38152,73799
"19026",2017,"44",37006,39173,76179
"19027",2017,"45",37165,39058,76223
"19028",2017,"46",36696,38735,75431
"19029",2017,"47",37423,39457,76880
"19030",2017,"48",37040,39088,76128
"19031",2017,"49",36094,37964,74058
"19032",2017,"50",35559,38054,73613
"19033",2017,"51",35056,37337,72393
"19034",2017,"52",34450,36612,71062
"19035",2017,"53",33399,34723,68122
"19036",2017,"54",32288,34044,66332
"19037",2017,"55",31849,33284,65133
"19038",2017,"56",31427,32876,64303
"19039",2017,"57",31350,32859,64209
"19040",2017,"58",31243,32228,63471
"19041",2017,"59",30587,31328,61915
"19042",2017,"60",31007,31440,62447
"19043",2017,"61",30092,30533,60625
"19044",2017,"62",29465,29575,59040
"19045",2017,"63",29104,28997,58101
"19046",2017,"64",28435,28569,57004
"19047",2017,"65",26806,27266,54072
"19048",2017,"66",27320,27428,54748
"19049",2017,"67",27266,27253,54519
"19050",2017,"68",27330,27401,54731
"19051",2017,"69",28027,27357,55384
"19052",2017,"70",28676,27934,56610
"19053",2017,"71",25516,24341,49857
"19054",2017,"72",24095,23029,47124
"19055",2017,"73",21204,19952,41156
"19056",2017,"74",19504,17808,37312
"19057",2017,"75",16872,14931,31803
"19058",2017,"76",17153,15034,32187
"19059",2017,"77",16392,13890,30282
"19060",2017,"78",15368,12832,28200
"19061",2017,"79",14292,11565,25857
"19062",2017,"80",13359,10556,23915
"19063",2017,"81",12528,9349,21877
"19064",2017,"82",11797,8674,20471
"19065",2017,"83",11201,8017,19218
"19066",2017,"84",11393,7752,19145
"19067",2017,"85",10754,6845,17599
"19068",2017,"86",10070,6246,16316
"19069",2017,"87",8860,5148,14008
"19070",2017,"88",8334,4514,12848
"19071",2017,"89",7269,3766,11035
"19072",2017,"90",6662,3253,9915
"19073",2017,"91",5546,2647,8193
"19074",2017,"92",4867,1988,6855
"19075",2017,"93",3905,1483,5388
"19076",2017,"94",3267,1109,4376
"19077",2017,"95",2575,726,3301
"19078",2017,"96",1928,548,2476
"19079",2017,"97",1175,292,1467
"19080",2017,"98",815,208,1023
"19081",2017,"99",577,150,727
"19082",2017,"100",310,60,370
"19083",2017,"101",191,29,220
"19084",2017,"102",106,18,124
"19085",2017,"103",64,8,72
"19086",2017,"104",38,3,41
"19087",2017,"105",17,1,18
"19088",2017,"106",8,2,10
"19089",2017,"107",4,1,5
"19090",2017,"108",0,0,0
"19091",2017,"109",0,0,0
"19092",2017,"110+",1,0,1
"19093",2018,"0",27628,29337,56965
"19094",2018,"1",29038,31029,60067
"19095",2018,"2",29367,31115,60482
"19096",2018,"3",29650,31261,60911
"19097",2018,"4",29979,31175,61154
"19098",2018,"5",30677,32345,63022
"19099",2018,"6",30893,32655,63548
"19100",2018,"7",31870,33470,65340
"19101",2018,"8",32289,34092,66381
"19102",2018,"9",31747,33634,65381
"19103",2018,"10",31099,32702,63801
"19104",2018,"11",31252,32819,64071
"19105",2018,"12",30618,31939,62557
"19106",2018,"13",30677,32201,62878
"19107",2018,"14",30441,31935,62376
"19108",2018,"15",30028,31326,61354
"19109",2018,"16",30523,32283,62806
"19110",2018,"17",31772,34141,65913
"19111",2018,"18",31840,34544,66384
"19112",2018,"19",31621,33881,65502
"19113",2018,"20",32253,34712,66965
"19114",2018,"21",33054,35477,68531
"19115",2018,"22",32920,35461,68381
"19116",2018,"23",33310,35459,68769
"19117",2018,"24",33854,35870,69724
"19118",2018,"25",34780,37119,71899
"19119",2018,"26",36003,37746,73749
"19120",2018,"27",37249,38275,75524
"19121",2018,"28",37028,38359,75387
"19122",2018,"29",36962,38054,75016
"19123",2018,"30",35955,36771,72726
"19124",2018,"31",35320,37290,72610
"19125",2018,"32",34818,36684,71502
"19126",2018,"33",34625,36350,70975
"19127",2018,"34",33998,36580,70578
"19128",2018,"35",34474,36702,71176
"19129",2018,"36",33945,35604,69549
"19130",2018,"37",34153,36449,70602
"19131",2018,"38",33707,35858,69565
"19132",2018,"39",33400,35701,69101
"19133",2018,"40",32701,34610,67311
"19134",2018,"41",33354,35593,68947
"19135",2018,"42",34465,36233,70698
"19136",2018,"43",35957,37648,73605
"19137",2018,"44",35719,38114,73833
"19138",2018,"45",37037,39153,76190
"19139",2018,"46",37186,39022,76208
"19140",2018,"47",36730,38644,75374
"19141",2018,"48",37469,39373,76842
"19142",2018,"49",37052,39008,76060
"19143",2018,"50",36126,37867,73993
"19144",2018,"51",35533,37916,73449
"19145",2018,"52",35042,37233,72275
"19146",2018,"53",34420,36477,70897
"19147",2018,"54",33339,34590,67929
"19148",2018,"55",32227,33903,66130
"19149",2018,"56",31791,33147,64938
"19150",2018,"57",31356,32701,64057
"19151",2018,"58",31242,32648,63890
"19152",2018,"59",31170,31997,63167
"19153",2018,"60",30498,31081,61579
"19154",2018,"61",30864,31194,62058
"19155",2018,"62",29973,30279,60252
"19156",2018,"63",29325,29328,58653
"19157",2018,"64",28955,28682,57637
"19158",2018,"65",28246,28261,56507
"19159",2018,"66",26614,26945,53559
"19160",2018,"67",27081,27029,54110
"19161",2018,"68",27029,26868,53897
"19162",2018,"69",27072,26998,54070
"19163",2018,"70",27726,26932,54658
"19164",2018,"71",28336,27460,55796
"19165",2018,"72",25168,23858,49026
"19166",2018,"73",23711,22547,46258
"19167",2018,"74",20847,19486,40333
"19168",2018,"75",19136,17375,36511
"19169",2018,"76",16526,14532,31058
"19170",2018,"77",16762,14552,31314
"19171",2018,"78",15993,13364,29357
"19172",2018,"79",14953,12266,27219
"19173",2018,"80",13811,11000,24811
"19174",2018,"81",12862,9978,22840
"19175",2018,"82",11986,8776,20762
"19176",2018,"83",11278,8070,19348
"19177",2018,"84",10600,7386,17986
"19178",2018,"85",10651,7036,17687
"19179",2018,"86",9972,6142,16114
"19180",2018,"87",9200,5548,14748
"19181",2018,"88",8063,4471,12534
"19182",2018,"89",7382,3886,11268
"19183",2018,"90",6332,3161,9493
"19184",2018,"91",5712,2668,8380
"19185",2018,"92",4664,2113,6777
"19186",2018,"93",4002,1536,5538
"19187",2018,"94",3109,1119,4228
"19188",2018,"95",2496,828,3324
"19189",2018,"96",1923,500,2423
"19190",2018,"97",1413,362,1775
"19191",2018,"98",822,201,1023
"19192",2018,"99",571,131,702
"19193",2018,"100",408,96,504
"19194",2018,"101",180,35,215
"19195",2018,"102",121,18,139
"19196",2018,"103",70,12,82
"19197",2018,"104",35,4,39
"19198",2018,"105",20,2,22
"19199",2018,"106",5,1,6
"19200",2018,"107",5,1,6
"19201",2018,"108",1,0,1
"19202",2018,"109",0,0,0
"19203",2018,"110+",0,0,0
"19204",2019,"0",26835,28556,55391
"19205",2019,"1",27901,29649,57550
"19206",2019,"2",29160,31187,60347
"19207",2019,"3",29452,31157,60609
"19208",2019,"4",29663,31303,60966
"19209",2019,"5",30034,31242,61276
"19210",2019,"6",30713,32372,63085
"19211",2019,"7",30910,32712,63622
"19212",2019,"8",31964,33540,65504
"19213",2019,"9",32349,34217,66566
"19214",2019,"10",31875,33752,65627
"19215",2019,"11",31203,32858,64061
"19216",2019,"12",31367,32986,64353
"19217",2019,"13",30750,32088,62838
"19218",2019,"14",30786,32377,63163
"19219",2019,"15",30554,32092,62646
"19220",2019,"16",30214,31517,61731
"19221",2019,"17",30672,32501,63173
"19222",2019,"18",31982,34379,66361
"19223",2019,"19",31912,34676,66588
"19224",2019,"20",31815,34048,65863
"19225",2019,"21",32531,34896,67427
"19226",2019,"22",33458,35746,69204
"19227",2019,"23",33285,35789,69074
"19228",2019,"24",33806,35857,69663
"19229",2019,"25",34469,36328,70797
"19230",2019,"26",35357,37618,72975
"19231",2019,"27",36612,38224,74836
"19232",2019,"28",37725,38744,76469
"19233",2019,"29",37415,38696,76111
"19234",2019,"30",37281,38400,75681
"19235",2019,"31",36174,37094,73268
"19236",2019,"32",35522,37425,72947
"19237",2019,"33",34968,36912,71880
"19238",2019,"34",34763,36433,71196
"19239",2019,"35",34148,36697,70845
"19240",2019,"36",34599,36765,71364
"19241",2019,"37",34097,35618,69715
"19242",2019,"38",34252,36496,70748
"19243",2019,"39",33835,35890,69725
"19244",2019,"40",33516,35731,69247
"19245",2019,"41",32815,34544,67359
"19246",2019,"42",33435,35594,69029
"19247",2019,"43",34612,36237,70849
"19248",2019,"44",36083,37644,73727
"19249",2019,"45",35791,38042,73833
"19250",2019,"46",37092,39157,76249
"19251",2019,"47",37258,38968,76226
"19252",2019,"48",36742,38611,75353
"19253",2019,"49",37471,39296,76767
"19254",2019,"50",37063,38891,75954
"19255",2019,"51",36134,37784,73918
"19256",2019,"52",35504,37842,73346
"19257",2019,"53",35004,37089,72093
"19258",2019,"54",34392,36341,70733
"19259",2019,"55",33287,34436,67723
"19260",2019,"56",32172,33786,65958
"19261",2019,"57",31709,32967,64676
"19262",2019,"58",31261,32503,63764
"19263",2019,"59",31131,32448,63579
"19264",2019,"60",31079,31775,62854
"19265",2019,"61",30376,30837,61213
"19266",2019,"62",30709,30966,61675
"19267",2019,"63",29818,29972,59790
"19268",2019,"64",29171,29040,58211
"19269",2019,"65",28768,28378,57146
"19270",2019,"66",28049,27952,56001
"19271",2019,"67",26413,26627,53040
"19272",2019,"68",26856,26679,53535
"19273",2019,"69",26793,26489,53282
"19274",2019,"70",26784,26585,53369
"19275",2019,"71",27395,26482,53877
"19276",2019,"72",28009,26920,54929
"19277",2019,"73",24811,23382,48193
"19278",2019,"74",23392,22031,45423
"19279",2019,"75",20493,18987,39480
"19280",2019,"76",18780,16856,35636
"19281",2019,"77",16169,14071,30240
"19282",2019,"78",16341,13975,30316
"19283",2019,"79",15536,12839,28375
"19284",2019,"80",14462,11687,26149
"19285",2019,"81",13307,10445,23752
"19286",2019,"82",12339,9328,21667
"19287",2019,"83",11351,8177,19528
"19288",2019,"84",10651,7463,18114
"19289",2019,"85",9974,6759,16733
"19290",2019,"86",9920,6347,16267
"19291",2019,"87",9173,5442,14615
"19292",2019,"88",8376,4843,13219
"19293",2019,"89",7175,3838,11013
"19294",2019,"90",6389,3241,9630
"19295",2019,"91",5453,2626,8079
"19296",2019,"92",4788,2118,6906
"19297",2019,"93",3840,1679,5519
"19298",2019,"94",3222,1193,4415
"19299",2019,"95",2381,834,3215
"19300",2019,"96",1863,579,2442
"19301",2019,"97",1396,357,1753
"19302",2019,"98",1001,233,1234
"19303",2019,"99",554,132,686
"19304",2019,"100",364,75,439
"19305",2019,"101",298,62,360
"19306",2019,"102",94,17,111
"19307",2019,"103",70,12,82
"19308",2019,"104",35,6,41
"19309",2019,"105",13,1,14
"19310",2019,"106",10,2,12
"19311",2019,"107",3,1,4
"19312",2019,"108",5,0,5
"19313",2019,"109",1,0,1
"19314",2019,"110+",0,0,0
"19315",2020,"0",26619,28208,54827
"19316",2020,"1",27165,28847,56012
"19317",2020,"2",28058,29823,57881
"19318",2020,"3",29261,31261,60522
"19319",2020,"4",29547,31274,60821
"19320",2020,"5",29721,31375,61096
"19321",2020,"6",30118,31274,61392
"19322",2020,"7",30789,32462,63251
"19323",2020,"8",31047,32834,63881
"19324",2020,"9",32041,33634,65675
"19325",2020,"10",32507,34323,66830
"19326",2020,"11",32008,33903,65911
"19327",2020,"12",31319,32987,64306
"19328",2020,"13",31494,33146,64640
"19329",2020,"14",30853,32229,63082
"19330",2020,"15",30887,32521,63408
"19331",2020,"16",30722,32300,63022
"19332",2020,"17",30367,31684,62051
"19333",2020,"18",30861,32696,63557
"19334",2020,"19",32067,34517,66584
"19335",2020,"20",32019,34794,66813
"19336",2020,"21",32005,34159,66164
"19337",2020,"22",32688,35129,67817
"19338",2020,"23",33822,36127,69949
"19339",2020,"24",33822,36264,70086
"19340",2020,"25",34470,36383,70853
"19341",2020,"26",35143,36912,72055
"19342",2020,"27",36110,38223,74333
"19343",2020,"28",37214,38820,76034
"19344",2020,"29",38288,39360,77648
"19345",2020,"30",37899,39255,77154
"19346",2020,"31",37654,39000,76654
"19347",2020,"32",36480,37580,74060
"19348",2020,"33",35879,37893,73772
"19349",2020,"34",35260,37324,72584
"19350",2020,"35",35043,36743,71786
"19351",2020,"36",34410,37027,71437
"19352",2020,"37",34780,37036,71816
"19353",2020,"38",34297,35869,70166
"19354",2020,"39",34425,36693,71118
"19355",2020,"40",33954,36077,70031
"19356",2020,"41",33625,35875,69500
"19357",2020,"42",32962,34706,67668
"19358",2020,"43",33568,35713,69281
"19359",2020,"44",34716,36319,71035
"19360",2020,"45",36151,37771,73922
"19361",2020,"46",35886,38163,74049
"19362",2020,"47",37168,39253,76421
"19363",2020,"48",37322,39033,76355
"19364",2020,"49",36790,38611,75401
"19365",2020,"50",37524,39317,76841
"19366",2020,"51",37067,38884,75951
"19367",2020,"52",36116,37722,73838
"19368",2020,"53",35489,37814,73303
"19369",2020,"54",34958,37040,71998
"19370",2020,"55",34348,36245,70593
"19371",2020,"56",33208,34357,67565
"19372",2020,"57",32098,33631,65729
"19373",2020,"58",31634,32836,64470
"19374",2020,"59",31179,32363,63542
"19375",2020,"60",31057,32248,63305
"19376",2020,"61",30961,31570,62531
"19377",2020,"62",30212,30629,60841
"19378",2020,"63",30547,30668,61215
"19379",2020,"64",29630,29701,59331
"19380",2020,"65",29002,28740,57742
"19381",2020,"66",28550,28104,56654
"19382",2020,"67",27818,27604,55422
"19383",2020,"68",26227,26278,52505
"19384",2020,"69",26631,26318,52949
"19385",2020,"70",26516,26058,52574
"19386",2020,"71",26497,26143,52640
"19387",2020,"72",27035,25994,53029
"19388",2020,"73",27605,26396,54001
"19389",2020,"74",24399,22809,47208
"19390",2020,"75",22981,21460,44441
"19391",2020,"76",20104,18447,38551
"19392",2020,"77",18353,16354,34707
"19393",2020,"78",15780,13571,29351
"19394",2020,"79",15915,13417,29332
"19395",2020,"80",15010,12269,27279
"19396",2020,"81",13950,11121,25071
"19397",2020,"82",12765,9870,22635
"19398",2020,"83",11770,8714,20484
"19399",2020,"84",10698,7548,18246
"19400",2020,"85",10004,6805,16809
"19401",2020,"86",9301,6097,15398
"19402",2020,"87",9115,5678,14793
"19403",2020,"88",8327,4751,13078
"19404",2020,"89",7531,4165,11696
"19405",2020,"90",6331,3255,9586
"19406",2020,"91",5499,2656,8155
"19407",2020,"92",4620,2078,6698
"19408",2020,"93",3971,1678,5649
"19409",2020,"94",3098,1259,4357
"19410",2020,"95",2544,891,3435
"19411",2020,"96",1807,623,2430
"19412",2020,"97",1330,405,1735
"19413",2020,"98",978,229,1207
"19414",2020,"99",685,160,845
"19415",2020,"100",357,88,445
"19416",2020,"101",226,43,269
"19417",2020,"102",214,41,255
"19418",2020,"103",57,9,66
"19419",2020,"104",39,5,44
"19420",2020,"105",17,2,19
"19421",2020,"106",5,0,5
"19422",2020,"107",3,0,3
"19423",2020,"108",1,0,1
"19424",2020,"109",2,0,2
"19425",2020,"110+",1,0,1
"19426",2021,"0",26005,27129,53134
"19427",2021,"1",26803,28422,55225
"19428",2021,"2",27195,28947,56142
"19429",2021,"3",28108,29825,57933
"19430",2021,"4",29248,31278,60526
"19431",2021,"5",29530,31274,60804
"19432",2021,"6",29686,31350,61036
"19433",2021,"7",30159,31288,61447
"19434",2021,"8",30825,32493,63318
"19435",2021,"9",31090,32878,63968
"19436",2021,"10",32075,33674,65749
"19437",2021,"11",32555,34378,66933
"19438",2021,"12",32086,34036,66122
"19439",2021,"13",31406,33056,64462
"19440",2021,"14",31564,33228,64792
"19441",2021,"15",30933,32323,63256
"19442",2021,"16",30962,32644,63606
"19443",2021,"17",30826,32411,63237
"19444",2021,"18",30518,31829,62347
"19445",2021,"19",30933,32820,63753
"19446",2021,"20",32088,34476,66564
"19447",2021,"21",32081,34855,66936
"19448",2021,"22",32099,34261,66360
"19449",2021,"23",32860,35275,68135
"19450",2021,"24",34112,36314,70426
"19451",2021,"25",34230,36548,70778
"19452",2021,"26",34904,36773,71677
"19453",2021,"27",35591,37281,72872
"19454",2021,"28",36388,38541,74929
"19455",2021,"29",37473,39157,76630
"19456",2021,"30",38433,39661,78094
"19457",2021,"31",38027,39393,77420
"19458",2021,"32",37748,39267,77015
"19459",2021,"33",36526,37747,74273
"19460",2021,"34",35983,38050,74033
"19461",2021,"35",35352,37419,72771
"19462",2021,"36",35045,36777,71822
"19463",2021,"37",34475,37044,71519
"19464",2021,"38",34814,37051,71865
"19465",2021,"39",34382,35930,70312
"19466",2021,"40",34477,36703,71180
"19467",2021,"41",34004,36074,70078
"19468",2021,"42",33703,35837,69540
"19469",2021,"43",33037,34704,67741
"19470",2021,"44",33598,35652,69250
"19471",2021,"45",34790,36349,71139
"19472",2021,"46",36213,37760,73973
"19473",2021,"47",35922,38138,74060
"19474",2021,"48",37159,39201,76360
"19475",2021,"49",37308,38962,76270
"19476",2021,"50",36795,38565,75360
"19477",2021,"51",37514,39239,76753
"19478",2021,"52",37039,38808,75847
"19479",2021,"53",36091,37627,73718
"19480",2021,"54",35413,37746,73159
"19481",2021,"55",34911,36944,71855
"19482",2021,"56",34269,36113,70382
"19483",2021,"57",33146,34224,67370
"19484",2021,"58",32021,33494,65515
"19485",2021,"59",31543,32661,64204
"19486",2021,"60",31071,32189,63260
"19487",2021,"61",30959,32060,63019
"19488",2021,"62",30811,31358,62169
"19489",2021,"63",30049,30383,60432
"19490",2021,"64",30366,30406,60772
"19491",2021,"65",29424,29417,58841
"19492",2021,"66",28825,28419,57244
"19493",2021,"67",28323,27731,56054
"19494",2021,"68",27607,27248,54855
"19495",2021,"69",25974,25899,51873
"19496",2021,"70",26387,25955,52342
"19497",2021,"71",26178,25617,51795
"19498",2021,"72",26166,25695,51861
"19499",2021,"73",26630,25492,52122
"19500",2021,"74",27192,25817,53009
"19501",2021,"75",23994,22181,46175
"19502",2021,"76",22579,20883,43462
"19503",2021,"77",19692,17914,37606
"19504",2021,"78",17914,15806,33720
"19505",2021,"79",15331,13045,28376
"19506",2021,"80",15434,12820,28254
"19507",2021,"81",14499,11641,26140
"19508",2021,"82",13413,10510,23923
"19509",2021,"83",12163,9237,21400
"19510",2021,"84",11128,8102,19230
"19511",2021,"85",10025,6895,16920
"19512",2021,"86",9355,6142,15497
"19513",2021,"87",8632,5444,14076
"19514",2021,"88",8321,5037,13358
"19515",2021,"89",7462,4060,11522
"19516",2021,"90",6594,3517,10111
"19517",2021,"91",5479,2703,8182
"19518",2021,"92",4687,2158,6845
"19519",2021,"93",3843,1621,5464
"19520",2021,"94",3165,1279,4444
"19521",2021,"95",2424,967,3391
"19522",2021,"96",1959,647,2606
"19523",2021,"97",1322,422,1744
"19524",2021,"98",940,263,1203
"19525",2021,"99",675,156,831
"19526",2021,"100",450,99,549
"19527",2021,"101",231,60,291
"19528",2021,"102",141,25,166
"19529",2021,"103",145,37,182
"19530",2021,"104",31,1,32
"19531",2021,"105",24,1,25
"19532",2021,"106",10,0,10
"19533",2021,"107",3,0,3
"19534",2021,"108",0,0,0
"19535",2021,"109",0,0,0
"19536",2021,"110+",1,0,1
"19537",2022,"0",27572,28886,56458
"19538",2022,"1",26296,27378,53674
"19539",2022,"2",26990,28560,55550
"19540",2022,"3",27261,29032,56293
"19541",2022,"4",28134,29931,58065
"19542",2022,"5",29316,31337,60653
"19543",2022,"6",29528,31269,60797
"19544",2022,"7",29782,31410,61192
"19545",2022,"8",30198,31345,61543
"19546",2022,"9",30921,32568,63489
"19547",2022,"10",31150,32978,64128
"19548",2022,"11",32175,33803,65978
"19549",2022,"12",32635,34472,67107
"19550",2022,"13",32196,34175,66371
"19551",2022,"14",31490,33199,64689
"19552",2022,"15",31695,33389,65084
"19553",2022,"16",31083,32486,63569
"19554",2022,"17",31076,32807,63883
"19555",2022,"18",31014,32603,63617
"19556",2022,"19",30634,31960,62594
"19557",2022,"20",31080,32967,64047
"19558",2022,"21",32302,34715,67017
"19559",2022,"22",32366,34965,67331
"19560",2022,"23",32474,34693,67167
"19561",2022,"24",33483,35865,69348
"19562",2022,"25",34825,36974,71799
"19563",2022,"26",34970,37227,72197
"19564",2022,"27",35409,37356,72765
"19565",2022,"28",36142,37862,74004
"19566",2022,"29",36818,39090,75908
"19567",2022,"30",37787,39627,77414
"19568",2022,"31",38689,40080,78769
"19569",2022,"32",38146,39769,77915
"19570",2022,"33",37932,39528,77460
"19571",2022,"34",36689,37938,74627
"19572",2022,"35",36076,38175,74251
"19573",2022,"36",35455,37609,73064
"19574",2022,"37",35143,36837,71980
"19575",2022,"38",34574,37071,71645
"19576",2022,"39",34903,37094,71997
"19577",2022,"40",34466,35951,70417
"19578",2022,"41",34546,36743,71289
"19579",2022,"42",34084,36039,70123
"19580",2022,"43",33791,35863,69654
"19581",2022,"44",33111,34712,67823
"19582",2022,"45",33646,35648,69294
"19583",2022,"46",34843,36394,71237
"19584",2022,"47",36272,37744,74016
"19585",2022,"48",35950,38060,74010
"19586",2022,"49",37172,39198,76370
"19587",2022,"50",37355,38955,76310
"19588",2022,"51",36806,38536,75342
"19589",2022,"52",37513,39148,76661
"19590",2022,"53",37071,38737,75808
"19591",2022,"54",36068,37545,73613
"19592",2022,"55",35352,37600,72952
"19593",2022,"56",34842,36781,71623
"19594",2022,"57",34201,35949,70150
"19595",2022,"58",33068,34054,67122
"19596",2022,"59",31942,33336,65278
"19597",2022,"60",31440,32512,63952
"19598",2022,"61",30966,31989,62955
"19599",2022,"62",30833,31815,62648
"19600",2022,"63",30656,31083,61739
"19601",2022,"64",29881,30090,59971
"19602",2022,"65",30149,30082,60231
"19603",2022,"66",29211,29069,58280
"19604",2022,"67",28591,28049,56640
"19605",2022,"68",28116,27353,55469
"19606",2022,"69",27357,26876,54233
"19607",2022,"70",25723,25540,51263
"19608",2022,"71",26096,25519,51615
"19609",2022,"72",25826,25158,50984
"19610",2022,"73",25770,25166,50936
"19611",2022,"74",26216,24952,51168
"19612",2022,"75",26731,25155,51886
"19613",2022,"76",23526,21566,45092
"19614",2022,"77",22070,20243,42313
"19615",2022,"78",19185,17284,36469
"19616",2022,"79",17441,15161,32602
"19617",2022,"80",14872,12516,27388
"19618",2022,"81",14887,12182,27069
"19619",2022,"82",13874,10995,24869
"19620",2022,"83",12798,9835,22633
"19621",2022,"84",11445,8569,20014
"19622",2022,"85",10478,7433,17911
"19623",2022,"86",9323,6240,15563
"19624",2022,"87",8557,5439,13996
"19625",2022,"88",7788,4770,12558
"19626",2022,"89",7402,4341,11743
"19627",2022,"90",6567,3407,9974
"19628",2022,"91",5730,2930,8660
"19629",2022,"92",4614,2220,6834
"19630",2022,"93",3825,1719,5544
"19631",2022,"94",3053,1246,4299
"19632",2022,"95",2479,992,3471
"19633",2022,"96",1856,710,2566
"19634",2022,"97",1446,435,1881
"19635",2022,"98",938,281,1219
"19636",2022,"99",638,162,800
"19637",2022,"100",438,89,527
"19638",2022,"101",288,52,340
"19639",2022,"102",146,37,183
"19640",2022,"103",77,15,92
"19641",2022,"104",103,34,137
"19642",2022,"105",10,1,11
"19643",2022,"106",12,0,12
"19644",2022,"107",4,0,4
"19645",2022,"108",1,0,1
"19646",2022,"109",0,0,0
"19647",2022,"110+",0,0,0
"19648",2023,"0",25310,26681,51991
"19649",2023,"1",28037,29378,57415
"19650",2023,"2",26820,27958,54778
"19651",2023,"3",27466,28989,56455
"19652",2023,"4",27692,29454,57146
"19653",2023,"5",28546,30339,58885
"19654",2023,"6",29714,31761,61475
"19655",2023,"7",29958,31747,61705
"19656",2023,"8",30221,31877,62098
"19657",2023,"9",30613,31832,62445
"19658",2023,"10",31377,33040,64417
"19659",2023,"11",31526,33476,65002
"19660",2023,"12",32628,34255,66883
"19661",2023,"13",33044,34985,68029
"19662",2023,"14",32594,34749,67343
"19663",2023,"15",31915,33731,65646
"19664",2023,"16",32102,33891,65993
"19665",2023,"17",31505,32980,64485
"19666",2023,"18",31573,33334,64907
"19667",2023,"19",31441,32888,64329
"19668",2023,"20",31111,32354,63465
"19669",2023,"21",31588,33404,64992
"19670",2023,"22",32878,35241,68119
"19671",2023,"23",33088,35569,68657
"19672",2023,"24",33364,35369,68733
"19673",2023,"25",34378,36562,70940
"19674",2023,"26",35747,37633,73380
"19675",2023,"27",35920,37911,73831
"19676",2023,"28",36385,38057,74442
"19677",2023,"29",36994,38611,75605
"19678",2023,"30",37694,39820,77514
"19679",2023,"31",38587,40282,78869
"19680",2023,"32",39395,40727,80122
"19681",2023,"33",38889,40275,79164
"19682",2023,"34",38601,40075,78676
"19683",2023,"35",37403,38393,75796
"19684",2023,"36",36743,38662,75405
"19685",2023,"37",36160,37985,74145
"19686",2023,"38",35848,37174,73022
"19687",2023,"39",35243,37362,72605
"19688",2023,"40",35525,37429,72954
"19689",2023,"41",34990,36190,71180
"19690",2023,"42",35089,36976,72065
"19691",2023,"43",34563,36250,70813
"19692",2023,"44",34236,36012,70248
"19693",2023,"45",33520,34884,68404
"19694",2023,"46",34033,35776,69809
"19695",2023,"47",35177,36463,71640
"19696",2023,"48",36600,37822,74422
"19697",2023,"49",36215,38079,74294
"19698",2023,"50",37446,39204,76650
"19699",2023,"51",37536,38960,76496
"19700",2023,"52",37024,38530,75554
"19701",2023,"53",37660,39127,76787
"19702",2023,"54",37209,38711,75920
"19703",2023,"55",36217,37445,73662
"19704",2023,"56",35480,37508,72988
"19705",2023,"57",34879,36634,71513
"19706",2023,"58",34275,35796,70071
"19707",2023,"59",33194,33856,67050
"19708",2023,"60",32018,33238,65256
"19709",2023,"61",31506,32420,63926
"19710",2023,"62",31028,31875,62903
"19711",2023,"63",30842,31627,62469
"19712",2023,"64",30683,30857,61540
"19713",2023,"65",29874,29861,59735
"19714",2023,"66",30085,29798,59883
"19715",2023,"67",29117,28764,57881
"19716",2023,"68",28485,27721,56206
"19717",2023,"69",27981,26980,54961
"19718",2023,"70",27198,26474,53672
"19719",2023,"71",25526,25160,50686
"19720",2023,"72",25882,25075,50957
"19721",2023,"73",25567,24671,50238
"19722",2023,"74",25427,24612,50039
"19723",2023,"75",25805,24288,50093
"19724",2023,"76",26208,24418,50626
"19725",2023,"77",23006,20835,43841
"19726",2023,"78",21550,19491,41041
"19727",2023,"79",18625,16617,35242
"19728",2023,"80",16927,14484,31411
"19729",2023,"81",14386,11843,26229
"19730",2023,"82",14292,11475,25767
"19731",2023,"83",13203,10253,23456
"19732",2023,"84",12100,9065,21165
"19733",2023,"85",10731,7812,18543
"19734",2023,"86",9731,6657,16388
"19735",2023,"87",8566,5523,14089
"19736",2023,"88",7676,4721,12397
"19737",2023,"89",6899,4033,10932
"19738",2023,"90",6430,3616,10046
"19739",2023,"91",5648,2747,8395
"19740",2023,"92",4751,2294,7045
"19741",2023,"93",3747,1703,5450
"19742",2023,"94",3013,1256,4269
"19743",2023,"95",2297,887,3184
"19744",2023,"96",1797,692,2489
"19745",2023,"97",1313,469,1782
"19746",2023,"98",991,286,1277
"19747",2023,"99",597,174,771
"19748",2023,"100",423,95,518
"19749",2023,"101",256,54,310
"19750",2023,"102",164,32,196
"19751",2023,"103",82,21,103
"19752",2023,"104",39,5,44
"19753",2023,"105",76,28,104
"19754",2023,"106",0,0,0
"19755",2023,"107",0,0,0
"19756",2023,"108",0,0,0
"19757",2023,"109",0,0,0
"19758",2023,"110+",0,0,0
